Threshold,Locus,Predict Sites,Positive Sites,Negative Sites,Actual Donor Sites,Predict Num,Predict Positive Num,Predict Negative Num,TP,FP,TN,FN
4.0,ACU08131,"[322, 463, 642, 710, 845, 925, 1024, 1255, 1363, 1437, 1735, 2029, 2245, 2350, 2598, 2637, 2803, 2807, 3042, 3336, 3798, 3914, 4038, 4512, 5313]","[642, 1363, 2029, 2803, 3798]","[322, 463, 710, 845, 925, 1024, 1255, 1437, 1735, 2245, 2350, 2598, 2637, 2807, 3042, 3336, 3914, 4038, 4512, 5313]","[642, 1363, 2029, 2803, 3798]",5385,25,5360,5,20,5360,0
4.0,AGGGLINE,"[32, 70, 869, 935, 1571, 2325, 2347, 2658, 2946, 2963, 3120, 3158, 3457, 3504, 4035, 4098, 4309, 4651, 4685, 5187, 5259, 5357, 5648, 5864, 6262, 6387, 6421, 6984, 7054]","[3158, 3504]","[32, 70, 869, 935, 1571, 2325, 2347, 2658, 2946, 2963, 3120, 3457, 4035, 4098, 4309, 4651, 4685, 5187, 5259, 5357, 5648, 5864, 6262, 6387, 6421, 6984, 7054]","[3158, 3504]",7222,29,7193,2,27,7193,0
4.0,AGU04852,"[536, 653, 1104, 1464, 2073, 2117, 2302, 2972, 3116, 3176, 3877, 3956, 4566, 4701, 4863, 4906, 5517, 5533, 5912, 6224, 6383, 6740, 6883, 7509, 7636, 8085, 8301, 8354, 8358, 8635, 8694, 8817, 8934, 8961, 9856, 10812, 10820]","[3956, 5517, 5912, 6740]","[536, 653, 1104, 1464, 2073, 2117, 2302, 2972, 3116, 3176, 3877, 4566, 4701, 4863, 4906, 5533, 6224, 6383, 6883, 7509, 7636, 8085, 8301, 8354, 8358, 8635, 8694, 8817, 8934, 8961, 9856, 10812, 10820]","[3956, 5517, 5912, 6740]",10977,37,10940,4,33,10940,0
4.0,ALOEGLOBIM,"[221, 237, 536, 583, 1170, 1182, 1297]","[237, 583]","[221, 536, 1170, 1182, 1297]","[237, 583]",1684,7,1677,2,5,1677,0
4.0,ALOEGLOBIN,"[221, 237, 536, 583, 1170, 1182, 1297]","[237, 583]","[221, 536, 1170, 1182, 1297]","[237, 583]",1684,7,1677,2,5,1677,0
4.0,ALOPROTP1A,"[59, 166, 170, 267]",[166],"[59, 170, 267]",[166],411,4,407,1,3,407,0
4.0,AMU12024,"[257, 667, 872, 1583, 1594, 1695, 1960, 2013, 2482, 2685]","[257, 667, 2482]","[872, 1583, 1594, 1695, 1960, 2013, 2685]","[257, 667, 1864, 2126, 2482]",3645,10,3635,3,7,3633,2
4.0,AMU12025,"[1080, 1412, 1830, 2485, 2654, 2658, 2705, 2736, 2789, 3278, 3313, 3343, 4481]","[1412, 1830, 2654, 3278]","[1080, 2485, 2658, 2705, 2736, 2789, 3313, 3343, 4481]","[1412, 1830, 2654, 2902, 3278]",5376,13,5363,4,9,5362,1
4.0,AOIRHODOPS,"[255, 620, 894, 1702, 1749, 1953, 1969, 2025, 2754, 3012, 4005, 4067, 4336, 4385, 4840, 4953, 5207, 5373, 5426, 5452, 5483, 5494, 6243, 7039, 7056, 7481, 7580, 7600, 7622, 7630, 7800, 8156, 8308, 8837, 9057, 9133]","[1702, 4067, 5373, 6243]","[255, 620, 894, 1749, 1953, 1969, 2025, 2754, 3012, 4005, 4336, 4385, 4840, 4953, 5207, 5426, 5452, 5483, 5494, 7039, 7056, 7481, 7580, 7600, 7622, 7630, 7800, 8156, 8308, 8837, 9057, 9133]","[1702, 4067, 5373, 6243]",9916,36,9880,4,32,9880,0
4.0,ASPROP2,"[75, 589]",[],"[75, 589]",[325],665,2,663,0,2,662,1
4.0,ASYRVISP,"[99, 625, 634, 656, 1042, 1335, 1419, 1585, 1916]","[625, 1042, 1335, 1585, 1916]","[99, 634, 656, 1419]","[625, 1042, 1335, 1585, 1916]",2222,9,2213,5,4,2213,0
4.0,ATREGLOBIN,"[221, 237, 541, 588, 604, 1187, 1295, 1314]","[237, 588]","[221, 541, 604, 1187, 1295, 1314]","[237, 588]",1692,8,1684,2,6,1684,0
4.0,BABAPOE,"[33, 60, 198, 267, 481, 550, 897, 1080, 1374, 1702, 1953, 2109, 2262, 2593, 2847, 3916, 3978, 3999]","[897, 2847]","[33, 60, 198, 267, 481, 550, 1080, 1374, 1702, 1953, 2109, 2262, 2593, 3916, 3978, 3999]","[897, 2847]",4755,18,4737,2,16,4737,0
4.0,BATROX,"[237, 341, 875, 1839, 2032, 2078, 2307, 2428, 2446, 2890, 2959, 3011, 3556, 3593, 3924, 3967, 3975, 4110, 4495, 4705, 4836, 5035, 5085, 5204, 6449, 6789, 6874, 6955, 7378, 7567, 7655, 7789, 7992]","[341, 3011, 5035, 6955]","[237, 875, 1839, 2032, 2078, 2307, 2428, 2446, 2890, 2959, 3556, 3593, 3924, 3967, 3975, 4110, 4495, 4705, 4836, 5085, 5204, 6449, 6789, 6874, 7378, 7567, 7655, 7789, 7992]","[341, 3011, 5035, 6955]",8093,33,8060,4,29,8060,0
4.0,BCHEGLOBIN,"[221, 237, 536, 583, 1184, 1196, 1311]","[237, 583]","[221, 536, 1184, 1196, 1311]","[237, 583]",1698,7,1691,2,5,1691,0
4.0,BOVANPA,"[334, 433, 598, 858]","[433, 858]","[334, 598]","[433, 858]",1762,4,1758,2,2,1758,0
4.0,BOVCOX7AL,"[295, 679, 1501, 1540, 1826, 2141, 2432, 2470, 2630, 2867, 2874, 3328, 3627, 3721, 3969, 4284, 5049, 5521, 6167]","[1540, 5049]","[295, 679, 1501, 1826, 2141, 2432, 2470, 2630, 2867, 2874, 3328, 3627, 3721, 3969, 4284, 5521, 6167]","[1540, 2812, 5049]",6850,19,6831,2,17,6830,1
4.0,BOVGAS,"[192, 751, 996]",[751],"[192, 996]",[751],1059,3,1056,1,2,1056,0
4.0,BOVIAP,"[437, 457, 533, 602, 926, 1116, 1318, 1568, 1764, 1994, 2033, 2107, 2159, 2269, 2354, 2674, 2756, 2793, 2864, 2999, 3092, 3352, 3392, 3440, 3535, 3667, 3782, 3844, 3996, 4009, 4024, 4731, 5074, 5241, 5262]","[1568, 1764, 1994, 2354, 2999, 3392, 3667, 3996]","[437, 457, 533, 602, 926, 1116, 1318, 2033, 2107, 2159, 2269, 2674, 2756, 2793, 2864, 3092, 3352, 3440, 3535, 3782, 3844, 4009, 4024, 4731, 5074, 5241, 5262]","[1568, 1764, 1994, 2354, 2606, 2999, 3157, 3392, 3667, 3996]",5392,35,5357,8,27,5355,2
4.0,BOVIRBP,"[129, 552, 994, 2388, 2586, 2649, 2769, 3174, 3723, 3801, 4176, 4212, 4571, 4806, 4970, 4983, 5048, 5349, 5507, 5595, 5643, 5761, 5857, 6214, 6494, 6540, 7416, 7669, 7699, 7773, 8937, 9190, 9309, 9959, 10082, 10749, 10841, 11020]","[3174, 5595, 7699]","[129, 552, 994, 2388, 2586, 2649, 2769, 3723, 3801, 4176, 4212, 4571, 4806, 4970, 4983, 5048, 5349, 5507, 5643, 5761, 5857, 6214, 6494, 6540, 7416, 7669, 7773, 8937, 9190, 9309, 9959, 10082, 10749, 10841, 11020]","[3174, 5595, 7699]",11786,38,11748,3,35,11748,0
4.0,BOVLHB,"[244, 592, 761, 803, 944, 1062, 1272, 1401, 1460]","[803, 1272]","[244, 592, 761, 944, 1062, 1401, 1460]","[803, 1272]",1857,9,1848,2,7,1848,0
4.0,BOVLYSOZMA,"[322, 397, 944, 2089, 2115, 2268, 2374, 2973, 3039, 3208, 3255, 3424, 3672, 4100, 4372, 4694, 5256, 5771, 5936, 5955, 6973, 7260, 7512, 7928, 8632, 8654, 9247, 9304, 9453, 10062, 10799]","[3039, 5771, 8654]","[322, 397, 944, 2089, 2115, 2268, 2374, 2973, 3208, 3255, 3424, 3672, 4100, 4372, 4694, 5256, 5936, 5955, 6973, 7260, 7512, 7928, 8632, 9247, 9304, 9453, 10062, 10799]","[3039, 5771, 8654]",12215,31,12184,3,28,12184,0
4.0,BOVLYSOZMB,"[35, 140, 461, 646, 1229, 1662, 1890, 1993, 2607, 2673, 2843, 3007, 3717, 3743, 4005, 4135, 4797, 5148, 5241, 5732, 6190, 6212, 6807, 6917, 6928, 7058, 7511, 8185, 9580, 10002]","[2673, 4005, 6212]","[35, 140, 461, 646, 1229, 1662, 1890, 1993, 2607, 2843, 3007, 3717, 3743, 4135, 4797, 5148, 5241, 5732, 6190, 6807, 6917, 6928, 7058, 7511, 8185, 9580, 10002]","[2673, 4005, 6212]",10205,30,10175,3,27,10175,0
4.0,BOVLYSOZMC,"[839, 905, 1086, 1274, 1708, 2107, 2323, 2933, 3388, 4172, 4194, 4908, 4941, 4964, 5325, 6235, 6245, 6302]","[905, 2323, 4194]","[839, 1086, 1274, 1708, 2107, 2933, 3388, 4172, 4908, 4941, 4964, 5325, 6235, 6245, 6302]","[905, 2323, 4194]",8044,18,8026,3,15,8026,0
4.0,BOVMYF5A,"[273, 698, 1398, 1433, 1625, 1824, 2273, 2815, 2895, 3199, 3947, 4171, 4583, 4629, 4829, 4851]","[698, 1625]","[273, 1398, 1433, 1824, 2273, 2815, 2895, 3199, 3947, 4171, 4583, 4629, 4829, 4851]","[698, 1625]",5212,16,5196,2,14,5196,0
4.0,BRHOX22,"[600, 843, 1431, 1815, 2301, 2493]",[1431],"[600, 843, 1815, 2301, 2493]",[1431],3435,6,3429,1,5,3429,0
4.0,BRHOX34A,"[64, 460, 588, 981, 1190, 1359, 1751, 1819, 2313, 2675, 3491]",[981],"[64, 460, 588, 1190, 1359, 1751, 1819, 2313, 2675, 3491]",[981],3491,11,3480,1,10,3480,0
4.0,BRU12895,"[793, 799, 1135, 1526, 1986, 2140, 2232, 2341]",[1135],"[793, 799, 1526, 1986, 2140, 2232, 2341]",[1135],3233,8,3225,1,7,3225,0
4.0,BTATPAAA,"[55, 296, 740, 826, 1146, 1166, 1200, 2314, 2377, 2501, 2615, 2761, 2829, 3383, 3387, 3707, 4106, 4183, 4188, 5345, 5556, 5729, 5886, 5953, 6155, 6472, 7693, 7770, 7885, 8023, 8311, 8831, 9129, 9211, 9733, 9844, 9848]","[740, 2314, 3707, 5729, 7770, 8023, 9129]","[55, 296, 826, 1146, 1166, 1200, 2377, 2501, 2615, 2761, 2829, 3383, 3387, 4106, 4183, 4188, 5345, 5556, 5886, 5953, 6155, 6472, 7693, 7885, 8311, 8831, 9211, 9733, 9844, 9848]","[740, 2314, 3707, 5729, 5984, 6337, 6827, 7151, 7770, 8023, 9129]",9908,37,9871,7,30,9867,4
4.0,BTEBGL2,"[201, 294, 310, 327, 611, 658, 766, 920, 1171, 1254]","[310, 658]","[201, 294, 327, 611, 766, 920, 1171, 1254]","[310, 658]",1834,10,1824,2,8,1824,0
4.0,BTEBGL4,"[201, 294, 310, 327, 611, 658, 763, 815]","[310, 658]","[201, 294, 327, 611, 763, 815]","[310, 658]",1829,8,1821,2,6,1821,0
4.0,BTGL01,"[98, 176, 327, 349, 365, 369, 873, 910, 961, 1008]","[365, 1008]","[98, 176, 327, 349, 369, 873, 910, 961]","[365, 1008]",2041,10,2031,2,8,2031,0
4.0,BTHOR02,"[16, 169, 484, 1123, 1936]",[484],"[16, 169, 1123, 1936]","[484, 1920]",2420,5,2415,1,4,2414,1
4.0,BTKER6B,"[826, 1008, 1355, 1593, 1678, 1820, 1830, 1925, 2044, 2171, 2219, 2346, 2559, 2913, 2926, 3070, 3530, 4056, 4335, 4666, 5608, 5686]","[1678, 2559, 3070, 3530, 4056, 4666]","[826, 1008, 1355, 1593, 1820, 1830, 1925, 2044, 2171, 2219, 2346, 2913, 2926, 4335, 5608, 5686]","[1678, 2559, 3070, 3315, 3530, 4056, 4666]",5719,22,5697,6,16,5696,1
4.0,BTSPDNA,"[84, 685, 960, 1054, 1546, 2123]",[],"[84, 685, 960, 1054, 1546, 2123]",[1541],2149,6,2143,0,6,2142,1
4.0,BTSVSP109,"[52, 353, 799, 1357, 1452, 1604, 2189, 2359, 2387, 2555, 5292, 5315, 5643, 6096, 6131, 6240, 6451, 6730]","[2359, 5292]","[52, 353, 799, 1357, 1452, 1604, 2189, 2387, 2555, 5315, 5643, 6096, 6131, 6240, 6451, 6730]","[2359, 3984, 5292]",6949,18,6931,2,16,6930,1
4.0,BTTNP2G,"[24, 710, 774, 847, 852, 1029, 1115, 1326, 1342]",[774],"[24, 710, 847, 852, 1029, 1115, 1326, 1342]",[774],1842,9,1833,1,8,1833,0
4.0,BTU02285,"[21, 434, 1858, 2131, 2334, 2367, 2873, 2980, 3792, 3866, 4169, 4222, 4487, 4780, 5056, 5087, 5654, 6075]","[3792, 4222, 4487, 4780, 5056]","[21, 434, 1858, 2131, 2334, 2367, 2873, 2980, 3866, 4169, 5087, 5654, 6075]","[3792, 4222, 4487, 4780, 5056]",6389,18,6371,5,13,6371,0
4.0,CALEGLOBIM,"[220, 236, 345, 540, 587, 603, 1185, 1197, 1293, 1312]","[236, 587]","[220, 345, 540, 603, 1185, 1197, 1293, 1312]","[236, 587]",1691,10,1681,2,8,1681,0
4.0,CBUEGLOBIM,"[220, 236, 345, 540, 587, 603, 874, 1185, 1197, 1293, 1312]","[236, 587]","[220, 345, 540, 603, 874, 1185, 1197, 1293, 1312]","[236, 587]",1691,11,1680,2,9,1680,0
4.0,CCALAC,"[436, 797, 932, 1128, 1178, 1358, 1798, 1852, 1994, 2409, 2973, 3275, 3279, 3333, 3397]","[1358, 1852, 2409]","[436, 797, 932, 1128, 1178, 1798, 1994, 2973, 3275, 3279, 3333, 3397]","[1358, 1852, 2409]",3620,15,3605,3,12,3605,0
4.0,CCBEGLOBIM,"[221, 237, 540, 587, 1191, 1203, 1318]","[237, 587]","[221, 540, 1191, 1203, 1318]","[237, 587]",1696,7,1689,2,5,1689,0
4.0,CCBEGLOBIN,"[222, 238, 542, 589, 1194, 1206, 1321]","[238, 589]","[222, 542, 1194, 1206, 1321]","[238, 589]",1699,7,1692,2,5,1692,0
4.0,CCGHG,"[283, 863, 1051, 1281, 1389, 1778, 2305]","[283, 1051, 1778]","[863, 1281, 1389, 2305]","[283, 706, 1051, 1778]",2831,7,2824,3,4,2823,1
4.0,CCGONBS1,"[431, 1599, 1767, 1974, 2688]",[1767],"[431, 1599, 1974, 2688]","[1767, 2072]",3464,5,3459,1,4,3458,1
4.0,CCGONBS2,"[433, 1617, 1785, 1993, 2707]",[1785],"[433, 1617, 1993, 2707]","[1785, 2091]",3483,5,3478,1,4,3477,1
4.0,CCGTHA1,"[26, 166, 302, 390, 1104]",[302],"[26, 166, 390, 1104]","[302, 572]",1145,5,1140,1,4,1139,1
4.0,CCT64CLU,"[274, 563, 1644, 1664, 2757, 2761, 2766, 3005, 3496, 3893, 4436, 4514, 4518, 4572, 4577, 4600, 5272, 5528, 5659, 6121, 6277]","[1644, 2757, 3005, 3496, 4514, 5272, 5659]","[274, 563, 1664, 2761, 2766, 3893, 4436, 4518, 4572, 4577, 4600, 5528, 6121, 6277]","[1644, 2757, 3005, 3496, 4514, 5272, 5659]",6278,21,6257,7,14,6257,0
4.0,CEPPINS,"[490, 858, 1399, 1509, 1513, 1517, 1760]",[858],"[490, 1399, 1509, 1513, 1517, 1760]",[858],1902,7,1895,1,6,1895,0
4.0,CHBLG,"[166, 698, 928, 932, 1465, 1472, 2301, 2308, 2564, 2807, 3030, 3640, 3788, 3794, 4019, 4266, 4298, 4302, 4700, 4861, 4919, 5246, 5573, 5619, 5756, 6025, 6255, 6280, 6376]","[4019, 5246, 6025]","[166, 698, 928, 932, 1465, 1472, 2301, 2308, 2564, 2807, 3030, 3640, 3788, 3794, 4266, 4298, 4302, 4700, 4861, 4919, 5573, 5619, 5756, 6255, 6280, 6376]","[2285, 3090, 4019, 5246, 6025]",8081,29,8052,3,26,8050,2
4.0,CHEBGLI,"[456, 862, 909, 1213, 1821, 1868]",[909],"[456, 862, 1213, 1821, 1868]","[570, 909]",2206,6,2200,1,5,2199,1
4.0,CHEBGLII,"[454, 547, 563, 580, 912, 923, 1020, 1049, 1426]","[563, 912]","[454, 547, 580, 923, 1020, 1049, 1426]","[563, 912]",2260,9,2251,2,7,2251,0
4.0,CHKALDB,"[606, 1062, 1452, 1506, 1912, 1922, 1927, 2460, 2629, 2878, 3077, 3115, 4004, 4388, 4462, 4802, 5731, 5748, 6172, 6452, 6664, 6955, 6960, 6983, 7360, 7487, 7504, 7523, 7600, 8170, 8186, 8617, 9185, 9626, 10415, 10577, 10705, 10844]","[6172, 6664, 6955, 8186, 9185]","[606, 1062, 1452, 1506, 1912, 1922, 1927, 2460, 2629, 2878, 3077, 3115, 4004, 4388, 4462, 4802, 5731, 5748, 6452, 6960, 6983, 7360, 7487, 7504, 7523, 7600, 8170, 8617, 9626, 10415, 10577, 10705, 10844]","[6172, 6664, 6955, 7265, 8186, 8842, 9185]",11644,38,11606,5,33,11604,2
4.0,CHKAPOII,"[282, 1246, 1328, 1339, 1839, 1891, 1901, 2131, 2798, 3317, 3381, 3820, 3975, 4026, 4488]","[3317, 3820]","[282, 1246, 1328, 1339, 1839, 1891, 1901, 2131, 2798, 3381, 3975, 4026, 4488]","[3317, 3820]",4954,15,4939,2,13,4939,0
4.0,CHKDPCP,"[347, 637, 1624, 1878]",[637],"[347, 1624, 1878]",[637],1903,4,1899,1,3,1899,0
4.0,CHKMAX,"[27, 632, 1236, 1299, 1816, 2127, 2291, 2712, 2882, 3172, 3189, 3400, 3764, 3768, 3928, 4295, 4931, 5134, 5173, 5407]","[2127, 2291, 3928, 4295]","[27, 632, 1236, 1299, 1816, 2712, 2882, 3172, 3189, 3400, 3764, 3768, 4931, 5134, 5173, 5407]","[2127, 2291, 3928, 4295]",5691,20,5671,4,16,5671,0
4.0,CHKMYOD,"[316, 984, 1166, 1268, 1738, 2106, 2292, 3066, 3379, 3468, 4038, 4849, 4941, 5145, 5517, 5592, 5660, 6150, 6284, 6456, 6527]","[4941, 6150]","[316, 984, 1166, 1268, 1738, 2106, 2292, 3066, 3379, 3468, 4038, 4849, 5145, 5517, 5592, 5660, 6284, 6456, 6527]","[4941, 6150]",7382,21,7361,2,19,7361,0
4.0,CHKOVAL,"[368, 1293, 1390, 2449, 2657, 3164, 3466, 3812, 3915, 4176, 4694, 4890, 4915, 5144, 5170, 6282, 6975, 7079, 7148, 7178, 7691, 8125, 8334, 8410, 8791, 9028]","[3164, 3466, 4176, 4694, 6282]","[368, 1293, 1390, 2449, 2657, 3812, 3915, 4890, 4915, 5144, 5170, 6975, 7079, 7148, 7178, 7691, 8125, 8334, 8410, 8791, 9028]","[3164, 3466, 4176, 4694, 5795, 6282]",9199,26,9173,5,21,9172,1
4.0,CHKRPL30,"[545, 571, 671, 749, 801, 916, 1471, 1684, 1778, 1872, 2113, 2158, 2250, 2753, 2816, 2850, 3799]","[801, 1872, 2753]","[545, 571, 671, 749, 916, 1471, 1684, 1778, 2113, 2158, 2250, 2816, 2850, 3799]","[801, 1872, 2753]",3885,17,3868,3,14,3868,0
4.0,CHKRPL37A,"[16, 201, 798, 996, 1265, 1376, 1558, 1618, 1946, 2079, 2125, 2255, 2386, 2739, 3052, 3179, 3376]","[798, 1376, 2386]","[16, 201, 996, 1265, 1558, 1618, 1946, 2079, 2125, 2255, 2739, 3052, 3179, 3376]","[798, 1376, 2386]",3466,17,3449,3,14,3449,0
4.0,CHKRPL5G,"[99, 153, 300, 1419, 1540, 1632, 2138, 2397, 2428, 2618, 3157, 3433, 3467, 4259, 4309, 5165, 6064, 6897, 7986]","[1419, 1632, 3157, 5165, 6897]","[99, 153, 300, 1540, 2138, 2397, 2428, 2618, 3433, 3467, 4259, 4309, 6064, 7986]","[498, 1419, 1632, 3157, 3955, 5165, 6897]",8314,19,8295,5,14,8293,2
4.0,CHKTUB4B,"[243, 264, 437, 762, 779, 849, 949, 1188, 1199, 1469, 1573, 1895]","[437, 949, 1573]","[243, 264, 762, 779, 849, 1188, 1199, 1469, 1895]","[437, 949, 1573]",3146,12,3134,3,9,3134,0
4.0,CHKY,"[214, 319, 641, 695, 794, 1650, 1664, 2096, 2197, 2725, 2730, 2858, 3082, 3577, 3603, 3953, 4199, 4683, 4750, 5049, 5186, 5213, 5648, 6012, 6249, 6473, 7072, 8349, 8361]","[3603, 4199, 4683, 5648, 6012, 6249]","[214, 319, 641, 695, 794, 1650, 1664, 2096, 2197, 2725, 2730, 2858, 3082, 3577, 3953, 4750, 5049, 5186, 5213, 6473, 7072, 8349, 8361]","[3603, 4199, 4683, 5648, 6012, 6249]",8365,29,8336,6,23,8336,0
4.0,CHPPHYGEN,"[22, 543, 555, 1736, 1818, 1830, 2214, 2284, 2350, 2485, 3020, 3764, 3786, 4096, 4387, 4561, 4599, 4945, 5459, 5471, 5521, 6609, 6693, 6791, 7000, 7072, 7138, 7843, 8472, 8746, 8823, 8841, 8862, 9306, 9395, 9894, 9910, 10066, 10818, 10833, 10849, 10853, 11000, 11193, 11685, 11689, 11693, 11811, 11828, 11903, 11936, 12560, 12575, 12603, 13318, 13493, 13548]","[4599, 4945]","[22, 543, 555, 1736, 1818, 1830, 2214, 2284, 2350, 2485, 3020, 3764, 3786, 4096, 4387, 4561, 5459, 5471, 5521, 6609, 6693, 6791, 7000, 7072, 7138, 7843, 8472, 8746, 8823, 8841, 8862, 9306, 9395, 9894, 9910, 10066, 10818, 10833, 10849, 10853, 11000, 11193, 11685, 11689, 11693, 11811, 11828, 11903, 11936, 12560, 12575, 12603, 13318, 13493, 13548]","[4599, 4945]",13690,57,13633,2,55,13633,0
4.0,CHPPROTP1A,"[58, 159]",[159],[58],[159],398,2,396,1,1,396,0
4.0,CHPPROTP1B,"[56, 160]",[160],[56],[160],397,2,395,1,1,395,0
4.0,CHWEGLOBIM,"[221, 237, 541, 588, 1193, 1319]","[237, 588]","[221, 541, 1193, 1319]","[237, 588]",1702,6,1696,2,4,1696,0
4.0,CIGH,"[457, 1249, 1281, 2029, 2130, 2280, 2536, 2889]","[1281, 2280, 2889]","[457, 1249, 2029, 2130, 2536]","[1281, 1691, 2280, 2889]",3968,8,3960,3,5,3959,1
4.0,CITEGLOBIM,"[220, 236, 345, 540, 587, 603, 890, 894, 1186, 1198, 1294, 1313]","[236, 587]","[220, 345, 540, 603, 890, 894, 1186, 1198, 1294, 1313]","[236, 587]",1692,12,1680,2,10,1680,0
4.0,CJAEGLOBIN,"[221, 237, 541, 588, 1193, 1319]","[237, 588]","[221, 541, 1193, 1319]","[237, 588]",1703,6,1697,2,4,1697,0
4.0,CJINTERFG,"[191, 1143, 2428, 2635, 2881, 3158, 3303, 4125, 4187, 4465, 4702, 4730, 4734, 4750, 5524, 5822, 6036, 6127, 6760, 6901, 7468, 7647, 8152, 8324, 8352, 8486]","[2881, 4187, 4465]","[191, 1143, 2428, 2635, 3158, 3303, 4125, 4702, 4730, 4734, 4750, 5524, 5822, 6036, 6127, 6760, 6901, 7468, 7647, 8152, 8324, 8352, 8486]","[2881, 4187, 4465]",8520,26,8494,3,23,8494,0
4.0,CL54K,"[119, 141, 183, 512, 535, 543, 649, 653, 706, 771, 959, 1177, 1190, 1238, 1294, 1538, 1926, 2581, 2696, 2715, 2726, 2797, 2954, 3218]",[512],"[119, 141, 183, 535, 543, 649, 653, 706, 771, 959, 1177, 1190, 1238, 1294, 1538, 1926, 2581, 2696, 2715, 2726, 2797, 2954, 3218]",[512],3409,24,3385,1,23,3385,0
4.0,CMBGA2B2,"[383, 718, 810, 989, 1597]","[383, 718]","[810, 989, 1597]","[383, 718]",2685,5,2680,2,3,2680,0
4.0,CMEGA2E2,"[416, 492, 718, 753]","[416, 753]","[492, 718]","[416, 753]",2047,4,2043,2,2,2043,0
4.0,CMU11711,"[15, 204, 790, 826, 906, 1647, 1685, 1984, 2031, 2627, 2669, 2741]","[1685, 2031]","[15, 204, 790, 826, 906, 1647, 1984, 2627, 2669, 2741]","[1685, 2031]",3165,12,3153,2,10,3153,0
4.0,CPPROT1GN,"[102, 164, 255]",[164],"[102, 255]",[164],391,3,388,1,2,388,0
4.0,CRASEQB,"[79, 669, 783, 1920, 2825, 3434, 3452, 3464, 3482, 3593, 3635, 3641, 3647, 4825, 4931]","[1920, 2825]","[79, 669, 783, 3434, 3452, 3464, 3482, 3593, 3635, 3641, 3647, 4825, 4931]","[1920, 2825]",5121,15,5106,2,13,5106,0
4.0,CRUCH7AHYD,"[37, 1205, 1339, 1731, 2936, 2941, 3016, 3151, 3418, 3651, 3792, 3841, 4121, 4774, 5283, 5559, 6076, 6613, 6819, 7135, 7866, 7901, 9375, 9626, 10316, 10564]","[1731, 3651, 6076, 7866]","[37, 1205, 1339, 2936, 2941, 3016, 3151, 3418, 3792, 3841, 4121, 4774, 5283, 5559, 6613, 6819, 7135, 7901, 9375, 9626, 10316, 10564]","[1731, 3651, 4938, 6076, 7866]",10607,26,10581,4,22,10580,1
4.0,CRUGAD45A,"[208, 215, 691, 859, 1811, 1877, 1971, 2063, 2417, 2553, 3428, 3555, 3605, 4003]","[1877, 2063, 2417]","[208, 215, 691, 859, 1811, 1971, 2553, 3428, 3555, 3605, 4003]","[1877, 2063, 2417]",4428,14,4414,3,11,4414,0
4.0,DMPROTP1,[249],[249],[],[249],617,1,616,1,0,616,0
4.0,DMU11712,"[16, 182, 792, 1405, 1667, 1705, 1996, 2043, 2685, 2757]","[1705, 2043]","[16, 182, 792, 1405, 1667, 1996, 2685, 2757]","[1705, 2043]",3020,10,3010,2,8,3010,0
4.0,DOGCOLIP,"[224, 249, 416, 789, 1108, 1343, 1411, 1747, 2378, 2503, 2508, 2694, 2821, 2839]","[1108, 2378]","[224, 249, 416, 789, 1343, 1411, 1747, 2503, 2508, 2694, 2821, 2839]","[1108, 2378]",3157,14,3143,2,12,3143,0
4.0,DOGIL8T,"[118, 671, 1206, 1406, 1769, 1918]","[118, 1406, 1769]","[671, 1206, 1918]","[118, 1406, 1769]",2230,6,2224,3,3,2224,0
4.0,ECGLOAP1,"[363, 657, 889, 962, 968]","[363, 657]","[889, 962, 968]","[363, 657]",1134,5,1129,2,3,1129,0
4.0,ECPZA2GL,"[193, 767, 954, 1560, 1585, 1600, 1615, 1623, 1648, 1675, 1728, 2012, 2153, 2166, 2613, 3527, 3576, 3650, 3945, 4059, 5046, 5060]","[3576, 4059]","[193, 767, 954, 1560, 1585, 1600, 1615, 1623, 1648, 1675, 1728, 2012, 2153, 2166, 2613, 3527, 3650, 3945, 5046, 5060]","[3576, 4059]",5082,22,5060,2,20,5060,0
4.0,ECZGL1,"[700, 725, 740, 755, 763, 845, 874, 1033, 1534]","[700, 1534]","[725, 740, 755, 763, 845, 874, 1033]","[700, 1534]",1995,9,1986,2,7,1986,0
4.0,ECZGL2,"[255, 280, 295, 310, 318, 400, 429, 588, 1084]","[255, 1084]","[280, 295, 310, 318, 400, 429, 588]","[255, 1084]",1556,9,1547,2,7,1547,0
4.0,ELMETL,"[1097, 1291, 1518]","[1097, 1291]",[1518],"[1097, 1291]",1866,3,1863,2,1,1863,0
4.0,FDFELDI2,"[276, 641, 678, 703, 1070, 1882, 2011, 2149]",[276],"[641, 678, 703, 1070, 1882, 2011, 2149]","[276, 970]",2418,8,2410,1,7,2409,1
4.0,FDTNFA,"[187, 291, 547, 790, 885, 972, 1590]","[187, 790, 972]","[291, 547, 885, 1590]","[187, 790, 972]",1715,7,1708,3,4,1708,0
4.0,GDMYF5G,"[138, 524, 639, 655, 1036, 1104]","[639, 1036]","[138, 524, 655, 1104]","[639, 1036]",1602,6,1596,2,4,1596,0
4.0,GGAC01,"[22, 116, 273, 443, 634, 774, 778, 833, 914, 970, 1119, 1343, 1586, 1666, 1716, 1999, 2050, 2226, 2261, 2602, 2687, 2782, 3189, 3330, 3338, 3495, 3561, 3677, 3831, 3857, 4055, 4499, 4695]","[1666, 2226, 3189, 3677]","[22, 116, 273, 443, 634, 774, 778, 833, 914, 970, 1119, 1343, 1586, 1716, 1999, 2050, 2261, 2602, 2687, 2782, 3330, 3338, 3495, 3561, 3831, 3857, 4055, 4499, 4695]","[1666, 2226, 3189, 3677]",5039,33,5006,4,29,5006,0
4.0,GGACTAC,"[339, 351, 533, 970, 1266, 1554, 1815, 1866, 2074, 2127, 2277, 2520, 2914, 3032, 3218, 4216, 4398, 5278]","[970, 2127, 2914, 3218, 4398]","[339, 351, 533, 1266, 1554, 1815, 1866, 2074, 2277, 2520, 3032, 4216, 5278]","[970, 2127, 2914, 3218, 4398]",5456,18,5438,5,13,5438,0
4.0,GGACTI,"[153, 525, 529, 580, 788, 841, 1030, 1368, 1554, 1659, 1841]","[841, 1554, 1841]","[153, 525, 529, 580, 788, 1030, 1368, 1659]","[404, 841, 1137, 1554, 1841]",2419,11,2408,3,8,2406,2
4.0,GGCALB,"[386, 416, 421, 589, 596, 866, 1016, 1292, 1542, 1863, 2289, 3062, 3467, 3509, 3617, 3629, 3793, 4235, 4414, 4894, 5205, 5262, 5524, 5867, 5933, 6149, 6694, 6784, 7035, 7824, 7865, 8249, 8718, 8722, 8776, 8829, 9052, 9685, 10030, 10195, 10530, 10551]","[386, 1863, 2289, 3467, 3793, 4235, 4894, 5205, 5933, 6784, 7035, 7824, 8718, 9052, 9685, 10195]","[416, 421, 589, 596, 866, 1016, 1292, 1542, 3062, 3509, 3617, 3629, 4414, 5262, 5524, 5867, 6149, 6694, 7865, 8249, 8722, 8776, 8829, 10030, 10530, 10551]","[386, 1863, 2289, 3467, 3793, 4235, 4894, 5205, 5933, 6784, 7035, 7824, 8718, 9052, 9685, 10195]",11061,42,11019,16,26,11019,0
4.0,GGCRYD1,"[217, 267, 441, 910, 2077, 2085, 2539, 2742, 3516, 3944, 4297, 4332, 4528, 4907, 5234, 5498, 5899, 6003, 6138, 6395, 6734, 6791, 6829, 7213, 7373, 7435, 7529, 7779]","[441, 2742, 3516, 3944, 4332, 4528, 4907, 5234, 5899, 6138, 6395, 6734, 7213]","[217, 267, 910, 2077, 2085, 2539, 4297, 5498, 6003, 6791, 6829, 7373, 7435, 7529, 7779]","[441, 1734, 2742, 3150, 3516, 3944, 4332, 4528, 4907, 5234, 5899, 6138, 6395, 6734, 7213]",8153,28,8125,13,15,8123,2
4.0,GGGL03,"[432, 768, 1160]","[432, 768]",[1160],"[432, 768]",1201,3,1198,2,1,1198,0
4.0,GGGNRHIA,"[338, 1684, 1950, 2787, 2822, 2951, 3048, 3422, 3627, 4195, 4392, 4472, 4544, 5111, 5575, 5640, 6095]","[3627, 4392]","[338, 1684, 1950, 2787, 2822, 2951, 3048, 3422, 4195, 4472, 4544, 5111, 5575, 5640, 6095]","[3627, 4392]",6275,17,6258,2,15,6258,0
4.0,GGNFM1D,"[859, 932, 1295, 1541, 2051, 2285, 2451, 3184, 3354, 3448, 3595, 4194, 4284, 4395, 4596, 4656, 4746, 4768, 4851, 5057]",[2451],"[859, 932, 1295, 1541, 2051, 2285, 3184, 3354, 3448, 3595, 4194, 4284, 4395, 4596, 4656, 4746, 4768, 4851, 5057]","[2132, 2451]",5631,20,5611,1,19,5610,1
4.0,GGPROP2,"[51, 564]",[],"[51, 564]",[307],641,2,639,0,2,638,1
4.0,GGRIHBGEN,"[202, 219, 254, 676, 961, 981, 1038, 1973, 2050, 2450, 2863, 2982, 3219, 3317, 3394, 3411, 3454]","[2982, 3219, 3454]","[202, 219, 254, 676, 961, 981, 1038, 1973, 2050, 2450, 2863, 3317, 3394, 3411]","[2982, 3219, 3454]",3879,17,3862,3,14,3862,0
4.0,GGVITIIG,"[54, 190, 442, 830, 1146, 1596, 2561, 2694, 2698, 2948, 2952, 2977, 3064, 3138, 3145, 3267, 3791, 4295, 4818, 4876, 5129, 5441, 5848, 6062, 6229, 6408, 6443, 7045, 7123, 7127, 7740, 8026, 8302, 8481, 9149, 9439, 9467, 10448, 10618, 10703, 10714, 10930, 10951, 10971, 11663, 11667, 12272, 12547, 12791, 13267, 13505, 13819, 14077, 14139, 14252, 14413, 14589, 15348, 15710, 15771, 15880, 16552, 16955, 17013, 17019, 17193, 17299, 17447, 17481, 17492, 17815, 17864, 17913, 18132, 18829, 18882, 19081, 19128, 19337, 19348, 19933, 20096, 20126]","[54, 190, 442, 2694, 2948, 3267, 3791, 4818, 5441, 6229, 6443, 7045, 8026, 8302, 9149, 9467, 10448, 10714, 12272, 13267, 13505, 15348, 15771, 16955, 17864, 19081]","[830, 1146, 1596, 2561, 2698, 2952, 2977, 3064, 3138, 3145, 4295, 4876, 5129, 5848, 6062, 6408, 7123, 7127, 7740, 8481, 9439, 10618, 10703, 10930, 10951, 10971, 11663, 11667, 12547, 12791, 13819, 14077, 14139, 14252, 14413, 14589, 15710, 15880, 16552, 17013, 17019, 17193, 17299, 17447, 17481, 17492, 17815, 17913, 18132, 18829, 18882, 19128, 19337, 19348, 19933, 20096, 20126]","[54, 190, 442, 2021, 2694, 2948, 3267, 3543, 3791, 4818, 5441, 6229, 6443, 7045, 7268, 8026, 8302, 9149, 9467, 10104, 10448, 10714, 11757, 12272, 12615, 13267, 13505, 14028, 14704, 15348, 15771, 16955, 17864, 19081]",20336,83,20253,26,57,20245,8
4.0,GIBPROTP1A,"[56, 160, 260]",[160],"[56, 260]",[160],394,3,391,1,2,391,0
4.0,GORAFPA,"[75, 999, 1243, 1860, 1939, 2163, 2232, 2395, 2871, 2955, 3434, 3684, 4002, 4151, 4192, 4232, 4363, 4369, 4564, 4596, 4757, 5457, 5550, 5602, 6121, 6760, 6976, 7046, 7156, 7445, 7766, 7795, 8370, 8836, 10041, 10310, 10422, 10727, 10815, 10903, 11145, 11629, 11737, 11823, 12491, 12575, 13421, 14087, 14183, 14424, 14496, 14672, 14707, 15801, 15935, 15952, 17195, 17207, 17601, 17834, 19231, 19676, 20297, 20427, 20474, 20478, 20718, 21186, 21207, 22550, 23229, 23233, 23613, 23763, 23937, 24387]","[999, 1860, 2955, 5457, 6760, 7766, 11629, 13421, 14087, 14707, 17834]","[75, 1243, 1939, 2163, 2232, 2395, 2871, 3434, 3684, 4002, 4151, 4192, 4232, 4363, 4369, 4564, 4596, 4757, 5550, 5602, 6121, 6976, 7046, 7156, 7445, 7795, 8370, 8836, 10041, 10310, 10422, 10727, 10815, 10903, 11145, 11737, 11823, 12491, 12575, 14183, 14424, 14496, 14672, 15801, 15935, 15952, 17195, 17207, 17601, 19231, 19676, 20297, 20427, 20474, 20478, 20718, 21186, 21207, 22550, 23229, 23233, 23613, 23763, 23937, 24387]","[999, 1860, 2955, 5457, 6760, 7766, 9445, 11629, 13421, 14087, 14707, 16581, 17834]",24600,76,24524,11,65,24522,2
4.0,GORPROTP1A,"[60, 164]",[164],[60],[164],405,2,403,1,1,403,0
4.0,GPIINS,"[526, 587]",[526],[587],[526],1465,2,1463,1,1,1463,0
4.0,HAMAMYLP,"[48, 1394, 1473, 1549, 1794, 2308, 3415, 3934, 4561, 5045, 5424]",[2308],"[48, 1394, 1473, 1549, 1794, 3415, 3934, 4561, 5045, 5424]",[2308],5948,11,5937,1,10,5937,0
4.0,HAMHG5,"[640, 781, 1373, 1640, 1817, 1905, 1919, 2464, 2817, 3433, 3461, 3620, 3950, 4662, 4856, 5603, 6188, 6597, 7156, 7240, 7287, 7441, 7668, 8258, 8295, 8396, 9231]","[4856, 6188, 6597, 7441]","[640, 781, 1373, 1640, 1817, 1905, 1919, 2464, 2817, 3433, 3461, 3620, 3950, 4662, 5603, 7156, 7240, 7287, 7668, 8258, 8295, 8396, 9231]","[4856, 5517, 6188, 6597, 7441]",9712,27,9685,4,23,9684,1
4.0,HROAMD1,"[237, 289, 1072, 1585, 2687, 3486, 3494, 3830, 4081, 4700, 4816, 5413, 5723, 5734, 5795, 5962, 6212, 6863, 6983]","[2687, 3486, 4700]","[237, 289, 1072, 1585, 3494, 3830, 4081, 4816, 5413, 5723, 5734, 5795, 5962, 6212, 6863, 6983]","[2687, 3486, 4700]",7092,19,7073,3,16,7073,0
4.0,HROMA2,"[358, 427, 686, 739, 1174, 1285, 1351]","[739, 1174]","[358, 427, 686, 1285, 1351]","[739, 1174]",1780,7,1773,2,5,1773,0
4.0,HROMA4A,"[727, 1055, 1108, 1670, 1774, 1840, 2287]","[1108, 1670]","[727, 1055, 1774, 1840, 2287]","[1108, 1670]",2332,7,2325,2,5,2325,0
4.0,HRSPRMI,"[247, 416, 722, 1245, 1605, 1880, 2047]",[722],"[247, 416, 1245, 1605, 1880, 2047]",[722],2199,7,2192,1,6,2192,0
4.0,HS1D3HLH,"[173, 757, 1039, 1231, 1634, 2146]",[1039],"[173, 757, 1231, 1634, 2146]",[1039],2474,6,2468,1,5,2468,0
4.0,HS2OXOC,"[116, 1162, 1421, 1451, 1694, 1719, 1825, 1894, 2227]","[116, 1162, 1421, 1694, 1825]","[1451, 1719, 1894, 2227]","[116, 871, 1162, 1421, 1694, 1825]",2511,9,2502,5,4,2501,1
4.0,HSABLGR1,"[371, 749, 860, 902, 1080, 1236, 1670, 1981, 2265, 2923, 2977, 3130, 3140, 3344, 3683, 4148, 4166, 4321, 4479, 4506, 4528, 4865, 5108, 5218, 5284, 5312, 5465, 5666, 5890, 6125, 6508, 6567, 6743, 6820, 6977, 7197, 8039, 8356, 8470, 8720, 9075, 9294, 9310, 9340, 9367, 9507, 10016, 10073, 10400, 10413, 10509, 10539, 10623, 10950, 11090, 11094, 11118, 11135, 11167, 11354, 11597, 11929, 11951, 11988, 11992, 12007, 12239, 12434, 12880, 13058, 13875, 14754, 14973, 15060, 15400, 15514, 15741, 16572, 16943, 17116, 17249, 17886, 17991, 18028, 18211, 19158, 19244, 19282, 19672, 19728, 19816, 19906, 19972, 20007, 20105, 20282, 20665, 20991, 21219, 23084, 23472, 23507, 23851, 23938, 23981, 24042, 24277, 24298, 24805, 24896, 24979, 25292, 25849, 25902, 25906, 26127, 26145, 26288, 26300, 26789, 27114, 27158, 28260, 29268, 29760, 30552, 31027, 31031, 31138, 31182, 31307, 32296, 32399, 32910, 33591, 33629, 33787, 33826, 34121, 34153, 34563, 35331, 35464, 35562, 35751, 35835]","[8720, 10400, 12434, 15741, 17116, 17991]","[371, 749, 860, 902, 1080, 1236, 1670, 1981, 2265, 2923, 2977, 3130, 3140, 3344, 3683, 4148, 4166, 4321, 4479, 4506, 4528, 4865, 5108, 5218, 5284, 5312, 5465, 5666, 5890, 6125, 6508, 6567, 6743, 6820, 6977, 7197, 8039, 8356, 8470, 9075, 9294, 9310, 9340, 9367, 9507, 10016, 10073, 10413, 10509, 10539, 10623, 10950, 11090, 11094, 11118, 11135, 11167, 11354, 11597, 11929, 11951, 11988, 11992, 12007, 12239, 12880, 13058, 13875, 14754, 14973, 15060, 15400, 15514, 16572, 16943, 17249, 17886, 18028, 18211, 19158, 19244, 19282, 19672, 19728, 19816, 19906, 19972, 20007, 20105, 20282, 20665, 20991, 21219, 23084, 23472, 23507, 23851, 23938, 23981, 24042, 24277, 24298, 24805, 24896, 24979, 25292, 25849, 25902, 25906, 26127, 26145, 26288, 26300, 26789, 27114, 27158, 28260, 29268, 29760, 30552, 31027, 31031, 31138, 31182, 31307, 32296, 32399, 32910, 33591, 33629, 33787, 33826, 34121, 34153, 34563, 35331, 35464, 35562, 35751, 35835]","[8720, 10400, 12434, 14200, 15741, 17116, 17991]",35955,146,35809,6,140,35808,1
4.0,HSALDCG,"[88, 105, 148, 349, 555, 801, 1014, 1283, 2098, 2481, 2641, 2663, 3110, 3289, 3366, 3386, 3551, 3567, 3994, 4346, 4434]","[2641, 3110, 3366, 3567, 3994]","[88, 105, 148, 349, 555, 801, 1014, 1283, 2098, 2481, 2663, 3289, 3386, 3551, 4346, 4434]","[2641, 2939, 3110, 3366, 3567, 3994, 4326]",5191,21,5170,5,16,5168,2
4.0,HSAPC3A,"[110, 226, 636, 919, 1178, 1246, 1829, 2140, 2325, 2515, 2570, 2778, 3409, 3492, 3863, 3874, 4222, 4662, 4679, 5823]","[919, 1178]","[110, 226, 636, 1246, 1829, 2140, 2325, 2515, 2570, 2778, 3409, 3492, 3863, 3874, 4222, 4662, 4679, 5823]","[919, 1178]",6042,20,6022,2,18,6022,0
4.0,HSAPOA2B,"[152, 232, 245, 338, 490, 682, 698, 916, 1554, 1585]","[490, 916]","[152, 232, 245, 338, 682, 698, 1554, 1585]","[490, 916]",1748,10,1738,2,8,1738,0
4.0,HSAPOAIA,"[57, 317, 583, 661, 1397, 1799, 1849, 2090]","[317, 661]","[57, 583, 1397, 1799, 1849, 2090]","[317, 661]",2186,8,2178,2,6,2178,0
4.0,HSAPOAIT,"[120, 231, 491, 757, 835, 1572, 1974, 2024, 2265]","[491, 835]","[120, 231, 757, 1572, 1974, 2024, 2265]","[491, 835]",2378,9,2369,2,7,2369,0
4.0,HSAPOC2G,"[33, 231, 255, 606, 645, 727, 790, 946, 1276, 1494, 1505, 1553, 1971, 2021, 2148, 2191, 2346, 2358, 2479, 2714, 2943]",[2714],"[33, 231, 255, 606, 645, 727, 790, 946, 1276, 1494, 1505, 1553, 1971, 2021, 2148, 2191, 2346, 2358, 2479, 2943]","[2714, 3041]",3833,21,3812,1,20,3811,1
4.0,HSAQUPN2,"[431, 632, 917]","[431, 632]",[917],"[431, 632, 746]",988,3,985,2,1,984,1
4.0,HSARYLA,"[275, 459, 848, 1091, 1238, 1571, 1815, 1906, 1991, 2004, 2141, 2252, 2470, 2528, 2666, 3040, 3432]","[848, 1238, 1571, 1815, 2252, 2470]","[275, 459, 1091, 1906, 1991, 2004, 2141, 2528, 2666, 3040, 3432]","[848, 1238, 1571, 1815, 2252, 2470, 2823]",3630,17,3613,6,11,3612,1
4.0,HSAT3,"[327, 646, 655, 825, 2225, 2451, 2846, 3311, 4422, 4823, 4978, 5095, 5311, 5717, 6015, 6059, 6235, 6645, 6811, 6879, 6934, 7102, 7225, 7231, 8072, 8536, 8733, 9045, 9260, 9625, 9717, 9730, 10089, 10205, 10401, 10948, 11303, 11320, 11660, 11748, 12007, 12165, 12719, 12834, 13036, 13056, 13775]","[646, 3311, 6059, 7102, 10401]","[327, 655, 825, 2225, 2451, 2846, 4422, 4823, 4978, 5095, 5311, 5717, 6015, 6235, 6645, 6811, 6879, 6934, 7225, 7231, 8072, 8536, 8733, 9045, 9260, 9625, 9717, 9730, 10089, 10205, 10948, 11303, 11320, 11660, 11748, 12007, 12165, 12719, 12834, 13036, 13056, 13775]","[646, 3311, 6059, 7102, 8303, 10401]",14199,47,14152,5,42,14151,1
4.0,HSATPCP1,"[158, 496, 534, 673, 831, 989, 1257, 1518, 1680, 1838, 1994, 2258, 2691, 2846, 3013, 3169, 4036, 4080, 4245, 4773, 4843, 4975, 5389, 5394, 5525, 5934, 6382, 6830, 6843, 6860, 6999, 7267, 7698, 7854, 7927, 8207, 8529, 8701, 8714, 8947, 9101]","[5389, 6382, 7267]","[158, 496, 534, 673, 831, 989, 1257, 1518, 1680, 1838, 1994, 2258, 2691, 2846, 3013, 3169, 4036, 4080, 4245, 4773, 4843, 4975, 5394, 5525, 5934, 6830, 6843, 6860, 6999, 7698, 7854, 7927, 8207, 8529, 8701, 8714, 8947, 9101]","[5389, 6382, 7267]",9450,41,9409,3,38,9409,0
4.0,HSATPCP2,"[6, 107, 1546, 2402, 2996, 3624, 3721, 3890, 4013, 4738, 4743, 5066, 5367, 6152, 6504, 6916, 7310, 7490, 7768, 7851, 8252, 8957, 9194, 9212, 9611, 9627, 9637, 9689, 9752, 9790, 10099, 10195, 10918, 11516, 11530, 11602, 11686, 11693, 11728, 12001, 12123, 12127, 12342, 12497, 13004, 13012, 13435, 13888, 14535]","[7490, 10195, 10918]","[6, 107, 1546, 2402, 2996, 3624, 3721, 3890, 4013, 4738, 4743, 5066, 5367, 6152, 6504, 6916, 7310, 7768, 7851, 8252, 8957, 9194, 9212, 9611, 9627, 9637, 9689, 9752, 9790, 10099, 11516, 11530, 11602, 11686, 11693, 11728, 12001, 12123, 12127, 12342, 12497, 13004, 13012, 13435, 13888, 14535]","[7490, 10195, 10918]",15009,49,14960,3,46,14960,0
4.0,HSB3A,"[580, 1424, 1843, 1847, 1940, 2085, 2623, 2640, 2655, 2659, 2670, 3139, 3166, 3203, 3474]",[1843],"[580, 1424, 1847, 1940, 2085, 2623, 2640, 2655, 2659, 2670, 3139, 3166, 3203, 3474]",[1843],3676,15,3661,1,14,3661,0
4.0,HSBGPG,"[29, 151, 560, 817, 856, 1096, 1340, 1593, 1645]","[560, 1096]","[29, 151, 817, 856, 1340, 1593, 1645]","[560, 850, 1096]",1668,9,1659,2,7,1658,1
4.0,HSBSF2,"[238, 318, 477, 1242, 1587, 1621, 2241, 2450, 2605, 2748, 2930, 2956, 3022, 3336, 3601, 4086, 4317, 4427, 4505, 4715, 4895, 4943, 5688]","[1242, 1587, 2748, 3601]","[238, 318, 477, 1621, 2241, 2450, 2605, 2930, 2956, 3022, 3336, 4086, 4317, 4427, 4505, 4715, 4895, 4943, 5688]","[1242, 1587, 2748, 3601]",5954,23,5931,4,19,5931,0
4.0,HSCBMYHC,"[297, 345, 369, 649, 1577, 2258, 2583, 2735, 2858, 2868, 3016, 3193, 3218, 3301, 3592, 3819, 3932, 4595, 4612, 4776, 4921, 5041, 5485, 5644, 6529, 6694, 7246, 7567, 7609, 7735, 7894, 7912, 8095, 8354, 8647, 8867, 8898, 9024, 9174, 9885, 10554, 10877, 11339, 11847, 12155, 12229, 12303, 12427, 12635, 12825, 12829, 13037, 13342, 14042, 14210, 14394, 14571, 14806, 15375, 15416, 15683, 15784, 16410, 17120, 18228, 18590, 18734, 18777, 18896, 19262, 19970, 20057, 20132, 20604, 20964, 21466, 21505, 21839, 22088, 22423, 22474, 22643, 23209, 23454, 23701, 23830, 24751]","[4595, 5041, 5485, 5644, 6529, 6694, 7246, 7567, 8354, 8898, 9174, 10877, 11339, 12155, 12427, 12829, 13342, 14210, 14571, 17120, 18228, 18590, 18896, 19262, 19970, 20604, 21466, 21839, 22088, 22474, 23454, 23701]","[297, 345, 369, 649, 1577, 2258, 2583, 2735, 2858, 2868, 3016, 3193, 3218, 3301, 3592, 3819, 3932, 4612, 4776, 4921, 7609, 7735, 7894, 7912, 8095, 8647, 8867, 9024, 9885, 10554, 11847, 12229, 12303, 12635, 12825, 13037, 14042, 14394, 14806, 15375, 15416, 15683, 15784, 16410, 18734, 18777, 20057, 20132, 20964, 21505, 22423, 22643, 23209, 23830, 24751]","[4595, 5041, 5485, 5644, 6354, 6529, 6694, 7246, 7567, 8354, 8898, 9174, 9626, 10530, 10877, 11339, 12155, 12427, 12829, 13342, 14210, 14571, 15900, 17120, 18228, 18590, 18896, 19262, 19970, 20319, 20604, 21466, 21839, 22088, 22474, 23454, 23701]",24993,87,24906,32,55,24901,5
4.0,HSCD14G,"[159, 562, 763, 1318]",[159],"[562, 763, 1318]",[159],1563,4,1559,1,3,1559,0
4.0,HSCKBG,"[236, 876, 1075, 1341, 1619, 1824, 2068, 2124, 2380, 2570, 2638, 2643, 2877, 3022, 3521, 3620, 4078]","[1341, 1619, 1824, 2380, 3521]","[236, 876, 1075, 2068, 2124, 2570, 2638, 2643, 2877, 3022, 3620, 4078]","[1341, 1619, 1824, 2380, 3174, 3521]",4193,17,4176,5,12,4175,1
4.0,HSCOMT2,"[197, 589, 636, 1075, 2188, 2212, 2350, 2378, 2547, 2897, 3503]",[2378],"[197, 589, 636, 1075, 2188, 2212, 2350, 2547, 2897, 3503]","[1630, 1959, 2378]",3644,11,3633,1,10,3631,2
4.0,HSCPH70,"[205, 297, 633, 773, 865, 1784, 2936, 3172, 3200, 3382, 3675, 3831, 3895, 4204, 4283, 4407, 4801, 5251, 6024]","[4204, 4407, 4801]","[205, 297, 633, 773, 865, 1784, 2936, 3172, 3200, 3382, 3675, 3831, 3895, 4283, 5251, 6024]","[1729, 4204, 4407, 4801]",6704,19,6685,3,16,6684,1
4.0,HSCSF1PO,"[359, 496, 534, 678, 779, 1290, 1965, 2385, 2428, 2670, 2704, 2816, 3283, 3327, 3740, 3777, 3815, 4479, 4825, 5393, 5647, 6274, 6579, 6602, 6651, 6706, 6732, 7061, 7314, 7572, 7831, 7943, 8115, 8250, 8287, 8486, 8680, 8694, 8699, 8725, 8843, 8847, 8876, 8943, 9217, 9575, 9882, 10227, 10249, 10444, 10517, 11059, 11063, 11092, 11515, 11707, 11723, 12975, 13021, 13657, 13951, 14683, 14890, 15036, 15082, 15556, 15733, 16061, 17256, 17882, 17968, 17972, 18046, 18156, 18208, 18350, 18465, 18756, 19403, 19724, 20123, 20159, 21307, 21311, 21444, 23086, 23668, 24072, 24247, 24260, 24264, 24806, 25196, 25690, 25817, 26044, 26095, 26605, 26732, 26837, 26841, 26963, 27465, 27905, 29084, 29206, 29926, 30172, 30657, 30823, 30890, 31040, 31133, 31663, 31739, 31836, 31942, 32108, 32301, 32402, 32862, 33091, 33729, 33816, 34006, 34015, 34027, 34038, 34158, 34399]","[1965, 7572, 8287, 10227, 11063, 15036, 17882, 18156, 18465, 20123, 26605, 26837, 27465, 30823, 31040, 32108, 32301, 33091, 34006]","[359, 496, 534, 678, 779, 1290, 2385, 2428, 2670, 2704, 2816, 3283, 3327, 3740, 3777, 3815, 4479, 4825, 5393, 5647, 6274, 6579, 6602, 6651, 6706, 6732, 7061, 7314, 7831, 7943, 8115, 8250, 8486, 8680, 8694, 8699, 8725, 8843, 8847, 8876, 8943, 9217, 9575, 9882, 10249, 10444, 10517, 11059, 11092, 11515, 11707, 11723, 12975, 13021, 13657, 13951, 14683, 14890, 15082, 15556, 15733, 16061, 17256, 17968, 17972, 18046, 18208, 18350, 18756, 19403, 19724, 20159, 21307, 21311, 21444, 23086, 23668, 24072, 24247, 24260, 24264, 24806, 25196, 25690, 25817, 26044, 26095, 26732, 26841, 26963, 27905, 29084, 29206, 29926, 30172, 30657, 30890, 31133, 31663, 31739, 31836, 31942, 32402, 32862, 33729, 33816, 34015, 34027, 34038, 34158, 34399]","[1965, 7572, 8287, 10227, 11063, 15036, 17882, 18156, 18465, 20123, 26605, 26837, 27465, 28627, 30823, 31040, 32108, 32301, 33091, 34006]",35093,130,34963,19,111,34962,1
4.0,HSCST3G,"[271, 536, 888, 931, 1145, 1328, 2342, 3064, 3155, 3159, 3443, 3468, 3694, 3783, 3865, 3938, 4129, 4620, 4813, 5518, 5990, 6231, 6293, 6448, 6521, 6632, 6921, 7112]","[1328, 3694]","[271, 536, 888, 931, 1145, 2342, 3064, 3155, 3159, 3443, 3468, 3783, 3865, 3938, 4129, 4620, 4813, 5518, 5990, 6231, 6293, 6448, 6521, 6632, 6921, 7112]","[1328, 3694]",7285,28,7257,2,26,7257,0
4.0,HSCYCLA,"[407, 1029, 1049, 1102, 1333, 1422, 2406, 2509, 2954, 3031, 3668, 3731, 4168, 4520, 4538, 5338, 5389, 5670, 5911, 6070, 6323, 6667, 6982, 7024, 7439, 7622, 7956, 8113]","[2406, 3731, 4168, 5338, 5911, 6667]","[407, 1029, 1049, 1102, 1333, 1422, 2509, 2954, 3031, 3668, 4520, 4538, 5389, 5670, 6070, 6323, 6982, 7024, 7439, 7622, 7956, 8113]","[1393, 2406, 3731, 4168, 5338, 5911, 6667]",8356,28,8328,6,22,8327,1
4.0,HSCYP216,"[255, 302, 442, 665, 874, 879, 1278, 1466, 1475, 1836, 1888, 2215, 2239, 2402]","[255, 442, 879, 1278, 1466, 1836, 2215, 2402]","[302, 665, 874, 1475, 1888, 2239]","[255, 442, 879, 1088, 1278, 1466, 1836, 2215, 2402]",2764,14,2750,8,6,2749,1
4.0,HSCYP45C,"[185, 731, 947, 1256, 1688, 1772, 2048, 2667, 3358, 3538, 3642, 3975, 4603, 4680, 4942, 4963, 5008, 5624, 5801, 6016, 6248, 6517, 6525, 6562, 6694, 6935, 7081, 7429]","[4942, 5624, 5801, 6016, 6248]","[185, 731, 947, 1256, 1688, 1772, 2048, 2667, 3358, 3538, 3642, 3975, 4603, 4680, 4963, 5008, 6517, 6525, 6562, 6694, 6935, 7081, 7429]","[4942, 5624, 5801, 6016, 6248]",7547,28,7519,5,23,7519,0
4.0,HSCYTOK17,"[396, 452, 488, 581, 982, 1709, 1951, 2079, 2304, 2582, 2857, 2928, 2935, 3066, 3131, 3171, 3245, 3257, 3468, 3601, 4000, 4123, 4987]","[581, 1709, 2304, 3066, 4000, 4123]","[396, 452, 488, 982, 1951, 2079, 2582, 2857, 2928, 2935, 3131, 3171, 3245, 3257, 3468, 3601, 4987]","[581, 1709, 2304, 3066, 3693, 4000, 4123]",5253,23,5230,6,17,5229,1
4.0,HSCYTOK20,"[203, 1277, 1871, 2287, 2515, 2601, 3128, 3978, 4019, 4075, 4732, 5152, 5205, 5281, 5352, 7290, 7458, 7512, 8061, 8134, 8722, 8760, 8864, 9313, 9470, 9642, 9984, 10005, 10714, 10828, 11052, 11206, 11940, 12705, 12783, 12902, 13941, 14034, 15297, 15989, 16190, 16343, 16498, 16620, 16791]","[5281, 7512, 9470, 9984, 11940, 12705]","[203, 1277, 1871, 2287, 2515, 2601, 3128, 3978, 4019, 4075, 4732, 5152, 5205, 5352, 7290, 7458, 8061, 8134, 8722, 8760, 8864, 9313, 9642, 10005, 10714, 10828, 11052, 11206, 12783, 12902, 13941, 14034, 15297, 15989, 16190, 16343, 16498, 16620, 16791]","[5281, 7512, 9470, 9984, 10271, 11940, 12705]",18054,45,18009,6,39,18008,1
4.0,HSDAO,"[588, 956, 1035, 1080, 1177, 1381, 1437, 1635, 1665, 1751, 2197, 2351, 2551, 2877, 3236, 3885, 3987, 4584, 4623, 5121, 5744, 5903, 6426, 6696, 7431, 7548, 7766, 7871, 8028, 8329, 8347, 8502, 8880, 9013, 9343]","[6426, 7431, 9013]","[588, 956, 1035, 1080, 1177, 1381, 1437, 1635, 1665, 1751, 2197, 2351, 2551, 2877, 3236, 3885, 3987, 4584, 4623, 5121, 5744, 5903, 6696, 7548, 7766, 7871, 8028, 8329, 8347, 8502, 8880, 9343]","[6426, 7431, 9013]",9896,35,9861,3,32,9861,0
4.0,HSERPG,"[628, 1303, 1340, 1683, 1774, 1943, 2026, 2069, 2474, 2509, 2768]","[628, 1340, 1683, 2474]","[1303, 1774, 1943, 2026, 2069, 2509, 2768]","[628, 1340, 1683, 2474]",3391,11,3380,4,7,3380,0
4.0,HSFAU1,"[335, 505, 655, 824, 857, 1096, 1129, 1140, 1557, 1592, 1613]","[857, 1096, 1613]","[335, 505, 655, 824, 1129, 1140, 1557, 1592]","[857, 1096, 1613]",2009,11,1998,3,8,1998,0
4.0,HSFESFPS,"[8, 13, 543, 728, 738, 1227, 1248, 1553, 1650, 3180, 3336, 3637, 3645, 3726, 3769, 3797, 3873, 3923, 4008, 4522, 4547, 5028, 5154, 5405, 5924, 6240, 6445, 6767, 7089, 7150, 7330, 7634, 7757, 7836, 8052, 8069, 8349, 8546, 8720, 8782, 9151, 9176, 9371, 9424, 9768, 10015, 10445, 10483, 10626, 10664, 10965, 11068, 11128, 11511, 11788, 11865, 12062, 12225]","[1227, 1553, 3336, 5405, 5924, 6240, 6445, 7150, 7634, 8069, 8782, 9151, 9371, 9768, 10015]","[8, 13, 543, 728, 738, 1248, 1650, 3180, 3637, 3645, 3726, 3769, 3797, 3873, 3923, 4008, 4522, 4547, 5028, 5154, 6767, 7089, 7330, 7757, 7836, 8052, 8349, 8546, 8720, 9176, 9424, 10445, 10483, 10626, 10664, 10965, 11068, 11128, 11511, 11788, 11865, 12062, 12225]","[1227, 1553, 3023, 3336, 5405, 5598, 5924, 6240, 6445, 7150, 7634, 8069, 8782, 9151, 9371, 9768, 10015]",12256,58,12198,15,43,12196,2
4.0,HSGCSFG,"[264, 404, 540, 690, 735, 739, 744, 748, 774, 970, 1230, 1521, 2048, 2121, 2296]","[404, 744, 1230, 1521]","[264, 540, 690, 735, 739, 748, 774, 970, 2048, 2121, 2296]","[404, 744, 1230, 1521]",2953,15,2938,4,11,2938,0
4.0,HSGEBCMA,"[334, 607, 700, 888, 1206, 1294, 1496, 1545, 1648, 2292, 2430, 2587, 2989, 3234, 3273, 3292, 3409, 3489, 3607]","[607, 1496]","[334, 700, 888, 1206, 1294, 1545, 1648, 2292, 2430, 2587, 2989, 3234, 3273, 3292, 3409, 3489, 3607]","[607, 1496]",3720,19,3701,2,17,3701,0
4.0,HSGGL2,"[164, 202, 547, 1055, 1067]","[202, 547]","[164, 1055, 1067]","[202, 547]",1621,5,1616,2,3,1616,0
4.0,HSGLA,"[94, 852, 868, 885, 901, 937, 955, 1374, 1822, 2011, 2148, 2472, 2499, 4062, 4106, 4149, 4165, 4435, 5040, 5269, 5308, 5575, 6958, 6983, 7846, 8012, 8167, 8378, 8413, 9335, 10329, 10359, 10369, 10395, 10453, 10708, 11761, 12168, 12322, 12358]","[1374, 5269, 8413, 10708]","[94, 852, 868, 885, 901, 937, 955, 1822, 2011, 2148, 2472, 2499, 4062, 4106, 4149, 4165, 4435, 5040, 5308, 5575, 6958, 6983, 7846, 8012, 8167, 8378, 9335, 10329, 10359, 10369, 10395, 10453, 11761, 12168, 12322, 12358]","[1374, 5269, 7447, 8413, 10293, 10708]",12429,40,12389,4,36,12387,2
4.0,HSGROW2,"[92, 211, 345, 462, 899, 1091]","[345, 1091]","[92, 211, 462, 899]","[345, 762, 1091, 1349]",1957,6,1951,2,4,1949,2
4.0,HSGSTM4,"[37, 41, 117, 391, 522, 874, 1262, 1357, 1458, 1793, 2098, 2142, 2232, 2469, 2670, 2960, 3366, 3511, 3516, 3623, 3766, 3953, 3984, 3991]","[37, 391, 874, 1262, 1458, 2469, 2670]","[41, 117, 522, 1357, 1793, 2098, 2142, 2232, 2960, 3366, 3511, 3516, 3623, 3766, 3953, 3984, 3991]","[37, 391, 874, 1262, 1458, 2469, 2670]",4835,24,4811,7,17,4811,0
4.0,HSGTRH,"[442, 515, 1000, 1193, 1847, 1927, 2111, 2205, 2322, 2809, 2814, 3141, 3732, 3816, 5548, 5645, 5766, 6094, 6275, 6449, 6552]","[2205, 3816]","[442, 515, 1000, 1193, 1847, 1927, 2111, 2322, 2809, 2814, 3141, 3732, 5548, 5645, 5766, 6094, 6275, 6449, 6552]","[2205, 3816]",7217,21,7196,2,19,7196,0
4.0,HSHMG17G,"[283, 400, 856, 1117, 1538, 1793, 2037, 2279, 2335, 2524, 2927, 2946, 3403, 3415, 3620, 4021, 4342, 4469, 4815, 4833, 4854, 5920, 5937, 7087, 7188]","[2524, 3415, 3620, 4021]","[283, 400, 856, 1117, 1538, 1793, 2037, 2279, 2335, 2927, 2946, 3403, 4342, 4469, 4815, 4833, 4854, 5920, 5937, 7087, 7188]","[2524, 3415, 3620, 4021, 4553]",7188,25,7163,4,21,7162,1
4.0,HSHNRNPA,"[49, 220, 707, 814, 868, 1086, 1159, 1287, 1494, 1789, 1936, 2295, 2481, 2511, 2615, 2660, 2869, 2927, 2988, 3229, 3233, 3559, 3602, 3773, 3962, 4312, 4316]","[814, 1494, 1936, 2295, 2481, 2660, 2869, 3962]","[49, 220, 707, 868, 1086, 1159, 1287, 1789, 2511, 2615, 2927, 2988, 3229, 3233, 3559, 3602, 3773, 4312, 4316]","[814, 1494, 1936, 2295, 2481, 2660, 2869, 3962]",5361,27,5334,8,19,5334,0
4.0,HSHOX51,"[268, 698, 703, 760, 1278, 1425, 1651, 1791, 2052, 2130, 2201, 2393, 2415, 2425, 2519, 2611, 3022, 3601, 4023, 4748, 6206]",[2052],"[268, 698, 703, 760, 1278, 1425, 1651, 1791, 2130, 2201, 2393, 2415, 2425, 2519, 2611, 3022, 3601, 4023, 4748, 6206]",[2052],6298,21,6277,1,20,6277,0
4.0,HSHSC70,"[27, 54, 59, 305, 456, 777, 913, 1194, 1245, 1313, 1773, 1778, 2052, 2250, 2550, 2893, 2938, 3307, 3734, 3841, 4329, 4735, 4819, 4910, 4929, 5378]","[1245, 1773, 2250, 2893, 3307, 3734]","[27, 54, 59, 305, 456, 777, 913, 1194, 1313, 1778, 2052, 2550, 2938, 3841, 4329, 4735, 4819, 4910, 4929, 5378]","[1245, 1773, 2250, 2893, 3307, 3734, 4114]",5401,26,5375,6,20,5374,1
4.0,HSIFNAR,"[329, 365, 429, 549, 583, 616, 631, 830, 869, 1218, 1356, 1404, 1420, 1437, 1540, 2445, 2612, 2684, 2696, 3337, 4481, 4612, 5386, 5843, 7631, 7976, 8112, 8182, 8569, 8594, 9219, 9606, 10270, 10423, 10677, 10800, 11127, 11325, 11655, 11664, 12416, 12704, 12838, 13828, 13884, 14172, 14247, 14937, 15387, 15464, 15482, 16062, 16909, 16944, 17681, 17725, 17942, 18117, 18394, 18564, 19188, 19220, 19442, 19858, 19910, 20036, 20088, 20346, 20795, 21132, 21239, 21243, 21261, 21610, 22130, 22538, 22586, 22719, 23136, 23180, 23369, 23783, 23985, 24341, 24359, 24515, 24742, 25061, 25314, 25630, 25777, 26285, 26649, 26892, 26897, 27236, 27880, 27952, 28142, 28272, 28315, 28489, 28657, 28661, 29018, 29168, 29554, 29885, 29899, 30053, 30214, 30452, 30489, 30854, 30881, 30949, 30998, 31727, 31769, 31918, 32399]","[830, 11325, 16944, 19188, 19442, 21132, 25061, 25314, 29554]","[329, 365, 429, 549, 583, 616, 631, 869, 1218, 1356, 1404, 1420, 1437, 1540, 2445, 2612, 2684, 2696, 3337, 4481, 4612, 5386, 5843, 7631, 7976, 8112, 8182, 8569, 8594, 9219, 9606, 10270, 10423, 10677, 10800, 11127, 11655, 11664, 12416, 12704, 12838, 13828, 13884, 14172, 14247, 14937, 15387, 15464, 15482, 16062, 16909, 17681, 17725, 17942, 18117, 18394, 18564, 19220, 19858, 19910, 20036, 20088, 20346, 20795, 21239, 21243, 21261, 21610, 22130, 22538, 22586, 22719, 23136, 23180, 23369, 23783, 23985, 24341, 24359, 24515, 24742, 25630, 25777, 26285, 26649, 26892, 26897, 27236, 27880, 27952, 28142, 28272, 28315, 28489, 28657, 28661, 29018, 29168, 29885, 29899, 30053, 30214, 30452, 30489, 30854, 30881, 30949, 30998, 31727, 31769, 31918, 32399]","[830, 11325, 16944, 19188, 19442, 21132, 25061, 25314, 28679, 29554]",32899,121,32778,9,112,32777,1
4.0,HSIFNG,"[63, 136, 589, 976, 1047, 1897, 2175, 2347, 2364, 2413, 2442, 2446, 2771, 3213, 3516, 3631, 3690, 3742, 3833, 4482, 4600, 5167, 5305, 5346, 5853]","[589, 1897, 2175]","[63, 136, 976, 1047, 2347, 2364, 2413, 2442, 2446, 2771, 3213, 3516, 3631, 3690, 3742, 3833, 4482, 4600, 5167, 5305, 5346, 5853]","[589, 1897, 2175]",5954,25,5929,3,22,5929,0
4.0,HSIL1AG,"[916, 1617, 1987, 2208, 2641, 2949, 3215, 3356, 3631, 3939, 4118, 4326, 4847, 5019, 5155, 5318, 5343, 5580, 6433, 7384, 7604, 7681, 7940, 8025, 8510, 8514, 8526, 9290, 9436, 9875, 10013, 10487, 11229]","[2208, 3215, 4326, 6433, 7940]","[916, 1617, 1987, 2641, 2949, 3356, 3631, 3939, 4118, 4847, 5019, 5155, 5318, 5343, 5580, 7384, 7604, 7681, 8025, 8510, 8514, 8526, 9290, 9436, 9875, 10013, 10487, 11229]","[2208, 3215, 4326, 6433, 7940]",11963,33,11930,5,28,11930,0
4.0,HSIL1B,"[735, 1352, 1515, 1565, 2240, 2528, 3144, 3903, 4383, 4393, 4496, 4554, 5657, 6039, 7121, 7406, 7849, 8995, 9010, 9336, 9692]","[2528, 3144, 6039, 7406]","[735, 1352, 1515, 1565, 2240, 3903, 4383, 4393, 4496, 4554, 5657, 7121, 7849, 8995, 9010, 9336, 9692]","[2528, 3144, 5327, 6039, 7406]",9705,21,9684,4,17,9683,1
4.0,HSINT2,"[516, 1156, 2267, 2792, 3197, 3420, 3471, 3509, 3549, 4140, 4327, 5335, 5386, 8668, 8973, 9331, 9480, 10216, 10232, 10273, 10458, 10533, 10644, 10708, 10736, 11562]","[1156, 3549]","[516, 2267, 2792, 3197, 3420, 3471, 3509, 4140, 4327, 5335, 5386, 8668, 8973, 9331, 9480, 10216, 10232, 10273, 10458, 10533, 10644, 10708, 10736, 11562]","[1156, 3549]",11601,26,11575,2,24,11575,0
4.0,HSL7A,"[122, 420, 1133, 1288, 1408, 2073, 2077, 2576, 2867, 3127, 3525, 4052, 4164, 4259, 4564, 4572, 4919, 5073]","[2073, 2867, 3525, 4164, 4572, 4919]","[122, 420, 1133, 1288, 1408, 2077, 2576, 3127, 4052, 4259, 4564, 5073]","[2073, 2867, 3525, 3881, 4164, 4572, 4919]",5499,18,5481,6,12,5480,1
4.0,HSLCATG,"[361, 991, 1352, 1590, 1620, 1629, 1636, 1672, 1704, 1881, 2266, 2574, 2609, 3577, 4200, 4283, 4458, 5051, 5147, 5320, 5372, 5638, 5649, 5873, 6028, 6060, 6184, 6402, 6574, 6705, 6743]","[991, 1881, 2266, 2574]","[361, 1352, 1590, 1620, 1629, 1636, 1672, 1704, 2609, 3577, 4200, 4283, 4458, 5051, 5147, 5320, 5372, 5638, 5649, 5873, 6028, 6060, 6184, 6402, 6574, 6705, 6743]","[991, 1881, 2076, 2266, 2574]",6894,31,6863,4,27,6862,1
4.0,HSMECDAG,"[93, 230, 387, 716, 1393, 1456, 1805, 2149, 2517, 2584, 2588, 2593, 2597, 2601, 2616, 2776, 2870, 2966, 3072, 3170, 3202, 3245, 3353, 3544, 3673, 3852, 3939, 4095, 4361]","[1393, 2517, 2776, 2966, 3544, 3852]","[93, 230, 387, 716, 1456, 1805, 2149, 2584, 2588, 2593, 2597, 2601, 2616, 2870, 3072, 3170, 3202, 3245, 3353, 3673, 3939, 4095, 4361]","[1393, 2517, 2776, 2966, 3544, 3852]",4363,29,4334,6,23,4334,0
4.0,HSMED,"[36, 52, 139, 277, 619, 636, 789, 812, 967, 1354, 1506, 1704, 1774, 1943, 1993, 1998, 2186, 2315, 3154, 3315, 4051, 4355, 4716, 4762, 4833]","[1354, 1943, 2315, 4716]","[36, 52, 139, 277, 619, 636, 789, 812, 967, 1506, 1704, 1774, 1993, 1998, 2186, 3154, 3315, 4051, 4355, 4762, 4833]","[1354, 1943, 2315, 4716]",5285,25,5260,4,21,5260,0
4.0,HSMT1H,"[20, 196, 396, 442, 816, 1128, 1475, 2125]","[816, 1475]","[20, 196, 396, 442, 1128, 2125]","[816, 1475]",2135,8,2127,2,6,2127,0
4.0,HSNCAMX1,"[188, 280, 638, 1256, 1550, 1609, 1794, 2245, 2381, 2470, 2486, 2537, 2791, 2808, 2974, 4142, 4157, 4190, 4778, 6024, 6582, 6983, 7316, 7569, 7640, 7795, 7852, 8033, 8171, 8529, 8552, 8809, 9068, 9248, 9369, 9373, 9522, 10015, 10317, 10722, 11249, 11509, 11667, 11710, 11726, 11870, 12072, 12467, 12550, 12786, 12924, 13049, 13357, 13408, 13684, 13893, 14002, 14016, 15353]","[1609, 4142, 4778, 6582, 6983, 7316, 7569, 7852, 8529, 8809, 9068, 9373, 10015, 10317, 10722, 11667, 12072, 12550, 12786, 13049, 13893, 14002]","[188, 280, 638, 1256, 1550, 1794, 2245, 2381, 2470, 2486, 2537, 2791, 2808, 2974, 4157, 4190, 6024, 7640, 7795, 8033, 8171, 8552, 9248, 9369, 9522, 11249, 11509, 11710, 11726, 11870, 12467, 12924, 13357, 13408, 13684, 14016, 15353]","[1609, 4142, 4778, 5218, 6315, 6582, 6983, 7316, 7569, 7852, 8529, 8809, 9068, 9373, 9571, 10015, 10317, 10722, 11667, 12072, 12283, 12550, 12786, 13049, 13487, 13893, 14002]",16281,59,16222,22,37,16217,5
4.0,HSNFM,"[417, 432, 1741, 1822, 2243, 2675, 2691, 3371, 3772, 3849, 4101, 4491, 4575, 4896, 5057, 5148, 5343, 5388]","[1822, 2675]","[417, 432, 1741, 2243, 2691, 3371, 3772, 3849, 4101, 4491, 4575, 4896, 5057, 5148, 5343, 5388]","[1822, 2675]",6229,18,6211,2,16,6211,0
4.0,HSODCG,"[362, 735, 1002, 1938, 2612, 2649, 2912, 3007, 3411, 3454, 3567, 3745, 3968, 4192, 4433, 4445, 4649, 5028, 5286, 5421, 5633, 5815, 5893, 6298, 6336, 7111, 7208, 7306, 7614, 7618, 8052, 8090, 8214, 8842, 8854]","[4192, 4649, 5028, 5421, 5633, 5893, 7111, 7306, 7614]","[362, 735, 1002, 1938, 2612, 2649, 2912, 3007, 3411, 3454, 3567, 3745, 3968, 4433, 4445, 5286, 5815, 6298, 6336, 7208, 7618, 8052, 8090, 8214, 8842, 8854]","[4192, 4649, 5028, 5421, 5633, 5893, 7111, 7306, 7614]",9036,35,9001,9,26,9001,0
4.0,HSODF2,"[4, 131, 158, 250, 907, 964, 993, 1375]",[],"[4, 131, 158, 250, 907, 964, 993, 1375]",[600],1423,8,1415,0,8,1414,1
4.0,HSPAT133,"[393, 558, 654, 762, 794, 1126, 1173, 1447, 1782, 3711]",[1447],"[393, 558, 654, 762, 794, 1126, 1173, 1782, 3711]",[1447],3713,10,3703,1,9,3703,0
4.0,HSPLAPL,"[24, 403, 599, 603, 808, 827, 1192, 1225]","[403, 599, 827]","[24, 603, 808, 1192, 1225]","[403, 599, 827]",1275,8,1267,3,5,1267,0
4.0,HSPRB3L,"[279, 356, 386, 566, 616, 789, 896, 1103, 1412, 1537, 2934, 3083, 3376, 4014]","[566, 1537]","[279, 356, 386, 616, 789, 896, 1103, 1412, 2934, 3083, 3376, 4014]","[566, 1537]",4509,14,4495,2,12,4495,0
4.0,HSPRB4S,"[97, 411, 487, 518, 693, 741, 913, 1018, 1534, 1565, 1658, 2128, 2384, 2495, 2812, 2957, 3999, 5204, 5381]","[693, 1658]","[97, 411, 487, 518, 741, 913, 1018, 1534, 1565, 2128, 2384, 2495, 2812, 2957, 3999, 5204, 5381]","[693, 1658]",5806,19,5787,2,17,5787,0
4.0,HSPSAG,"[46, 447, 872, 1848, 2397, 2551, 2834, 3544, 3611, 3866, 3987, 4044, 4080, 4368, 4427, 4493, 4499, 5088, 5456]","[447, 1848, 4044]","[46, 872, 2397, 2551, 2834, 3544, 3611, 3866, 3987, 4080, 4368, 4427, 4493, 4499, 5088, 5456]","[447, 1848, 3764, 4044]",5866,19,5847,3,16,5846,1
4.0,HSRPII145,"[449, 588, 908, 1071, 1097, 1102, 1181, 1233, 1378, 1535, 1619, 1688, 1729]","[449, 588, 908, 1071, 1233]","[1097, 1102, 1181, 1378, 1535, 1619, 1688, 1729]","[449, 588, 908, 1071, 1233]",2086,13,2073,5,8,2073,0
4.0,HSRPS7,"[55, 115, 284, 404, 415, 516, 1008, 1055, 1077, 1599, 1831, 2166, 2369, 2530, 2551, 3329, 3383, 3598, 3755, 4254, 4460, 4644, 4654, 5088, 5100, 5409, 5736, 5912, 5937, 6064, 6068, 6325, 6386, 6408, 6429, 6734, 7003]","[2166, 2369, 4254, 6734]","[55, 115, 284, 404, 415, 516, 1008, 1055, 1077, 1599, 1831, 2530, 2551, 3329, 3383, 3598, 3755, 4460, 4644, 4654, 5088, 5100, 5409, 5736, 5912, 5937, 6064, 6068, 6325, 6386, 6408, 6429, 7003]","[2166, 2369, 3108, 4254, 6734]",7506,37,7469,4,33,7468,1
4.0,HSSAA1B,"[349, 527, 862, 1009, 1151, 1543, 1831, 2345, 2367, 2467, 3182, 3845, 3876, 4013, 4403, 4571, 4697, 4712, 4744]","[1543, 3845]","[349, 527, 862, 1009, 1151, 1831, 2345, 2367, 2467, 3182, 3876, 4013, 4403, 4571, 4697, 4712, 4744]","[1543, 3845]",4816,19,4797,2,17,4797,0
4.0,HSSHBG,"[1016, 1058, 2575, 2672, 2679, 2810, 2867, 3148]","[1058, 3148]","[1016, 2575, 2672, 2679, 2810, 2867]","[472, 696, 1058, 1551, 1938, 2205, 3148]",3803,8,3795,2,6,3790,5
4.0,HSSSPN1AG,"[155, 418, 589, 1434, 1635, 1809, 1853, 2066, 2280, 2330, 3028, 3360, 3491, 3518, 3781, 4053]","[1635, 1809, 3360, 3491]","[155, 418, 589, 1434, 1853, 2066, 2280, 2330, 3028, 3518, 3781, 4053]","[1343, 1635, 1809, 3360, 3491]",4089,16,4073,4,12,4072,1
4.0,HSSURF3,"[284, 288, 743, 1033, 1294, 1692, 2048, 2160, 2209, 2321, 2415, 2721, 2729, 3074, 3226]","[284, 1033, 1692, 2048, 2321, 2729, 3074]","[288, 743, 1294, 2160, 2209, 2415, 2721, 3226]","[284, 1033, 1692, 2048, 2321, 2729, 3074]",3410,15,3395,7,8,3395,0
4.0,HSTNFB,"[189, 836, 980, 1375, 2506, 3015]",[1375],"[189, 836, 980, 2506, 3015]","[1375, 1567]",3030,6,3024,1,5,3023,1
4.0,HSTPI1G,"[730, 746, 919, 972, 1304, 1558, 1616, 1685, 1817, 2035, 2231, 2821, 3181, 3249, 3760, 3846, 4376, 4651, 4845, 4849]","[746, 2035, 2231, 2821, 3181]","[730, 919, 972, 1304, 1558, 1616, 1685, 1817, 3249, 3760, 3846, 4376, 4651, 4845, 4849]","[746, 2035, 2231, 2438, 2821, 3181]",4988,20,4968,5,15,4967,1
4.0,HSTUBAG,"[71, 96, 536, 1912, 2065, 2287, 2310, 2584, 3623, 3733, 3759, 3777, 3815, 3843]","[536, 2287, 2584]","[71, 96, 1912, 2065, 2310, 3623, 3733, 3759, 3777, 3815, 3843]","[536, 2287, 2584]",4080,14,4066,3,11,4066,0
4.0,HSU01102,"[222, 275, 668, 745, 817, 858, 1671, 1711, 1943, 2082, 2210, 2568, 4166, 4611, 4655]",[668],"[222, 275, 745, 817, 858, 1671, 1711, 1943, 2082, 2210, 2568, 4166, 4611, 4655]","[668, 3896]",4988,15,4973,1,14,4972,1
4.0,HSU04357,"[97, 123, 1201, 1239, 1342, 1882, 1963]","[97, 1342]","[123, 1201, 1239, 1882, 1963]","[97, 1342]",2075,7,2068,2,5,2068,0
4.0,HSU04636,"[103, 220, 224, 749, 852, 1018, 1449, 1935, 2199, 2262, 2996, 3264, 3426, 3608, 3965, 4424, 4790, 4919, 5359, 5719, 5723, 6008, 6340, 7357, 8301]","[1018, 1935, 2199, 2996, 3608, 4424, 4790, 5359, 6008]","[103, 220, 224, 749, 852, 1449, 2262, 3264, 3426, 3965, 4919, 5719, 5723, 6340, 7357, 8301]","[1018, 1935, 2199, 2996, 3608, 4424, 4790, 5359, 6008]",9446,25,9421,9,16,9421,0
4.0,HSU05259,"[164, 782, 814, 951, 2055, 2091, 2173, 2435, 2571, 2685, 2859, 3045, 3387, 3672, 3937, 4128, 5264]","[782, 2685, 3045, 4128]","[164, 814, 951, 2055, 2091, 2173, 2435, 2571, 2859, 3387, 3672, 3937, 5264]","[782, 2685, 3045, 4128]",5663,17,5646,4,13,5646,0
4.0,HSU07807,"[454, 459, 609, 614, 757, 1040, 1362, 1638, 1991, 2047, 2568, 2736, 2873, 3386, 3509, 3664, 4350]","[757, 3386]","[454, 459, 609, 614, 1040, 1362, 1638, 1991, 2047, 2568, 2736, 2873, 3509, 3664, 4350]","[757, 3386]",4832,17,4815,2,15,4815,0
4.0,HSU07983,"[287, 354, 390, 1286]",[390],"[287, 354, 1286]",[390],1419,4,1415,1,3,1415,0
4.0,HSU08198,"[311, 676, 707, 895, 1072, 1124, 1316, 1392, 1601, 1689, 1811, 1845, 1892, 1900]","[895, 1124, 1316, 1689, 1811]","[311, 676, 707, 1072, 1392, 1601, 1845, 1892, 1900]","[583, 895, 1124, 1316, 1689, 1811]",2337,14,2323,5,9,2322,1
4.0,HSU12421,"[227, 311, 315, 583, 1215, 1384, 1400, 1882, 1941, 2080, 2255, 2291, 2434, 2624, 3216, 3242, 3287, 3349, 3573, 3577, 3747, 3869]","[311, 2080]","[227, 315, 583, 1215, 1384, 1400, 1882, 1941, 2255, 2291, 2434, 2624, 3216, 3242, 3287, 3349, 3573, 3577, 3747, 3869]","[311, 2080]",4251,22,4229,2,20,4229,0
4.0,HSUBR,"[219, 374, 564, 957, 1589, 2316, 2324, 3005]","[1589, 2324]","[219, 374, 564, 957, 2316, 3005]","[1589, 2324]",3290,8,3282,2,6,3282,0
4.0,HSXBXVIII,"[473, 644, 1059, 1189, 1193, 1199, 1203, 1213, 1671, 1992, 2137, 2578, 2596, 2723, 3019, 3026, 3061, 3074, 3099, 3123, 3248, 3333, 3339, 3371, 3859, 4456, 4586, 5362, 5486, 5490, 6115, 6193, 6240, 6599, 6733, 7675, 8302, 8850, 8934, 9475, 9552, 9633, 10043, 10077, 10107, 10136, 10425, 10687, 11253, 11405, 11714, 11843, 11856, 11870, 12085, 12311, 12408, 12693]","[11405, 11843, 12085]","[473, 644, 1059, 1189, 1193, 1199, 1203, 1213, 1671, 1992, 2137, 2578, 2596, 2723, 3019, 3026, 3061, 3074, 3099, 3123, 3248, 3333, 3339, 3371, 3859, 4456, 4586, 5362, 5486, 5490, 6115, 6193, 6240, 6599, 6733, 7675, 8302, 8850, 8934, 9475, 9552, 9633, 10043, 10077, 10107, 10136, 10425, 10687, 11253, 11714, 11856, 11870, 12311, 12408, 12693]","[11405, 11589, 11843, 12085]",12637,58,12579,3,55,12578,1
4.0,HSZNGP1,"[445, 518, 565, 1142, 1307, 1765, 2672, 3191, 3608, 4109, 4312, 4718, 4777, 5026, 5073, 5752, 5805, 5990, 6144, 6347, 6402, 6435, 6665, 7275, 7410, 8313, 8597, 8615, 8986, 8991, 9067, 9762]","[518, 4718, 8313]","[445, 565, 1142, 1307, 1765, 2672, 3191, 3608, 4109, 4312, 4777, 5026, 5073, 5752, 5805, 5990, 6144, 6347, 6402, 6435, 6665, 7275, 7410, 8597, 8615, 8986, 8991, 9067, 9762]","[518, 4718, 8313]",9816,32,9784,3,29,9784,0
4.0,HUMADAG,"[176, 710, 1241, 1309, 1355, 1609, 1677, 2050, 2405, 2418, 2423, 2578, 2769, 2805, 3343, 3737, 4064, 4501, 4549, 4623, 4817, 4900, 5136, 5267, 5278, 5296, 5341, 5657, 5773, 5828, 6192, 7938, 8160, 8421, 9092, 9628, 10515, 11124, 11190, 11568, 11763, 11804, 11825, 12555, 13187, 13314, 13416, 13458, 13503, 13521, 14450, 14833, 14976, 15069, 15395, 15582, 15661, 15857, 15875, 15955, 16030, 17025, 17161, 17205, 17401, 17492, 17850, 18465, 18482, 19292, 19437, 19529, 19940, 20245, 20776, 21006, 21015, 21027, 21114, 22592, 22735, 22747, 23112, 23808, 24224, 24752, 25434, 25532, 26467, 26603, 26891, 26912, 27206, 27250, 28038, 28083, 28099, 28255, 28362, 28712, 28722, 28987, 28992, 29052, 29419, 29939, 30609, 30766, 30860, 31115, 31304, 31313, 31342, 31644, 31682, 32470, 32497, 32675, 32916, 33952, 34262, 34308, 34484, 34578, 34742, 35203, 36268]","[4064, 19292, 26467, 29052, 29939, 31304, 32497, 32675, 32916, 34484, 35203]","[176, 710, 1241, 1309, 1355, 1609, 1677, 2050, 2405, 2418, 2423, 2578, 2769, 2805, 3343, 3737, 4501, 4549, 4623, 4817, 4900, 5136, 5267, 5278, 5296, 5341, 5657, 5773, 5828, 6192, 7938, 8160, 8421, 9092, 9628, 10515, 11124, 11190, 11568, 11763, 11804, 11825, 12555, 13187, 13314, 13416, 13458, 13503, 13521, 14450, 14833, 14976, 15069, 15395, 15582, 15661, 15857, 15875, 15955, 16030, 17025, 17161, 17205, 17401, 17492, 17850, 18465, 18482, 19437, 19529, 19940, 20245, 20776, 21006, 21015, 21027, 21114, 22592, 22735, 22747, 23112, 23808, 24224, 24752, 25434, 25532, 26603, 26891, 26912, 27206, 27250, 28038, 28083, 28099, 28255, 28362, 28712, 28722, 28987, 28992, 29419, 30609, 30766, 30860, 31115, 31313, 31342, 31644, 31682, 32470, 33952, 34262, 34308, 34578, 34742, 36268]","[4064, 19292, 26467, 29052, 29939, 31304, 32497, 32675, 32916, 34484, 35203]",36734,127,36607,11,116,36607,0
4.0,HUMADPRF02,"[90, 359, 638, 1308, 1650, 2033, 2953, 2972, 3035, 3392, 3994, 4213, 4253, 4732, 4870, 5150]","[359, 1308, 1650]","[90, 638, 2033, 2953, 2972, 3035, 3392, 3994, 4213, 4253, 4732, 4870, 5150]","[359, 1308, 1650]",5160,16,5144,3,13,5144,0
4.0,HUMAPEXN,"[137, 349, 1190, 1364, 1376, 1465, 1535, 1863, 2233, 2622, 2850]","[1465, 1863, 2622]","[137, 349, 1190, 1364, 1376, 1535, 2233, 2850]","[1465, 1863, 2622]",3723,11,3712,3,8,3712,0
4.0,HUMAPOCII,"[70, 184, 349, 547, 571, 891, 930, 1012, 1075, 1230, 1557, 1778, 1789, 1837, 1980, 2255, 2305, 2630, 2642, 2760, 2995, 3223, 4263]",[2995],"[70, 184, 349, 547, 571, 891, 930, 1012, 1075, 1230, 1557, 1778, 1789, 1837, 1980, 2255, 2305, 2630, 2642, 2760, 3223, 4263]","[2995, 3321]",4333,23,4310,1,22,4309,1
4.0,HUMAPOE4,"[617, 1064, 1091, 1225, 1294, 1324, 1506, 1575, 1773, 1914, 2365, 2409, 2611, 3200, 4032, 4292, 4313]","[1914, 3200]","[617, 1064, 1091, 1225, 1294, 1324, 1506, 1575, 1773, 2365, 2409, 2611, 4032, 4292, 4313]","[1914, 3200]",5508,17,5491,2,15,5491,0
4.0,HUMATPGG,"[203, 213, 285, 676, 831, 1445, 1902, 2553, 2677, 2891, 2905, 2937, 3025, 3180, 3691, 4064, 4114, 4293, 4578, 5307, 5627, 5882, 5953, 6191, 6534, 6749, 7456, 7488, 7833, 7885, 7908, 8198, 8227, 9299, 9436, 9672, 10001, 10190, 10354, 10406, 11018, 11405, 11435, 12074, 12415, 12987, 13458, 14100, 14110, 14276, 14537, 14755]","[1445, 1902, 2677, 4293, 5307, 6534, 6749, 7456, 8198, 9436, 9672, 10190, 11405, 12074, 14100, 14276]","[203, 213, 285, 676, 831, 2553, 2891, 2905, 2937, 3025, 3180, 3691, 4064, 4114, 4578, 5627, 5882, 5953, 6191, 7488, 7833, 7885, 7908, 8227, 9299, 10001, 10354, 10406, 11018, 11435, 12415, 12987, 13458, 14110, 14537, 14755]","[1445, 1727, 1902, 2677, 4293, 4749, 5307, 6118, 6534, 6749, 7456, 8198, 9436, 9672, 9946, 10190, 11405, 12074, 13663, 14100, 14276]",15108,52,15056,16,36,15051,5
4.0,HUMBETGLOA,"[52, 252, 376, 601, 687, 920, 942, 958, 1176, 1264, 1311, 2016, 2475, 2559, 2931]","[958, 1311]","[52, 252, 376, 601, 687, 920, 942, 1176, 1264, 2016, 2475, 2559, 2931]","[958, 1311]",2995,15,2980,2,13,2980,0
4.0,HUMBETGLOB,"[52, 252, 374, 599, 685, 918, 940, 956, 1174, 1262, 1309, 2014, 2473, 2557, 2929]","[956, 1309]","[52, 252, 374, 599, 685, 918, 940, 1174, 1262, 2014, 2473, 2557, 2929]","[956, 1309]",2993,15,2978,2,13,2978,0
4.0,HUMBETGLOC,"[52, 252, 376, 601, 687, 920, 942, 958, 1176, 1264, 1311, 2016, 2475, 2559, 2931]","[958, 1311]","[52, 252, 376, 601, 687, 920, 942, 1176, 1264, 2016, 2475, 2559, 2931]","[958, 1311]",2995,15,2980,2,13,2980,0
4.0,HUMBETGLOD,"[52, 252, 376, 601, 687, 920, 942, 958, 1176, 1264, 1311, 2016, 2475, 2559, 2931]","[958, 1311]","[52, 252, 376, 601, 687, 920, 942, 1176, 1264, 2016, 2475, 2559, 2931]","[958, 1311]",2995,15,2980,2,13,2980,0
4.0,HUMBETGLOE,"[52, 252, 374, 599, 685, 918, 940, 956, 1174, 1262, 1309, 2014, 2473, 2557, 2929]","[956, 1309]","[52, 252, 374, 599, 685, 918, 940, 1174, 1262, 2014, 2473, 2557, 2929]","[956, 1309]",2993,15,2978,2,13,2978,0
4.0,HUMBETGLOF,"[52, 252, 376, 601, 687, 920, 942, 958, 1176, 1264, 1311, 2016, 2475, 2559, 2931]","[958, 1311]","[52, 252, 376, 601, 687, 920, 942, 1176, 1264, 2016, 2475, 2559, 2931]","[958, 1311]",2995,15,2980,2,13,2980,0
4.0,HUMBETGLOG,"[52, 252, 376, 601, 687, 920, 942, 958, 1176, 1264, 1311, 2016, 2475, 2559, 2931]","[958, 1311]","[52, 252, 376, 601, 687, 920, 942, 1176, 1264, 2016, 2475, 2559, 2931]","[958, 1311]",2995,15,2980,2,13,2980,0
4.0,HUMBETGLOH,"[52, 252, 376, 601, 687, 920, 942, 958, 1176, 1264, 1311, 2016, 2475, 2559, 2931]","[958, 1311]","[52, 252, 376, 601, 687, 920, 942, 1176, 1264, 2016, 2475, 2559, 2931]","[958, 1311]",2995,15,2980,2,13,2980,0
4.0,HUMBETGLOI,"[52, 252, 374, 599, 685, 918, 940, 956, 1174, 1262, 1309, 2014, 2473, 2557, 2929]","[956, 1309]","[52, 252, 374, 599, 685, 918, 940, 1174, 1262, 2014, 2473, 2557, 2929]","[956, 1309]",2993,15,2978,2,13,2978,0
4.0,HUMBETGLOJ,"[52, 252, 374, 599, 685, 918, 940, 956, 1174, 1262, 1309, 2014, 2473, 2557, 2929]","[956, 1309]","[52, 252, 374, 599, 685, 918, 940, 1174, 1262, 2014, 2473, 2557, 2929]","[956, 1309]",2993,15,2978,2,13,2978,0
4.0,HUMBETGLOK,"[52, 252, 374, 599, 685, 918, 940, 956, 1174, 1262, 1309, 2014, 2473, 2557, 2929]","[956, 1309]","[52, 252, 374, 599, 685, 918, 940, 1174, 1262, 2014, 2473, 2557, 2929]","[956, 1309]",2993,15,2978,2,13,2978,0
4.0,HUMBETGLOL,"[52, 252, 374, 599, 685, 918, 940, 956, 1174, 1262, 1309, 2014, 2473, 2557, 2929]","[956, 1309]","[52, 252, 374, 599, 685, 918, 940, 1174, 1262, 2014, 2473, 2557, 2929]","[956, 1309]",2993,15,2978,2,13,2978,0
4.0,HUMBETGLOM,"[52, 252, 373, 598, 684, 917, 939, 955, 1173, 1261, 1308, 2013, 2472, 2556, 2928]","[955, 1308]","[52, 252, 373, 598, 684, 917, 939, 1173, 1261, 2013, 2472, 2556, 2928]","[955, 1308]",2992,15,2977,2,13,2977,0
4.0,HUMBETGLON,"[52, 252, 374, 599, 685, 918, 940, 956, 1174, 1262, 1309, 2014, 2473, 2557, 2929]","[956, 1309]","[52, 252, 374, 599, 685, 918, 940, 1174, 1262, 2014, 2473, 2557, 2929]","[956, 1309]",2993,15,2978,2,13,2978,0
4.0,HUMBETGLOO,"[52, 252, 374, 599, 685, 918, 940, 956, 1174, 1262, 1309, 2014, 2473, 2557, 2929]","[956, 1309]","[52, 252, 374, 599, 685, 918, 940, 1174, 1262, 2014, 2473, 2557, 2929]","[956, 1309]",2993,15,2978,2,13,2978,0
4.0,HUMBETGLOP,"[52, 252, 374, 599, 685, 918, 940, 956, 1174, 1262, 1309, 2014, 2473, 2557, 2929]","[956, 1309]","[52, 252, 374, 599, 685, 918, 940, 1174, 1262, 2014, 2473, 2557, 2929]","[956, 1309]",2993,15,2978,2,13,2978,0
4.0,HUMBETGLOR,"[52, 252, 374, 599, 685, 918, 940, 956, 1174, 1262, 1309, 2014, 2473, 2557, 2929]","[956, 1309]","[52, 252, 374, 599, 685, 918, 940, 1174, 1262, 2014, 2473, 2557, 2929]","[956, 1309]",2993,15,2978,2,13,2978,0
4.0,HUMCBRG,"[80, 567, 704, 1220, 2848, 2897, 2901, 3041]","[567, 1220]","[80, 704, 2848, 2897, 2901, 3041]","[567, 1220]",3319,8,3311,2,6,3311,0
4.0,HUMCHYMASE,"[510, 646, 969, 1185, 1277, 1379, 1826, 2315, 2966, 3165, 3406, 3982, 4038, 5216, 5644, 5779, 6037, 6922, 7220, 7255, 7363, 7455, 7463, 7615, 8006, 8052]","[5216, 6037, 6922, 7363]","[510, 646, 969, 1185, 1277, 1379, 1826, 2315, 2966, 3165, 3406, 3982, 4038, 5644, 5779, 7220, 7255, 7455, 7463, 7615, 8006, 8052]","[5216, 6037, 6922, 7363]",8109,26,8083,4,22,8083,0
4.0,HUMCP21OH,"[92, 185, 408, 435, 463, 505, 626, 644, 947, 994, 1134, 1357, 1566, 1571, 1970, 2158, 2167, 2528, 2580, 2907, 2931, 3094, 3659]","[947, 1134, 1571, 1970, 2158, 2528, 2907, 3094]","[92, 185, 408, 435, 463, 505, 626, 644, 994, 1357, 1566, 2167, 2580, 2931, 3659]","[947, 1134, 1571, 1780, 1970, 2158, 2528, 2907, 3094]",4035,23,4012,8,15,4011,1
4.0,HUMCP21OHC,"[92, 185, 408, 435, 506, 627, 645, 948, 995, 1135, 1358, 1567, 1572, 1971, 2159, 2529, 2581, 2908, 2933, 3096, 3661]","[948, 1135, 1572, 1971, 2159, 2529, 2908, 3096]","[92, 185, 408, 435, 506, 627, 645, 995, 1358, 1567, 2581, 2933, 3661]","[948, 1135, 1572, 1781, 1971, 2159, 2529, 2908, 3096]",4037,21,4016,8,13,4015,1
4.0,HUMCS1,"[85, 148, 310, 429, 565, 669, 991, 1334, 1591, 1679, 2196, 2210]","[565, 991, 1334, 1591]","[85, 148, 310, 429, 669, 1679, 2196, 2210]","[565, 991, 1334, 1591]",2294,12,2282,4,8,2282,0
4.0,HUMCS3,"[87, 150, 312, 431, 566, 671, 991, 1334, 1588, 2200, 2214, 2520]","[566, 991, 1334, 1588]","[87, 150, 312, 431, 671, 2200, 2214, 2520]","[566, 991, 1334, 1588]",2733,12,2721,4,8,2721,0
4.0,HUMCSN2A,"[122, 591, 1451, 1845, 2228, 3194, 3776, 4104, 4855, 5391, 5620, 5742, 5747, 6144, 6682, 6747, 6887, 7474, 7789, 8522, 8683, 8805, 9482, 10265]","[4855, 5747, 6747, 6887, 8522]","[122, 591, 1451, 1845, 2228, 3194, 3776, 4104, 5391, 5620, 5742, 6144, 6682, 7474, 7789, 8683, 8805, 9482, 10265]","[4855, 5747, 6747, 6887, 8522]",10601,24,10577,5,19,10577,0
4.0,HUMCSPA,"[455, 982, 1239, 2276, 2929, 3200, 3608, 3691]","[982, 2276, 2929]","[455, 1239, 3200, 3608, 3691]","[982, 2276, 2929, 3392]",4784,8,4776,3,5,4775,1
4.0,HUMCTLA1,"[988, 1812, 2119, 2179, 2297, 2336, 2360, 2770, 3041, 3122, 3236, 3532, 3695]","[988, 2179, 2770, 3236]","[1812, 2119, 2297, 2336, 2360, 3041, 3122, 3532, 3695]","[988, 2179, 2770, 3236]",4521,13,4508,4,9,4508,0
4.0,HUMDEF5A,"[296, 500, 923, 1387, 1571, 1922, 2280, 2323, 2601]",[1571],"[296, 500, 923, 1387, 1922, 2280, 2323, 2601]",[1571],2873,9,2864,1,8,2864,0
4.0,HUMDZA2G,"[24, 296, 631, 680, 727, 829, 1645, 1982, 2003, 2928, 3711, 3942, 4262, 4436, 4857, 5316, 5389, 5436, 6013, 6178, 6636, 7542, 8063, 8480, 8981, 9184, 9590, 9649, 9898, 9945, 10624, 10677, 10862, 11016, 11212, 11267, 11300, 11530, 12139, 12274, 13183, 13467, 13485, 13857, 13862, 13938, 14633]","[5389, 9590, 13183]","[24, 296, 631, 680, 727, 829, 1645, 1982, 2003, 2928, 3711, 3942, 4262, 4436, 4857, 5316, 5436, 6013, 6178, 6636, 7542, 8063, 8480, 8981, 9184, 9649, 9898, 9945, 10624, 10677, 10862, 11016, 11212, 11267, 11300, 11530, 12139, 12274, 13467, 13485, 13857, 13862, 13938, 14633]","[5389, 9590, 13183]",14687,47,14640,3,44,14640,0
4.0,HUMELAFIN,"[3, 208, 326, 338, 557, 786, 802, 1089, 1351, 1456, 1461, 1517, 1534, 1559]",[326],"[3, 208, 338, 557, 786, 802, 1089, 1351, 1456, 1461, 1517, 1534, 1559]",[326],1871,14,1857,1,13,1857,0
4.0,HUMEPOHYDD,"[504, 776, 1107, 1724, 1951, 2164, 2190, 2283, 2289, 2972, 2990, 3069, 3143, 3680, 4407, 5656, 5979, 5997, 6115, 6277, 6289, 6422, 6537, 6542, 6599, 6758, 7946, 8217, 8696, 8728, 9045, 9132, 9213, 9470, 10184, 10319, 10475, 10621, 10778, 11088, 11772, 11832, 12105, 12409, 12625, 12819, 12928, 13103, 13241, 13279, 13416, 13804, 13924, 14095, 14495, 14606, 15062, 15197, 15227, 15620, 15705, 15831, 16085, 16324, 16771, 16775, 17075, 17080, 17170, 17238, 17511, 17789, 17810, 17870, 18254, 18395, 18573, 18887, 18944, 19204, 19373, 19698, 19920, 20118, 20318, 20545, 20674, 20683, 20720, 20857, 20883, 20954, 20979, 20994, 21354, 21648, 21715, 21945, 22251, 22856, 22952, 23010, 23217, 23497, 24312, 24408, 24469]","[5656, 8696, 15620, 16085, 16775, 19204, 21354]","[504, 776, 1107, 1724, 1951, 2164, 2190, 2283, 2289, 2972, 2990, 3069, 3143, 3680, 4407, 5979, 5997, 6115, 6277, 6289, 6422, 6537, 6542, 6599, 6758, 7946, 8217, 8728, 9045, 9132, 9213, 9470, 10184, 10319, 10475, 10621, 10778, 11088, 11772, 11832, 12105, 12409, 12625, 12819, 12928, 13103, 13241, 13279, 13416, 13804, 13924, 14095, 14495, 14606, 15062, 15197, 15227, 15705, 15831, 16324, 16771, 17075, 17080, 17170, 17238, 17511, 17789, 17810, 17870, 18254, 18395, 18573, 18887, 18944, 19373, 19698, 19920, 20118, 20318, 20545, 20674, 20683, 20720, 20857, 20883, 20954, 20979, 20994, 21648, 21715, 21945, 22251, 22856, 22952, 23010, 23217, 23497, 24312, 24408, 24469]","[5656, 8696, 15620, 16085, 16775, 19204, 21354]",24783,107,24676,7,100,24676,0
4.0,HUMG0S24B,"[91, 631, 658, 812, 1264]",[631],"[91, 658, 812, 1264]",[631],3128,5,3123,1,4,3123,0
4.0,HUMG0S8PP,"[91, 401, 660, 784, 942, 1230, 1379, 2148, 2152, 2682, 2826, 3036, 3170, 3768, 3840, 3932, 4113, 4399, 4646, 5361, 6236]","[2682, 3768, 3932, 4646]","[91, 401, 660, 784, 942, 1230, 1379, 2148, 2152, 2826, 3036, 3170, 3840, 4113, 4399, 5361, 6236]","[2682, 3768, 3932, 4646]",7338,21,7317,4,17,7317,0
4.0,HUMGAD45A,"[724, 927, 1215, 1321, 1558, 1761, 2266, 2457, 2461, 2596, 2968, 3092, 3184, 3645, 3730, 3734, 3880, 4167, 4171, 4396, 4427, 4472, 4529, 4828, 4956, 5015]","[2596, 3184, 3645]","[724, 927, 1215, 1321, 1558, 1761, 2266, 2457, 2461, 2968, 3092, 3730, 3734, 3880, 4167, 4171, 4396, 4427, 4472, 4529, 4828, 4956, 5015]","[2596, 3184, 3645]",5371,26,5345,3,23,5345,0
4.0,HUMGARE,"[25, 71, 322, 590, 609, 633, 810, 964, 1467, 1872, 2239, 2243, 2373, 2411, 2455, 2653, 2861, 3118, 3133, 3207, 3213, 3254, 3259, 4469, 4718]","[810, 2239, 2653, 3118]","[25, 71, 322, 590, 609, 633, 964, 1467, 1872, 2243, 2373, 2411, 2455, 2861, 3133, 3207, 3213, 3254, 3259, 4469, 4718]","[810, 2239, 2653, 3118]",4747,25,4722,4,21,4722,0
4.0,HUMGCK,"[304, 634, 725, 916, 1514, 1989, 2345, 3096, 3248, 3360, 3789, 3799, 3882, 4288, 4312, 4806, 5015, 5092, 5118, 5452, 5584, 5623, 5808, 5981, 6475, 6630, 6651, 6744, 6765, 6921, 7127]","[3360, 3882, 4312, 4806, 5015, 5452, 6475]","[304, 634, 725, 916, 1514, 1989, 2345, 3096, 3248, 3789, 3799, 4288, 5092, 5118, 5584, 5623, 5808, 5981, 6630, 6651, 6744, 6765, 6921, 7127]","[1188, 3360, 3882, 4312, 4806, 5015, 5452, 5964, 6475]",7530,31,7499,7,24,7497,2
4.0,HUMGFP40H,"[11, 910, 1058, 1140, 1173, 1748, 1846, 1943, 2593, 2752, 2781, 3126, 3426, 3615, 4025, 4290]","[910, 1058, 1173, 2593]","[11, 1140, 1748, 1846, 1943, 2752, 2781, 3126, 3426, 3615, 4025, 4290]","[910, 1058, 1173, 2593]",4372,16,4356,4,12,4356,0
4.0,HUMGHG,"[40, 689, 946, 1983, 2636, 2907, 3315, 3398]","[689, 1983, 2636]","[40, 946, 2907, 3315, 3398]","[689, 1983, 2636, 3099]",4445,8,4437,3,5,4436,1
4.0,HUMGHN,"[85, 148, 313, 434, 569, 673, 1316, 1574, 2181, 2439, 2583]","[569, 1316, 1574]","[85, 148, 313, 434, 673, 2181, 2439, 2583]","[569, 989, 1316, 1574]",2650,11,2639,3,8,2638,1
4.0,HUMGHV,"[86, 149, 432, 566, 1136, 1328, 1351, 1584, 2188, 2443, 2485]","[566, 1328, 1584]","[86, 149, 432, 1136, 1351, 2188, 2443, 2485]","[566, 998, 1328, 1584]",2653,11,2642,3,8,2641,1
4.0,HUMGSTM4A,"[516, 777, 781, 1139, 1272, 1631, 1844, 2024, 2098, 2124, 2225, 2573, 2880, 2925, 3023, 3262, 3463, 3753, 4160, 4306, 4311, 4425, 4566, 4760, 4791, 4798, 4913, 5623, 5629]","[777, 1139, 1631, 2024, 2225, 3262, 3463]","[516, 781, 1272, 1844, 2098, 2124, 2573, 2880, 2925, 3023, 3753, 4160, 4306, 4311, 4425, 4566, 4760, 4791, 4798, 4913, 5623, 5629]","[777, 1139, 1631, 2024, 2225, 3262, 3463]",6075,29,6046,7,22,6046,0
4.0,HUMHMGIY,"[310, 720, 1075, 1337, 1472, 1557, 2388, 2558, 2578, 2704, 3280, 3749, 3875, 3978, 3983, 4529, 4627, 4648, 4660, 4773, 5150, 5496, 5619, 6274, 6334, 6422, 6544, 6687, 7016, 7102, 7133, 7166, 7270, 7274, 7315, 7420, 7449, 7781, 7962, 8043, 8047, 8361, 9286, 9390, 9424, 9791, 9823, 10022]","[4660, 6544, 7270]","[310, 720, 1075, 1337, 1472, 1557, 2388, 2558, 2578, 2704, 3280, 3749, 3875, 3978, 3983, 4529, 4627, 4648, 4773, 5150, 5496, 5619, 6274, 6334, 6422, 6687, 7016, 7102, 7133, 7166, 7274, 7315, 7420, 7449, 7781, 7962, 8043, 8047, 8361, 9286, 9390, 9424, 9791, 9823, 10022]","[4660, 6544, 7270]",10103,48,10055,3,45,10055,0
4.0,HUMHOX13G,"[336, 380, 503, 1451, 1653, 2083, 2502, 2576, 2652, 2796]",[],"[336, 380, 503, 1451, 1653, 2083, 2502, 2576, 2652, 2796]",[811],3064,10,3054,0,10,3053,1
4.0,HUMHPARS1,"[20, 967, 1046, 1300, 1320, 1961, 2005, 2105, 2327, 2632, 3020, 3096, 3337, 3496, 3855, 4015, 4744, 4820, 5061, 5220, 5577, 5730, 6373, 6499, 6948, 7164, 7231, 7510, 7569, 7692, 7696, 8010, 8703, 8728, 8994, 9085, 9344, 9570, 9649, 9904, 9924, 10183, 10563, 10607, 10668, 11363, 11385]","[1046, 2632, 3020, 3855, 4744, 5577]","[20, 967, 1300, 1320, 1961, 2005, 2105, 2327, 3096, 3337, 3496, 4015, 4820, 5061, 5220, 5730, 6373, 6499, 6948, 7164, 7231, 7510, 7569, 7692, 7696, 8010, 8703, 8728, 8994, 9085, 9344, 9570, 9649, 9904, 9924, 10183, 10563, 10607, 10668, 11363, 11385]","[1046, 2632, 3020, 3855, 4744, 5577]",11544,47,11497,6,41,11497,0
4.0,HUMIBP3,"[182, 1260, 1284, 1409, 1473, 1556, 1685, 1701, 2441, 2457, 2584, 2715, 2845, 2935, 3142, 3149, 3356, 3924, 3984, 4247, 4262, 4304, 4342, 4358, 4406, 4924, 5122, 5197, 5553, 5735, 5953, 6617, 6621, 7184, 7377, 7687, 7842, 8353, 8677, 8756, 9118]","[2441, 5953, 6617]","[182, 1260, 1284, 1409, 1473, 1556, 1685, 1701, 2457, 2584, 2715, 2845, 2935, 3142, 3149, 3356, 3924, 3984, 4247, 4262, 4304, 4342, 4358, 4406, 4924, 5122, 5197, 5553, 5735, 6621, 7184, 7377, 7687, 7842, 8353, 8677, 8756, 9118]","[2441, 5953, 6617]",10877,41,10836,3,38,10836,0
4.0,HUMIDS,"[372, 636, 1160, 1972, 2038, 2248, 2376, 2549, 2860, 3140, 3243, 3321, 3731, 4119, 4174, 4684, 4778, 4865, 5244, 5385, 5446, 5850, 5864, 5927, 6071, 6178, 7368, 8086, 8266, 8364, 8796, 9161, 9282, 9391, 9526, 9847, 9901, 9965, 10120, 10170, 10734, 10877, 11136, 11158, 11397, 11401, 11928, 12302, 12329, 13103, 14040, 14418, 14645, 14655, 14702, 15205, 15210, 15477, 15596, 15879, 15901, 16084, 16844, 18130, 18552, 18689, 18976, 19046, 19106, 19301, 19599, 19657, 19747, 20044, 21250, 21311, 21624, 21640, 21795, 21930, 22369, 22809, 22814, 23494, 24724, 25810, 25819, 26843, 26943, 27097, 27785, 27983, 28676, 28773, 28973, 29070, 29338, 29400, 29441, 29518, 29555, 29710, 30034, 30410, 30535, 30554, 30602, 31004, 31147, 31168, 31515, 31699, 32027, 32099, 33900, 34107, 34645, 35626, 35761, 35777, 35958, 36682, 36718]","[1160, 2038, 5244, 8086, 9847, 15879]","[372, 636, 1972, 2248, 2376, 2549, 2860, 3140, 3243, 3321, 3731, 4119, 4174, 4684, 4778, 4865, 5385, 5446, 5850, 5864, 5927, 6071, 6178, 7368, 8266, 8364, 8796, 9161, 9282, 9391, 9526, 9901, 9965, 10120, 10170, 10734, 10877, 11136, 11158, 11397, 11401, 11928, 12302, 12329, 13103, 14040, 14418, 14645, 14655, 14702, 15205, 15210, 15477, 15596, 15901, 16084, 16844, 18130, 18552, 18689, 18976, 19046, 19106, 19301, 19599, 19657, 19747, 20044, 21250, 21311, 21624, 21640, 21795, 21930, 22369, 22809, 22814, 23494, 24724, 25810, 25819, 26843, 26943, 27097, 27785, 27983, 28676, 28773, 28973, 29070, 29338, 29400, 29441, 29518, 29555, 29710, 30034, 30410, 30535, 30554, 30602, 31004, 31147, 31168, 31515, 31699, 32027, 32099, 33900, 34107, 34645, 35626, 35761, 35777, 35958, 36682, 36718]","[1160, 2038, 2882, 5244, 8086, 9847, 15879, 19268]",36838,123,36715,6,117,36713,2
4.0,HUMIGERA,"[68, 1072, 1089, 1261, 1342, 1601, 1797, 2173, 2574, 3105, 3141, 3309, 3416, 3471, 4527, 4792, 5005, 5043, 5168, 5626, 5709, 6119, 6188, 6281, 6676, 7019, 7275]","[1342, 1797, 3105, 5168]","[68, 1072, 1089, 1261, 1601, 2173, 2574, 3141, 3309, 3416, 3471, 4527, 4792, 5005, 5043, 5626, 5709, 6119, 6188, 6281, 6676, 7019, 7275]","[1342, 1797, 3105, 5168]",7652,27,7625,4,23,7625,0
4.0,HUMIL2RGA,"[28, 231, 735, 772, 817, 840, 943, 1232, 1476, 1646, 1914, 1957, 1980, 2162, 2402, 2683, 2783, 2794, 3031, 3126, 3353, 4026]","[735, 1476, 2402, 3031, 3353]","[28, 231, 772, 817, 840, 943, 1232, 1646, 1914, 1957, 1980, 2162, 2683, 2783, 2794, 3126, 4026]","[203, 735, 1128, 1476, 2402, 3031, 3353]",4031,22,4009,5,17,4007,2
4.0,HUMIL4A,"[59, 67, 189, 328, 491, 1306, 1626, 2072, 3234, 3254, 3380, 3861, 3877, 4037, 4460, 4465, 5634, 6460, 6557, 7003, 7433, 7514, 7518, 7915, 7981, 8135, 8316, 8362, 8391, 8407, 8461, 8466, 8512, 8605, 8686, 9292, 9369, 9400, 9501, 9622]","[1306, 1626, 7003]","[59, 67, 189, 328, 491, 2072, 3234, 3254, 3380, 3861, 3877, 4037, 4460, 4465, 5634, 6460, 6557, 7433, 7514, 7518, 7915, 7981, 8135, 8316, 8362, 8391, 8407, 8461, 8466, 8512, 8605, 8686, 9292, 9369, 9400, 9501, 9622]","[1306, 1626, 7003]",9893,40,9853,3,37,9853,0
4.0,HUMIRBPG,"[786, 1819, 1823, 2428, 2776, 3181, 3221, 3400, 3550, 4554, 4612, 4672, 5069, 5157, 5340, 5556, 6592, 6975, 7160, 7238, 7261, 8440, 8766, 8885, 9262]","[3181, 5157, 7160]","[786, 1819, 1823, 2428, 2776, 3221, 3400, 3550, 4554, 4612, 4672, 5069, 5340, 5556, 6592, 6975, 7238, 7261, 8440, 8766, 8885, 9262]","[3181, 5157, 7160]",9704,25,9679,3,22,9679,0
4.0,HUMLHDC,"[166, 766, 791, 843, 1727, 1763, 2138, 3070, 3735, 4598, 4925, 5561, 6016, 6047, 6140, 6257, 6295, 6492, 7357, 7415, 7475, 7949, 8200, 8345, 8690, 8728, 8890, 8992, 9773, 9823, 10512, 10795, 11183, 11221, 11591, 11765, 11774, 12252, 12347, 12354, 12358, 12756, 13017, 13087, 13182, 14169, 14605, 14811, 15099, 15584, 16409, 16774, 17363, 18253, 18382, 18464, 18782, 18827, 18855, 18932, 19312, 19921, 19951, 20075, 20118, 20143, 20300, 20482, 21206, 21593, 21661, 21813, 21867, 22046, 22090, 22140, 22928, 23463, 24054, 24086, 24666, 24767, 25233, 25563, 26636, 27104, 27699, 28034, 28067, 28493, 28499, 28537, 28671, 28843, 29151, 29773, 30408, 30438, 31558, 31702, 31819, 31856, 32156, 32346]","[7415, 9773, 14605, 15584, 18382, 18782, 19312, 20300, 20482, 24666, 29773]","[166, 766, 791, 843, 1727, 1763, 2138, 3070, 3735, 4598, 4925, 5561, 6016, 6047, 6140, 6257, 6295, 6492, 7357, 7475, 7949, 8200, 8345, 8690, 8728, 8890, 8992, 9823, 10512, 10795, 11183, 11221, 11591, 11765, 11774, 12252, 12347, 12354, 12358, 12756, 13017, 13087, 13182, 14169, 14811, 15099, 16409, 16774, 17363, 18253, 18464, 18827, 18855, 18932, 19921, 19951, 20075, 20118, 20143, 21206, 21593, 21661, 21813, 21867, 22046, 22090, 22140, 22928, 23463, 24054, 24086, 24767, 25233, 25563, 26636, 27104, 27699, 28034, 28067, 28493, 28499, 28537, 28671, 28843, 29151, 30408, 30438, 31558, 31702, 31819, 31856, 32156, 32346]","[7415, 9773, 14605, 15584, 18382, 18782, 19312, 20300, 20482, 24666, 29773]",32344,104,32240,11,93,32240,0
4.0,HUMLUCT,"[108, 1550, 1877, 2505, 2861, 3004]","[1550, 2505, 2861]","[108, 1877, 3004]","[1550, 2505, 2861]",3289,6,3283,3,3,3283,0
4.0,HUMLYTOXBB,"[1097, 1235, 1357, 1361, 1395, 2157, 2184, 2202, 2275, 2657, 2734, 2934, 3150, 3207, 3330, 3376, 3631, 4333, 4402, 4477, 4665, 5005, 5291, 5345, 5349, 5530, 6032]","[2934, 3376, 3631]","[1097, 1235, 1357, 1361, 1395, 2157, 2184, 2202, 2275, 2657, 2734, 3150, 3207, 3330, 4333, 4402, 4477, 4665, 5005, 5291, 5345, 5349, 5530, 6032]","[2934, 3376, 3631]",6298,27,6271,3,24,6271,0
4.0,HUMMCHEMP,"[159, 674, 790, 812, 984, 1077, 1328, 1590]","[674, 1590]","[159, 790, 812, 984, 1077, 1328]","[674, 1590]",2758,8,2750,2,6,2750,0
4.0,HUMMET2,"[866, 1128, 1167, 1233]","[866, 1233]","[1128, 1167]","[866, 1233]",1696,4,1692,2,2,1692,0
4.0,HUMMGPA,"[845, 1045, 1050, 1288, 1299, 1628, 2484, 2515, 3516, 3748, 4493, 5093, 6334, 7349, 7617]","[3516, 5093, 6334]","[845, 1045, 1050, 1288, 1299, 1628, 2484, 2515, 3748, 4493, 7349, 7617]","[3516, 5093, 6334]",7727,15,7712,3,12,7712,0
4.0,HUMMIF,"[700, 753, 912, 1129, 1643]",[1643],"[700, 753, 912, 1129]","[1281, 1643]",2160,5,2155,1,4,2154,1
4.0,HUMMIS,"[623, 669, 778, 1358, 1489, 1639, 1887]","[623, 1358, 1639, 1887]","[669, 778, 1489]","[623, 1358, 1639, 1887]",3093,7,3086,4,3,3086,0
4.0,HUMMKXX,"[870, 1040, 1168, 1264, 1290, 1415, 1574, 1737, 1887, 2019, 2078, 2202, 2463, 2985, 3142, 3172, 3194]","[1415, 1737, 2019]","[870, 1040, 1168, 1264, 1290, 1574, 1887, 2078, 2202, 2463, 2985, 3142, 3172, 3194]","[1415, 1737, 2019]",3301,17,3284,3,14,3284,0
4.0,HUMNKG5PRO,"[298, 345, 605, 843, 964, 1055, 1118, 1505, 1644, 1865, 1896, 2262, 2639, 2715, 2788, 2915, 2978, 3215, 3283, 3314, 3580, 3848, 3982, 4048, 5379, 5435, 5468, 5480, 6576, 6599]","[2262, 3215, 3848, 5468]","[298, 345, 605, 843, 964, 1055, 1118, 1505, 1644, 1865, 1896, 2639, 2715, 2788, 2915, 2978, 3283, 3314, 3580, 3982, 4048, 5379, 5435, 5480, 6576, 6599]","[2262, 3215, 3848, 5468]",6739,30,6709,4,26,6709,0
4.0,HUMNTRI,"[10, 575, 1247, 1483, 1629, 2145, 2342, 2412, 2615, 2802, 3141, 3151]",[2802],"[10, 575, 1247, 1483, 1629, 2145, 2342, 2412, 2615, 3141, 3151]",[2802],3703,12,3691,1,11,3691,0
4.0,HUMNTRIII,"[10, 575, 1247, 1483, 1629, 2145, 2342, 2412, 2615, 2802, 3141, 3151]",[2802],"[10, 575, 1247, 1483, 1629, 2145, 2342, 2412, 2615, 3141, 3151]",[2802],3703,12,3691,1,11,3691,0
4.0,HUMOSTP,"[214, 970, 1509, 1549, 1581, 2162, 2358, 3054, 3385, 3509, 3657, 3909, 4738, 6004, 6322, 6327, 6420, 6480, 6986, 7813, 7897, 8035, 8287, 8349, 8520, 8785, 8832, 9372, 10025, 10776]","[3509, 3657, 6986, 8349]","[214, 970, 1509, 1549, 1581, 2162, 2358, 3054, 3385, 3909, 4738, 6004, 6322, 6327, 6420, 6480, 7813, 7897, 8035, 8287, 8520, 8785, 8832, 9372, 10025, 10776]","[3509, 3657, 6679, 6986, 8349]",10731,30,10701,4,26,10700,1
4.0,HUMPAP,"[167, 440, 641, 1012, 1410, 1490, 1495, 1737, 1970, 2089, 2115, 3167, 3342, 3477, 4164, 4270, 4366, 4478]","[1410, 2089, 3167]","[167, 440, 641, 1012, 1490, 1495, 1737, 1970, 2115, 3342, 3477, 4164, 4270, 4366, 4478]","[1410, 2089, 2414, 3167]",4490,18,4472,3,15,4471,1
4.0,HUMPCI,"[284, 312, 511, 1538, 2078, 2124, 2208, 2226, 2298, 2586, 2671, 2784, 2812, 2930, 2957, 3129, 3307, 3575, 3636, 3914, 4332, 4672, 4697, 4718, 4859, 5210, 5543, 7199, 7255, 8054, 8156, 8384, 8568, 8664, 8725, 9209, 9603, 9820, 9964, 10819, 10898, 11275, 11483, 12792, 14117, 14121, 14247, 14264, 14272, 14452, 14982, 15064, 15146]","[8568, 10898, 11483]","[284, 312, 511, 1538, 2078, 2124, 2208, 2226, 2298, 2586, 2671, 2784, 2812, 2930, 2957, 3129, 3307, 3575, 3636, 3914, 4332, 4672, 4697, 4718, 4859, 5210, 5543, 7199, 7255, 8054, 8156, 8384, 8664, 8725, 9209, 9603, 9820, 9964, 10819, 11275, 12792, 14117, 14121, 14247, 14264, 14272, 14452, 14982, 15064, 15146]","[8568, 10898, 11483]",15564,53,15511,3,50,15511,0
4.0,HUMPEM,"[693, 700, 789, 934, 948, 1033, 1537, 2101, 2266, 2421, 2614, 2707, 2850, 2973, 3203, 3297, 3314, 3590, 3745, 3904, 3921, 4210]","[934, 2266, 2421, 2707, 2973, 3203]","[693, 700, 789, 948, 1033, 1537, 2101, 2614, 2850, 3297, 3314, 3590, 3745, 3904, 3921, 4210]","[934, 2266, 2421, 2707, 2973, 3203]",4236,22,4214,6,16,4214,0
4.0,HUMPEPYYA,"[7, 20, 647, 727, 766, 904, 1201, 1307, 1537, 1699, 1824, 2196, 2243, 2254]",[1201],"[7, 20, 647, 727, 766, 904, 1307, 1537, 1699, 1824, 2196, 2243, 2254]","[1201, 1388]",2371,14,2357,1,13,2356,1
4.0,HUMPF4V1A,"[11, 199, 381, 785, 826]","[381, 826]","[11, 199, 785]","[381, 826]",1461,5,1456,2,3,1456,0
4.0,HUMPHOSA,"[87, 233, 312, 425, 604, 850, 1300, 1494, 1555, 1713, 1810, 2185, 2323, 2469, 3209, 3729, 4516, 4789]","[233, 850, 1494, 1810, 2323, 3209, 3729]","[87, 312, 425, 604, 1300, 1555, 1713, 2185, 2469, 4516, 4789]","[233, 850, 1494, 1810, 2323, 2988, 3209, 3729]",4885,18,4867,7,11,4866,1
4.0,HUMPRCA,"[130, 488, 498, 684, 1048, 1687, 2201, 2304, 2309, 2354, 3181, 3438, 3631, 3703, 3856, 4175, 4778, 5118, 5348, 5452, 5512, 5585, 6604, 6648, 6777, 7256, 7719, 7822, 7994, 8396, 8524, 8580, 8584, 9387, 9620, 10055, 10977, 10987, 11461]","[2201, 3631, 5118, 5348, 5585, 8396, 9387]","[130, 488, 498, 684, 1048, 1687, 2304, 2309, 2354, 3181, 3438, 3703, 3856, 4175, 4778, 5452, 5512, 6604, 6648, 6777, 7256, 7719, 7822, 7994, 8524, 8580, 8584, 9620, 10055, 10977, 10987, 11461]","[2201, 3631, 5118, 5348, 5585, 8396, 9387]",11718,39,11679,7,32,11679,0
4.0,HUMPREELAS,"[253, 274, 478, 596, 608, 826, 1054, 1070, 1357, 1619, 1724, 1729, 1785, 1802, 1827]",[596],"[253, 274, 478, 608, 826, 1054, 1070, 1357, 1619, 1724, 1729, 1785, 1802, 1827]",[596],2293,15,2278,1,14,2278,0
4.0,HUMPRPHX,"[71, 317, 963, 1143, 1346, 1475, 1551, 1838, 1911, 2127, 2502, 2550, 2869, 3173, 3322, 3633, 3719, 3914, 4225, 4319]","[1346, 1838, 2127, 2869, 3173, 3322, 3633]","[71, 317, 963, 1143, 1475, 1551, 1911, 2502, 2550, 3719, 3914, 4225, 4319]","[1346, 1838, 2127, 2652, 2869, 3173, 3322, 3633]",4525,20,4505,7,13,4504,1
4.0,HUMRCC1,"[108, 246, 486, 638, 654, 1017, 1608, 1708, 2437, 2711, 3455, 4068, 4304, 4379, 4555, 4654, 4681, 4733, 4737, 4787, 4872, 5210, 5479, 5545, 5741, 6493, 6765, 7271, 8114, 8701, 8986, 9297, 9960, 10178, 10252, 10535, 10711, 11120, 11134, 11329, 11415, 12573, 12616, 12731, 13006, 13360, 13471, 13510, 13805, 13819, 14069, 14368, 14604, 14619, 14697, 14702, 15108, 15126, 15324, 15440, 15532, 15548, 15704, 15894, 16280, 16316, 16362, 16465, 16526, 16574, 16836, 17016, 17025, 17556, 17950, 18304, 18348, 18716, 18787, 19037, 19296, 19495, 19784, 19855, 20442, 20849, 20918, 21036, 21092, 21303, 22033, 22051, 22205, 22579, 22826, 23423, 23681, 23725, 24194, 24201, 25071, 25857, 26108, 26218, 26579, 26701, 26808, 26989, 27447, 28010, 28244, 28523, 28793, 28893, 29020, 29247, 29419, 29746, 29766, 29965, 30085, 30235, 30648, 31610, 31672, 32040, 32435, 33137, 33278, 33503, 34138, 34406, 34481]","[24201, 26218, 26579, 28010, 28244, 28893, 29247, 29766]","[108, 246, 486, 638, 654, 1017, 1608, 1708, 2437, 2711, 3455, 4068, 4304, 4379, 4555, 4654, 4681, 4733, 4737, 4787, 4872, 5210, 5479, 5545, 5741, 6493, 6765, 7271, 8114, 8701, 8986, 9297, 9960, 10178, 10252, 10535, 10711, 11120, 11134, 11329, 11415, 12573, 12616, 12731, 13006, 13360, 13471, 13510, 13805, 13819, 14069, 14368, 14604, 14619, 14697, 14702, 15108, 15126, 15324, 15440, 15532, 15548, 15704, 15894, 16280, 16316, 16362, 16465, 16526, 16574, 16836, 17016, 17025, 17556, 17950, 18304, 18348, 18716, 18787, 19037, 19296, 19495, 19784, 19855, 20442, 20849, 20918, 21036, 21092, 21303, 22033, 22051, 22205, 22579, 22826, 23423, 23681, 23725, 24194, 25071, 25857, 26108, 26701, 26808, 26989, 27447, 28523, 28793, 29020, 29419, 29746, 29965, 30085, 30235, 30648, 31610, 31672, 32040, 32435, 33137, 33278, 33503, 34138, 34406, 34481]","[24201, 26218, 26579, 28010, 28244, 28893, 29247, 29766]",34634,133,34501,8,125,34501,0
4.0,HUMREGHOM,"[52, 274, 684, 891, 1170, 1419, 1423, 1864, 1909, 2739, 2825, 3329]","[684, 1419, 1864, 2739]","[52, 274, 891, 1170, 1423, 1909, 2825, 3329]","[684, 1419, 1864, 2739]",3404,12,3392,4,8,3392,0
4.0,HUMROD1X,"[1146, 1242, 1876, 2015, 2227, 2343, 2611, 2638, 2695, 2720]","[1242, 1876]","[1146, 2015, 2227, 2343, 2611, 2638, 2695, 2720]","[1242, 1876]",2834,10,2824,2,8,2824,0
4.0,HUMRPIB2,"[310, 356, 435, 472, 510, 622, 899, 1121, 1531, 1737, 2017, 2268, 2272, 2713, 2758, 3588, 3674, 4178]","[1531, 2268, 2713, 3588]","[310, 356, 435, 472, 510, 622, 899, 1121, 1737, 2017, 2272, 2758, 3674, 4178]","[1531, 2268, 2713, 3588]",4330,18,4312,4,14,4312,0
4.0,HUMRPS6B,"[359, 363, 784, 1059, 1168, 1232, 1543, 1721, 1838, 2146, 2178, 2651, 2866, 3072, 3893, 4051, 4432, 4655, 4838]","[359, 1059, 1838, 2178, 4051]","[363, 784, 1168, 1232, 1543, 1721, 2146, 2651, 2866, 3072, 3893, 4432, 4655, 4838]","[359, 1059, 1838, 2178, 4051]",4967,19,4948,5,14,4948,0
4.0,HUMSEMI,"[262, 578, 793, 806, 975, 1583, 1636, 2394, 2547, 2682, 2979, 3074, 3496, 3849]",[793],"[262, 578, 806, 975, 1583, 1636, 2394, 2547, 2682, 2979, 3074, 3496, 3849]",[793],4157,14,4143,1,13,4143,0
4.0,HUMSEMIIB,"[493, 528, 765, 1274, 1298, 1302, 1316, 1389, 1642, 1790, 1889, 1988, 2410, 2515, 2616, 2979, 3135, 3352, 3511, 3769, 3843, 4271, 4486, 4499, 4660, 4667, 5275, 5328, 5640, 5820, 6000, 6304, 6446, 7146, 7527, 7944]",[4486],"[493, 528, 765, 1274, 1298, 1302, 1316, 1389, 1642, 1790, 1889, 1988, 2410, 2515, 2616, 2979, 3135, 3352, 3511, 3769, 3843, 4271, 4499, 4660, 4667, 5275, 5328, 5640, 5820, 6000, 6304, 6446, 7146, 7527, 7944]",[4486],8217,36,8181,1,35,8181,0
4.0,HUMSTATH2,"[353, 911, 1140, 1197, 1553, 1675, 1820, 2025, 2131, 2151, 2322, 2403, 2530, 2627, 2733, 2848, 3710, 4629]","[353, 1553, 1675]","[911, 1140, 1197, 1820, 2025, 2131, 2151, 2322, 2403, 2530, 2627, 2733, 2848, 3710, 4629]","[353, 1553, 1675]",4716,18,4698,3,15,4698,0
4.0,HUMTBGA,"[377, 451, 854, 1021, 1050, 1646, 2099, 2681, 2911, 3355, 4529, 4941, 5164, 5177, 5231, 5236, 5475, 5530, 5879, 6296, 6314, 6627, 6841, 7144, 7395, 7441, 7960, 8219, 8362]","[4941, 7144]","[377, 451, 854, 1021, 1050, 1646, 2099, 2681, 2911, 3355, 4529, 5164, 5177, 5231, 5236, 5475, 5530, 5879, 6296, 6314, 6627, 6841, 7395, 7441, 7960, 8219, 8362]","[4941, 6265, 7144]",8762,29,8733,2,27,8732,1
4.0,HUMTCRBRA,"[278, 318]",[278],[318],[278],729,2,727,1,1,727,0
4.0,HUMTHROMA,"[159, 187, 787, 800, 1277, 1464, 1605, 1696, 1985, 2344, 2384, 2717, 3117, 4222, 4266, 4362, 4394, 4817, 5134, 5715]","[1985, 2344, 2717, 4817]","[159, 187, 787, 800, 1277, 1464, 1605, 1696, 2384, 3117, 4222, 4266, 4362, 4394, 5134, 5715]","[1985, 2344, 2717, 4817]",6156,20,6136,4,16,6136,0
4.0,HUMTNP2SS,"[80, 86, 177, 658, 673, 941]",[658],"[80, 86, 177, 673, 941]",[658],1775,6,1769,1,5,1769,0
4.0,HUMTPALBU,"[313, 722, 1094, 1359, 1621, 1708, 2692, 2741, 3377, 3425, 3781, 4153, 4361, 4587, 4707, 4711, 4720, 5992, 6086]","[1094, 1621, 2741, 3425, 4361]","[313, 722, 1359, 1708, 2692, 3377, 3781, 4153, 4587, 4707, 4711, 4720, 5992, 6086]","[1094, 1621, 2741, 3425, 4361]",6165,19,6146,5,14,6146,0
4.0,HUMTRHYAL,"[201, 301, 562, 827, 1120, 1557, 1645, 1793, 2232, 2340, 2837, 4658, 6019, 6556, 7415, 8581]",[1645],"[201, 301, 562, 827, 1120, 1557, 1793, 2232, 2340, 2837, 4658, 6019, 6556, 7415, 8581]",[1645],9544,16,9528,1,15,9528,0
4.0,HUMTSHB2,"[187, 780]",[187],[780],[187],979,2,977,1,1,977,0
4.0,HUMV2R,"[261, 287, 1366, 1404, 1507, 2047, 2128]","[261, 1507]","[287, 1366, 1404, 2047, 2128]","[261, 1507]",2275,7,2268,2,5,2268,0
4.0,HYPSCGH,"[41, 806, 837, 889, 1039, 1252, 1624]","[41, 1039, 1624]","[806, 837, 889, 1252]","[41, 451, 1039, 1624]",2477,7,2470,3,4,2469,1
4.0,LAYEGLOBIN,"[222, 238, 537, 584, 1185, 1197, 1265, 1312, 1373]","[238, 584]","[222, 537, 1185, 1197, 1265, 1312, 1373]","[238, 584]",1695,9,1686,2,7,1686,0
4.0,LEBGLOB,"[94, 142, 157, 662, 1501, 1539, 1561, 1577, 1663, 1791, 1828, 1926, 2206, 3171, 3208, 3565]","[1577, 1926]","[94, 142, 157, 662, 1501, 1539, 1561, 1663, 1791, 1828, 2206, 3171, 3208, 3565]","[1577, 1926]",3639,16,3623,2,14,3623,0
4.0,LNOEGLOBIN,"[220, 236, 345, 540, 587, 603, 1185, 1197, 1293, 1312]","[236, 587]","[220, 345, 540, 603, 1185, 1197, 1293, 1312]","[236, 587]",1691,10,1681,2,8,1681,0
4.0,MACHBGA1,"[283, 457, 495, 794, 841, 1370]","[495, 841]","[283, 457, 794, 1370]","[495, 841]",2098,6,2092,2,4,2092,0
4.0,MACHBGA2,"[281, 455, 493, 792, 839, 1367]","[493, 839]","[281, 455, 792, 1367]","[493, 839]",2101,6,2095,2,4,2095,0
4.0,MAMGLUTRA,"[484, 663, 1255, 1627, 1718, 1819, 2152, 2406, 2558, 2745, 2938, 3059, 3175, 4252, 4272, 4298, 4967, 4974, 5131, 5135, 5213, 5870]","[484, 1255, 1627, 1819, 2745, 2938]","[663, 1718, 2152, 2406, 2558, 3059, 3175, 4252, 4272, 4298, 4967, 4974, 5131, 5135, 5213, 5870]","[484, 821, 1255, 1627, 1819, 2745, 2938]",6288,22,6266,6,16,6265,1
4.0,MAU09941,"[11, 613, 778, 1031, 1166, 1480, 1803, 1830, 1846, 2427, 2667, 2932, 2968, 3134, 3521]",[1830],"[11, 613, 778, 1031, 1166, 1480, 1803, 1846, 2427, 2667, 2932, 2968, 3134, 3521]",[1830],3799,15,3784,1,14,3784,0
4.0,MFAPOA2A,"[53, 133, 226, 379, 571, 587, 785, 1422]","[379, 785]","[53, 133, 226, 571, 587, 1422]","[379, 785]",1490,8,1482,2,6,1482,0
4.0,MFAPOC3A,"[115, 232, 642, 913, 1172, 1239, 1715, 1993, 2232, 2384, 2439, 2689, 3213]","[913, 1172]","[115, 232, 642, 1239, 1715, 1993, 2232, 2384, 2439, 2689, 3213]","[913, 1172]",3255,13,3242,2,11,3242,0
4.0,MMA2IXCOA,"[599, 798, 859, 878, 1383, 1439, 1757, 1800, 1812, 1866, 1881, 1925, 2935, 3132, 3652, 4386, 5665, 5682, 5831, 6014, 6266, 6355, 6481, 6628, 6635, 6930, 7102, 7250, 7371, 7472, 7658, 7684, 8064, 8135, 8216, 8255, 8401, 8539, 8882, 9209, 9322, 9467, 9609, 9626, 9793, 10270, 10282, 10304, 10930, 11077, 11426, 11611, 12074, 12952, 13033, 13111, 13447, 13609, 13726, 13786, 13840, 14575, 15021, 15338, 15597, 15933, 16114, 16240, 16522, 16811, 17106, 17275, 17333, 17647, 18032, 18243, 18283]","[3132, 4386, 5682, 5831, 7102, 7250, 7371, 7684, 8064, 8216, 8401, 8539, 8882, 9322, 9467, 9626, 13033, 13447, 13726, 14575, 15021, 15338, 15597, 15933, 16114, 16240, 16522, 16811, 17275, 17647]","[599, 798, 859, 878, 1383, 1439, 1757, 1800, 1812, 1866, 1881, 1925, 2935, 3652, 5665, 6014, 6266, 6355, 6481, 6628, 6635, 6930, 7472, 7658, 8135, 8255, 9209, 9609, 9793, 10270, 10282, 10304, 10930, 11077, 11426, 11611, 12074, 12952, 13111, 13609, 13786, 13840, 17106, 17333, 18032, 18243, 18283]","[3132, 4386, 5682, 5831, 7102, 7250, 7371, 7684, 8064, 8216, 8401, 8539, 8882, 9322, 9467, 9626, 13033, 13447, 13726, 14575, 15021, 15338, 15597, 15746, 15933, 16114, 16240, 16522, 16811, 17275, 17647]",19472,77,19395,30,47,19394,1
4.0,MMACLGNA,"[474, 499, 553, 918, 1458, 1499, 2537, 2666, 2734, 2923, 2969, 3107, 3178]","[474, 3178]","[499, 553, 918, 1458, 1499, 2537, 2666, 2734, 2923, 2969, 3107]","[474, 3178]",3874,13,3861,2,11,3861,0
4.0,MMAPOG,"[143, 265, 536, 806, 1186, 1456, 1935, 2056]","[536, 806]","[143, 265, 1186, 1456, 1935, 2056]","[536, 806]",2169,8,2161,2,6,2161,0
4.0,MMASM1G,"[1088, 1141, 2244, 2830, 2928, 3245, 3367, 3599, 3619, 3745, 3749, 4681]","[1088, 2244, 2928, 3245, 3745]","[1141, 2830, 3367, 3599, 3619, 3749, 4681]","[1088, 2244, 2928, 3245, 3745]",4768,12,4756,5,7,4756,0
4.0,MMCASEIB,"[439, 1113, 1889, 2857, 3141, 3742, 4901, 4916, 5615, 5877, 6252, 6305, 6603, 6611, 6905, 6932, 7023, 7119, 7155, 7160, 7964, 8126, 8222, 8252, 8851, 9803, 10030, 10443, 11712, 11758, 11765, 11838, 12928, 13000]","[6252, 7023, 7160, 8126, 8252, 9803]","[439, 1113, 1889, 2857, 3141, 3742, 4901, 4916, 5615, 5877, 6305, 6603, 6611, 6905, 6932, 7119, 7155, 7964, 8222, 8851, 10030, 10443, 11712, 11758, 11765, 11838, 12928, 13000]","[6252, 7023, 7160, 8126, 8252, 9803]",13047,34,13013,6,28,13013,0
4.0,MMCD24A,"[115, 233, 274, 287, 477, 1126, 1660, 1969, 2195, 2486, 2860, 3693, 3805, 3949, 4043, 4140, 5435, 5478, 6323, 6430, 6441, 7063, 7471, 7475]",[2486],"[115, 233, 274, 287, 477, 1126, 1660, 1969, 2195, 2860, 3693, 3805, 3949, 4043, 4140, 5435, 5478, 6323, 6430, 6441, 7063, 7471, 7475]",[2486],7635,24,7611,1,23,7611,0
4.0,MMCFOS,"[99, 376, 844, 1850, 2162, 2208, 2363, 3118, 3414]","[844, 1850, 2363]","[99, 376, 2162, 2208, 3118, 3414]","[844, 1850, 2363]",3960,9,3951,3,6,3951,0
4.0,MMCOL10A,"[30, 216, 560, 1070, 1193, 1518, 1719, 1802, 1964, 2931, 3292, 3514, 3918, 3985, 4222, 4716, 4974, 5105, 5224, 5660, 5729, 5765, 6146, 6290, 6371, 6389, 6407, 6704, 6833, 7009, 7059, 7101, 7192, 7282, 7286, 7335, 7656, 8029, 9001, 9050, 9284, 9322]",[1802],"[30, 216, 560, 1070, 1193, 1518, 1719, 1964, 2931, 3292, 3514, 3918, 3985, 4222, 4716, 4974, 5105, 5224, 5660, 5729, 5765, 6146, 6290, 6371, 6389, 6407, 6704, 6833, 7009, 7059, 7101, 7192, 7282, 7286, 7335, 7656, 8029, 9001, 9050, 9284, 9322]",[1802],9324,42,9282,1,41,9282,0
4.0,MMCRPG,"[375, 523, 929]",[375],"[523, 929]",[375],2133,3,2130,1,2,2130,0
4.0,MMCYTOKNA,"[810, 1089, 1123, 1339, 1580, 1881]",[810],"[1089, 1123, 1339, 1580, 1881]","[810, 1559]",2552,6,2546,1,5,2545,1
4.0,MMDM2RR,"[104, 665, 680, 854, 878, 1305, 1439, 1651, 1846, 2004, 2407, 2702, 3262, 3378, 3509, 3526, 3701, 3962, 4028, 4134, 4663, 4925, 5134, 6030, 6048, 6320, 6591]","[665, 854, 1305, 1651, 2702, 3701, 3962, 4925, 5134]","[104, 680, 878, 1439, 1846, 2004, 2407, 3262, 3378, 3509, 3526, 4028, 4134, 4663, 6030, 6048, 6320, 6591]","[665, 854, 1305, 1651, 2702, 3701, 3962, 4925, 5134]",6633,27,6606,9,18,6606,0
4.0,MMDNAASFA,"[542, 855, 859, 918, 1241, 1497, 1576, 1823, 2357, 2406, 3306, 3517, 3558, 3682, 4306]","[855, 1241, 1576, 1823, 2357]","[542, 859, 918, 1497, 2406, 3306, 3517, 3558, 3682, 4306]","[855, 1241, 1576, 1823, 2135, 2357, 2695]",4311,15,4296,5,10,4294,2
4.0,MMEZGL,"[54, 106, 589, 613, 637, 715, 802, 910, 1167, 1276, 1599, 1625]","[589, 1599]","[54, 106, 613, 637, 715, 802, 910, 1167, 1276, 1625]","[589, 1599]",1947,12,1935,2,10,1935,0
4.0,MMG37,"[265, 332, 336, 348, 381, 788, 2119, 2363, 2570, 2771, 2788]","[332, 788, 2119, 2363, 2570]","[265, 336, 348, 381, 2771, 2788]","[332, 788, 1303, 2119, 2363, 2570]",3066,11,3055,5,6,3054,1
4.0,MMGBCRYA,"[165, 188, 332, 671, 1003, 1412, 1718, 2175, 2261, 2662]","[671, 1003]","[165, 188, 332, 1412, 1718, 2175, 2261, 2662]","[671, 1003]",2655,10,2645,2,8,2645,0
4.0,MMGCCRYA,"[721, 1056, 1430, 1716, 1790, 1807, 2488, 2650, 2655]","[721, 1056]","[1430, 1716, 1790, 1807, 2488, 2650, 2655]","[721, 1056]",2885,9,2876,2,7,2876,0
4.0,MMGFAPD,"[108, 713, 1175, 1298, 1901, 2277, 2449, 2760, 2995, 3351, 3473, 3660, 4335, 4868, 5452, 7117, 7192, 7253, 7902, 7907, 8227, 8409, 9093, 9788]","[713, 1901, 2995, 4335, 5452, 7907]","[108, 1175, 1298, 2277, 2449, 2760, 3351, 3473, 3660, 4868, 7117, 7192, 7253, 7902, 8227, 8409, 9093, 9788]","[713, 1624, 1901, 2995, 3906, 4335, 5452, 7907]",9964,24,9940,6,18,9938,2
4.0,MMGGLINE,"[204, 279, 441, 1465, 1487, 1787, 2076, 2250, 2288, 2587, 2634, 3162, 3948, 4417, 4429, 4790, 4813, 4824, 4883, 4949, 5098, 5624, 6352, 6374, 6664, 6955, 7129, 7167, 7466, 7513, 8041, 8852, 9096, 9162, 9179, 9263, 9360, 9567, 9641, 9714, 9849, 10420, 10978, 10982, 11052]","[7167, 7513]","[204, 279, 441, 1465, 1487, 1787, 2076, 2250, 2288, 2587, 2634, 3162, 3948, 4417, 4429, 4790, 4813, 4824, 4883, 4949, 5098, 5624, 6352, 6374, 6664, 6955, 7129, 7466, 8041, 8852, 9096, 9162, 9179, 9263, 9360, 9567, 9641, 9714, 9849, 10420, 10978, 10982, 11052]","[7167, 7513]",11279,45,11234,2,43,11234,0
4.0,MMGK5,"[244, 695, 1690, 1805, 1809, 1890, 2626, 2768, 2825, 2845, 2850, 3525]","[695, 1805, 2825]","[244, 1690, 1809, 1890, 2626, 2768, 2845, 2850, 3525]","[695, 1805, 2595, 2825]",3603,12,3591,3,9,3590,1
4.0,MMH2D4Q5,"[159, 345, 644]","[159, 644]",[345],"[159, 644]",1101,3,1098,2,1,1098,0
4.0,MMHOX13,"[325, 369, 492, 800, 1037, 1147, 1455, 1570, 1647, 1651, 2076, 2407, 2504, 2583, 2658, 2798]",[800],"[325, 369, 492, 1037, 1147, 1455, 1570, 1647, 1651, 2076, 2407, 2504, 2583, 2658, 2798]",[800],2828,16,2812,1,15,2812,0
4.0,MMHOX24I,"[705, 837, 896, 1160, 1264, 1719]",[837],"[705, 896, 1160, 1264, 1719]",[837],1916,6,1910,1,5,1910,0
4.0,MMIL1BG,"[121, 572, 1099, 1356, 1567, 1803, 1938, 3222, 3239, 3680, 4398, 4988, 5080, 5679, 6670]","[1356, 1938, 3680, 4398, 5679]","[121, 572, 1099, 1567, 1803, 3222, 3239, 4988, 5080, 6670]","[1356, 1938, 3680, 4398, 5679]",7093,15,7078,5,10,7078,0
4.0,MMIL3G,"[129, 469, 686, 745, 824, 1326, 1913, 2090, 2583]","[686, 824, 1913, 2090]","[129, 469, 745, 1326, 2583]","[686, 824, 1913, 2090]",3483,9,3474,4,5,3474,0
4.0,MMIL5G,"[731, 980, 1473, 1593, 1625, 1842, 1971, 2262, 2448, 2637, 2641, 2645, 2649, 2653, 2657, 2661, 2708, 2874, 3418, 3597, 4702, 4774, 4806, 5303, 5441, 5742, 6478, 6608]","[731, 1593, 3597]","[980, 1473, 1625, 1842, 1971, 2262, 2448, 2637, 2641, 2645, 2649, 2653, 2657, 2661, 2708, 2874, 3418, 4702, 4774, 4806, 5303, 5441, 5742, 6478, 6608]","[731, 1593, 3597]",6720,28,6692,3,25,6692,0
4.0,MMKFGF,"[542, 693, 976, 1045, 1086, 1254, 1259, 1337, 1556, 1574, 1624, 2079, 2484, 2561, 2886, 3185]","[542, 1045]","[693, 976, 1086, 1254, 1259, 1337, 1556, 1574, 1624, 2079, 2484, 2561, 2886, 3185]","[542, 1045]",3982,16,3966,2,14,3966,0
4.0,MMLDHAG,"[105, 1012, 1180, 1378, 1782, 1906, 2132, 2186, 2429, 2774, 2978, 3295, 4167, 4377, 4577, 4824, 4966, 5138, 5333, 5919, 6038, 6042, 6123, 7171, 7208, 7338, 7668, 7776, 7780, 7959, 7963, 8206, 8280, 8315, 8380, 8402, 8414, 8597, 8833, 8981, 9652, 9999, 10037, 10590, 10704, 10855, 11532, 11655, 11977, 12060, 12148, 12155]","[4577, 5919, 7171, 7668, 8597, 10704]","[105, 1012, 1180, 1378, 1782, 1906, 2132, 2186, 2429, 2774, 2978, 3295, 4167, 4377, 4824, 4966, 5138, 5333, 6038, 6042, 6123, 7208, 7338, 7776, 7780, 7959, 7963, 8206, 8280, 8315, 8380, 8402, 8414, 8833, 8981, 9652, 9999, 10037, 10590, 10855, 11532, 11655, 11977, 12060, 12148, 12155]","[4577, 5919, 7171, 7668, 8597, 10704]",12844,52,12792,6,46,12792,0
4.0,MMMMP9A,"[880, 1476, 1890, 2008, 2375, 2781, 3064, 3418, 3945, 4206, 4321, 4478, 4492, 4851, 4864, 5301, 5695, 5716, 6087, 6282, 6356, 6564, 7752, 7770, 7791, 7954]","[2008, 2375, 2781, 3064, 3418, 3945, 4206, 5695, 6356, 6564]","[880, 1476, 1890, 4321, 4478, 4492, 4851, 4864, 5301, 5716, 6087, 6282, 7752, 7770, 7791, 7954]","[1341, 2008, 2375, 2781, 3064, 3418, 3945, 4206, 5695, 5936, 6356, 6564]",8183,26,8157,10,16,8155,2
4.0,MMMRPS24,"[40, 353, 404, 645, 670, 836, 1106, 1132, 1196, 1460, 2206, 2253, 2406, 2669, 2683, 2987, 3095, 3137, 3192, 3263, 3713, 3934, 4371, 5070, 5091]","[404, 1460, 3137]","[40, 353, 645, 670, 836, 1106, 1132, 1196, 2206, 2253, 2406, 2669, 2683, 2987, 3095, 3192, 3263, 3713, 3934, 4371, 5070, 5091]","[404, 1460, 1761, 3137]",5492,25,5467,3,22,5466,1
4.0,MMMTIX,"[402, 706, 758, 951, 1355]","[402, 951]","[706, 758, 1355]","[402, 951]",1553,5,1548,2,3,1548,0
4.0,MMMUPBS6,"[731, 792, 861, 1203, 1207, 1246, 1298, 1614, 1901, 2045, 2425, 3185, 3236, 3445, 4527]","[731, 1203, 2045, 3236]","[792, 861, 1207, 1246, 1298, 1614, 1901, 2425, 3185, 3445, 4527]","[731, 1203, 2045, 2793, 3236]",4615,15,4600,4,11,4599,1
4.0,MMMYCL,"[580, 806, 919, 1615, 1787, 2042, 2419, 2554, 3292, 3810, 4161, 4617, 4673, 4744, 4970, 5883, 6468, 6484, 6619, 6752, 7436, 7477, 7560, 7565, 8161]",[1787],"[580, 806, 919, 1615, 2042, 2419, 2554, 3292, 3810, 4161, 4617, 4673, 4744, 4970, 5883, 6468, 6484, 6619, 6752, 7436, 7477, 7560, 7565, 8161]",[1787],8309,25,8284,1,24,8284,0
4.0,MMNFMG,"[50, 97, 120, 421, 638, 1553, 1634, 2336, 2540, 2878, 3175, 3339, 3793, 4040, 4409, 4448, 4619, 4777, 4798, 4804, 4855, 4886, 5044]","[1634, 2540]","[50, 97, 120, 421, 638, 1553, 2336, 2878, 3175, 3339, 3793, 4040, 4409, 4448, 4619, 4777, 4798, 4804, 4855, 4886, 5044]","[1634, 2540]",5464,23,5441,2,21,5441,0
4.0,MMNMYC,"[749, 869, 1163, 1210, 1355, 1609, 1732, 3549, 3661, 4261]",[1163],"[749, 869, 1210, 1355, 1609, 1732, 3549, 3661, 4261]",[1163],4800,10,4790,1,9,4790,0
4.0,MMNUCLEO,"[184, 665, 669, 784, 863, 1033, 1160, 1932, 2042, 2680, 2859, 3040, 3141, 3984, 4071, 4293, 4464, 4694, 4729, 4879, 5198, 5351, 5605, 5879, 6230, 6234, 6399, 6530, 6879, 7203, 7215, 8122, 8304, 8534, 8614, 8928, 9050, 9881, 10179, 10436, 10506, 11016]","[2042, 3141, 4293, 4694, 4879, 5198, 6230, 8122, 9050, 9881, 10436]","[184, 665, 669, 784, 863, 1033, 1160, 1932, 2680, 2859, 3040, 3984, 4071, 4464, 4729, 5351, 5605, 5879, 6234, 6399, 6530, 6879, 7203, 7215, 8304, 8534, 8614, 8928, 10179, 10506, 11016]","[2042, 3141, 4293, 4694, 4879, 5198, 6230, 7517, 8122, 8738, 9050, 9881, 10436]",11471,42,11429,11,31,11427,2
4.0,MMODC2,"[124, 331, 737, 1053, 1239, 1374, 1557, 1801, 2073, 2508, 2523, 2702, 2999, 3130, 3433, 4219]","[331, 737, 1053, 1374, 1557, 1801, 2508, 2702, 2999]","[124, 1239, 2073, 2523, 3130, 3433, 4219]","[331, 737, 1053, 1374, 1557, 1801, 2508, 2702, 2999]",4253,16,4237,9,7,4237,0
4.0,MMOESTEOP,"[510, 993, 1091, 1127, 1662, 1666, 2605, 2609, 2742, 2821, 4039, 4101, 4452, 4834, 5104, 5290, 5308, 5456, 5607]","[993, 1127, 2821, 4101]","[510, 1091, 1662, 1666, 2605, 2609, 2742, 4039, 4452, 4834, 5104, 5290, 5308, 5456, 5607]","[993, 1127, 2283, 2821, 4101]",5775,19,5756,4,15,5755,1
4.0,MMPO,"[324, 475, 561, 825, 857, 1637, 1709, 1950, 2193, 2446, 2553, 2860, 2948, 3054, 3336, 3728, 3749, 4385, 4769, 4831, 4835, 5312, 5641, 5673, 6250, 6384, 6509, 6525, 6555, 6624, 6664, 6805, 6833, 6901, 6982, 7167, 7842, 8043, 8109, 8440, 8907, 9464, 9716, 9809, 9903, 9938, 10001, 10055, 10756, 10894, 10983, 11076, 11636]","[2193, 2446, 2948, 3728, 4769, 7167, 8440, 8907, 9903]","[324, 475, 561, 825, 857, 1637, 1709, 1950, 2553, 2860, 3054, 3336, 3749, 4385, 4831, 4835, 5312, 5641, 5673, 6250, 6384, 6509, 6525, 6555, 6624, 6664, 6805, 6833, 6901, 6982, 7842, 8043, 8109, 9464, 9716, 9809, 9938, 10001, 10055, 10756, 10894, 10983, 11076, 11636]","[2193, 2446, 2948, 3503, 3728, 4018, 4769, 7167, 8440, 8907, 9903]",11906,53,11853,9,44,11851,2
4.0,MMPPSOMA,"[251, 411, 447, 562, 706, 722, 1034, 1208, 1248, 2049, 2491]",[1034],"[251, 411, 447, 562, 706, 722, 1208, 1248, 2049, 2491]",[1034],2557,11,2546,1,10,2546,0
4.0,MMPROP2,[631],[],[631],[289],713,1,712,0,1,711,1
4.0,MMPROT1,"[312, 478, 759, 937]",[759],"[312, 478, 937]",[759],1179,4,1175,1,3,1175,0
4.0,MMPROT2,"[361, 508, 615, 880, 915, 987, 1218, 1469]",[1218],"[361, 508, 615, 880, 915, 987, 1469]",[1218],1569,8,1561,1,7,1561,0
4.0,MMSAP,"[441, 794, 1550, 1558]",[441],"[794, 1550, 1558]",[441],1869,4,1865,1,3,1865,0
4.0,MMSCIMIP,"[415, 578, 600, 1017, 1054]","[415, 1017]","[578, 600, 1054]","[415, 1017]",1981,5,1976,2,3,1976,0
4.0,MMSYNDE1A,"[190, 526, 762, 816, 1054, 1345, 1483, 1992, 2151, 2623, 3132, 3570, 4124, 4826, 4867, 5018, 5043, 5616, 5772, 5923, 6256, 6622, 6741, 7683, 7733, 7805, 7828, 7931, 8043, 8442, 8765, 9076, 9182, 9320, 9666, 9867, 10045, 10122, 10340, 10903, 11397, 11495, 11583, 11858, 11900, 12132, 12515, 12803, 13095, 13426, 13599, 13723, 13851, 14080, 14113, 14182, 14254, 14623, 14634, 14690, 14843, 14948, 15172, 15203, 15299, 15499, 15641, 15704, 15845, 15955, 16427, 16639, 16744, 16770, 17281, 17647, 17663, 17701, 17717, 18837, 19009, 19057, 19286, 19349, 19424, 19440, 19542, 19546, 19726, 19767, 20385, 20460, 20515, 20604, 20735, 20942, 21888, 22081, 22120, 22488, 22707, 22802, 23203]","[1345, 19009, 20385, 20942]","[190, 526, 762, 816, 1054, 1483, 1992, 2151, 2623, 3132, 3570, 4124, 4826, 4867, 5018, 5043, 5616, 5772, 5923, 6256, 6622, 6741, 7683, 7733, 7805, 7828, 7931, 8043, 8442, 8765, 9076, 9182, 9320, 9666, 9867, 10045, 10122, 10340, 10903, 11397, 11495, 11583, 11858, 11900, 12132, 12515, 12803, 13095, 13426, 13599, 13723, 13851, 14080, 14113, 14182, 14254, 14623, 14634, 14690, 14843, 14948, 15172, 15203, 15299, 15499, 15641, 15704, 15845, 15955, 16427, 16639, 16744, 16770, 17281, 17647, 17663, 17701, 17717, 18837, 19057, 19286, 19349, 19424, 19440, 19542, 19546, 19726, 19767, 20460, 20515, 20604, 20735, 21888, 22081, 22120, 22488, 22707, 22802, 23203]","[1345, 19009, 20385, 20942]",23593,103,23490,4,99,23490,0
4.0,MMTHY1G,"[80, 183, 616, 696, 1009, 1156, 1833, 2181]","[80, 1009]","[183, 616, 696, 1156, 1833, 2181]","[80, 1009]",2683,8,2675,2,6,2675,0
4.0,MMTLAC,"[140, 299, 494, 748, 912, 925, 1171, 1335, 2858, 3092, 3338, 3509, 3836, 4297, 4373, 4783, 5339]","[299, 748, 1171, 3092, 3338]","[140, 494, 912, 925, 1335, 2858, 3509, 3836, 4297, 4373, 4783, 5339]","[299, 748, 1171, 3092, 3338]",5250,17,5233,5,12,5233,0
4.0,MMTNFBG,"[315, 524, 734, 813, 1196, 1553, 1728, 2456]",[1728],"[315, 524, 734, 813, 1196, 1553, 2456]","[1728, 1911]",3212,8,3204,1,7,3203,1
4.0,MMTROPIB,"[183, 261, 656, 1261, 1568, 1744, 1749, 1832, 1932, 1939, 2033, 2038, 2185, 2274, 2522, 2656, 3037, 3564, 3690, 4493, 4580, 4604, 4620, 4748, 4950, 5379, 5561]","[1932, 2185, 2656, 3037, 3564, 4604]","[183, 261, 656, 1261, 1568, 1744, 1749, 1832, 1939, 2033, 2038, 2274, 2522, 3690, 4493, 4580, 4620, 4748, 4950, 5379, 5561]","[1697, 1932, 2185, 2656, 3037, 3564, 4604]",5684,27,5657,6,21,5656,1
4.0,MMTUM198,"[120, 347, 709, 1084, 1729, 1750, 1849, 1990, 1994, 2808, 2818, 2899, 3098, 3313, 3587, 3818, 4180, 4220]","[2818, 3098, 3313, 3587, 3818, 4180]","[120, 347, 709, 1084, 1729, 1750, 1849, 1990, 1994, 2808, 2899, 4220]","[1692, 2818, 3098, 3313, 3587, 3818, 4180]",4377,18,4359,6,12,4358,1
4.0,MMU01530,"[358, 636, 891, 924, 1080, 1164, 1180, 1357, 1589, 2027, 2269, 2298, 3231, 3729, 3803, 3939, 4167, 4412, 4904, 5405, 5885, 6039, 6229, 6394, 6423, 6546]",[3231],"[358, 636, 891, 924, 1080, 1164, 1180, 1357, 1589, 2027, 2269, 2298, 3729, 3803, 3939, 4167, 4412, 4904, 5405, 5885, 6039, 6229, 6394, 6423, 6546]","[3094, 3231]",6700,26,6674,1,25,6673,1
4.0,MMU02278,"[75, 342, 1041, 1638, 1858, 2312, 2344, 3368, 3669, 3873]",[1638],"[75, 342, 1041, 1858, 2312, 2344, 3368, 3669, 3873]",[1638],3974,10,3964,1,9,3964,0
4.0,MMU02298,"[475, 603, 1180, 1508, 2102, 2413, 2874, 3047, 3116, 3120, 3911, 3920, 4270, 4749, 4794, 4897]","[1180, 2413]","[475, 603, 1508, 2102, 2874, 3047, 3116, 3120, 3911, 3920, 4270, 4749, 4794, 4897]","[1180, 2413]",5852,16,5836,2,14,5836,0
4.0,MMU02884,"[220, 512, 668, 814, 1576, 1630, 1761, 1934, 2107, 2382, 2484, 3386, 3669, 4798, 5217, 5244, 5291, 5517, 5806, 6022, 6026, 6642, 6836, 7309, 7527, 7562, 7567, 7973, 8171, 8612]","[1630, 5244, 6836]","[220, 512, 668, 814, 1576, 1761, 1934, 2107, 2382, 2484, 3386, 3669, 4798, 5217, 5291, 5517, 5806, 6022, 6026, 6642, 7309, 7527, 7562, 7567, 7973, 8171, 8612]","[1630, 5244, 6836]",8758,30,8728,3,27,8728,0
4.0,MMU04056,"[186, 321, 901, 1227, 1331, 1382, 1450, 1461, 1465, 1472, 1502, 1857, 1865, 2135, 2183, 2377, 2490, 2509, 2667, 2711, 2747, 2902, 2906, 2960, 3291, 3530, 4688, 5218, 6264, 6477, 7544, 7683, 7979, 8501, 8633, 8664, 8680, 8732, 8895, 9807, 10317, 10794, 10876, 10998, 11259, 11441, 11797, 12088, 12211, 12804, 13211, 13933, 14104, 14478, 14615, 14896, 15214, 15270, 15417, 15506, 15545, 15620, 15870, 15971, 16157, 16230, 16348, 16561, 16710, 16734, 16994, 17245, 17992, 18100, 19860, 20025, 20066, 20243, 20314, 20602, 20804, 21185, 21351, 21514, 21625, 21633]","[1382, 3530, 4688, 7979, 8895, 10317, 10876, 11259, 12211, 16230, 16561]","[186, 321, 901, 1227, 1331, 1450, 1461, 1465, 1472, 1502, 1857, 1865, 2135, 2183, 2377, 2490, 2509, 2667, 2711, 2747, 2902, 2906, 2960, 3291, 5218, 6264, 6477, 7544, 7683, 8501, 8633, 8664, 8680, 8732, 9807, 10794, 10998, 11441, 11797, 12088, 12804, 13211, 13933, 14104, 14478, 14615, 14896, 15214, 15270, 15417, 15506, 15545, 15620, 15870, 15971, 16157, 16348, 16710, 16734, 16994, 17245, 17992, 18100, 19860, 20025, 20066, 20243, 20314, 20602, 20804, 21185, 21351, 21514, 21625, 21633]","[1382, 3530, 4688, 7979, 8895, 10317, 10876, 11259, 12211, 13491, 16230, 16561]",21711,86,21625,11,75,21624,1
4.0,MMU04827,"[105, 1299, 1649, 2280, 2512, 2767, 2828, 3551, 3555, 3684, 3688, 4276, 4281, 4301, 4969, 5286, 5444, 5675, 6692, 7133, 7252, 7369, 7592]","[3684, 4281, 4969]","[105, 1299, 1649, 2280, 2512, 2767, 2828, 3551, 3555, 3688, 4276, 4301, 5286, 5444, 5675, 6692, 7133, 7252, 7369, 7592]","[3684, 4281, 4969]",7601,23,7578,3,20,7578,0
4.0,MMU07568,"[84, 267, 482, 527]","[84, 267, 482]",[527],"[84, 267, 482]",744,4,740,3,1,740,0
4.0,MMU07808,"[61, 183, 404, 542, 547, 673, 677, 987, 1019, 1179, 1208, 1697, 1762, 1918, 2384]","[673, 1697]","[61, 183, 404, 542, 547, 677, 987, 1019, 1179, 1208, 1762, 1918, 2384]","[673, 1697]",2841,15,2826,2,13,2826,0
4.0,MMU09741,"[245, 1076, 1094, 1230, 1655, 2034]","[245, 1230]","[1076, 1094, 1655, 2034]","[245, 1230]",2845,6,2839,2,4,2839,0
4.0,MMU09964,"[26, 30, 157, 375, 433, 510, 803, 857, 1295, 1299, 1968, 2317, 2375, 2490, 2680, 2697, 3136, 3428, 3448, 3779, 3796, 3933, 4126, 4303, 4607, 4657, 5091, 5211, 5697, 5708, 5726, 5730, 5747, 5754, 5793, 5816, 5820, 5824, 5828, 5832, 5836, 5840, 5844, 5977, 6240, 6524, 6741, 6890, 7044, 7434, 7525, 7760, 7962, 8162, 8460, 8601, 9017, 9311, 9952, 9980, 10001, 10372, 10378, 10429, 11246]","[1968, 3428, 4303, 4607, 7962, 8162, 8601, 9017, 9311]","[26, 30, 157, 375, 433, 510, 803, 857, 1295, 1299, 2317, 2375, 2490, 2680, 2697, 3136, 3448, 3779, 3796, 3933, 4126, 4657, 5091, 5211, 5697, 5708, 5726, 5730, 5747, 5754, 5793, 5816, 5820, 5824, 5828, 5832, 5836, 5840, 5844, 5977, 6240, 6524, 6741, 6890, 7044, 7434, 7525, 7760, 8460, 9952, 9980, 10001, 10372, 10378, 10429, 11246]","[1968, 3428, 4303, 4607, 7962, 8162, 8601, 9017, 9311, 10875]",11455,65,11390,9,56,11389,1
4.0,MMU10098,"[593, 1098, 1155, 1165, 1173, 1425, 1436, 1624, 2957, 3270, 3312, 3509, 3513, 3596, 5292, 5593, 5609, 5695, 5812]","[1173, 3509]","[593, 1098, 1155, 1165, 1425, 1436, 1624, 2957, 3270, 3312, 3513, 3596, 5292, 5593, 5609, 5695, 5812]","[1173, 3509]",6118,19,6099,2,17,6099,0
4.0,MMU11054,"[185, 204, 1833, 1996, 2250, 2515]",[1996],"[185, 204, 1833, 2250, 2515]","[457, 1418, 1996]",2565,6,2559,1,5,2557,2
4.0,MMU11713,"[250, 288, 587, 634, 1341]","[288, 634]","[250, 587, 1341]","[288, 634]",1760,5,1755,2,3,1755,0
4.0,MMU12029,"[17, 51, 297, 342, 381, 582, 879, 1264, 1309, 1385, 1410, 1897, 2030, 2082]","[582, 1264]","[17, 51, 297, 342, 381, 879, 1309, 1385, 1410, 1897, 2030, 2082]","[582, 1264]",2256,14,2242,2,12,2242,0
4.0,MMU12273,"[38, 358, 384, 389, 680, 769, 915, 1085, 1434, 1740, 1940]","[680, 1085, 1740]","[38, 358, 384, 389, 769, 915, 1434, 1940]","[680, 1085, 1740]",2576,11,2565,3,8,2565,0
4.0,MMU12559,"[62, 247, 822]",[247],"[62, 822]",[247],919,3,916,1,2,916,0
4.0,MMU12560,"[62, 247, 257]",[247],"[62, 257]",[247],921,3,918,1,2,918,0
4.0,MMU12561,"[62, 247, 420, 820]",[247],"[62, 420, 820]",[247],917,4,913,1,3,913,0
4.0,MMU12562,"[62, 247]",[247],[62],[247],919,2,917,1,1,917,0
4.0,MMU12565,"[62, 247, 396, 630]",[247],"[62, 396, 630]",[247],1044,4,1040,1,3,1040,0
4.0,MMU13921,"[10, 162, 289, 820, 856, 952, 1607, 1862, 1867, 2003, 2197, 2354, 3036, 3132, 3241, 3401, 3525, 3990, 4034]","[952, 2003, 2354, 3241, 3990]","[10, 162, 289, 820, 856, 1607, 1862, 1867, 2197, 3036, 3132, 3401, 3525, 4034]","[952, 2003, 2354, 2693, 2930, 3241, 3990]",4671,19,4652,5,14,4650,2
4.0,MMU14421,"[1089, 1322, 1867, 1887, 1952, 2041, 2454, 3681, 3799, 3848, 3867, 3920, 4195, 4470, 4506, 4528, 4560, 4941, 5034, 5599, 5864, 6026]",[],"[1089, 1322, 1867, 1887, 1952, 2041, 2454, 3681, 3799, 3848, 3867, 3920, 4195, 4470, 4506, 4528, 4560, 4941, 5034, 5599, 5864, 6026]","[3668, 4237, 4502, 4814]",6255,22,6233,0,22,6229,4
4.0,MMVITRO,"[8, 689, 725, 1025, 1425, 1861, 2054, 2071, 2474, 2585, 2693, 2718, 2783, 2826, 3279, 3703, 3733, 3755, 3812, 3816, 3820, 3855, 3859, 3863, 4355, 4941, 4985, 4996]","[2054, 2474, 2693, 3279, 4355]","[8, 689, 725, 1025, 1425, 1861, 2071, 2585, 2718, 2783, 2826, 3703, 3733, 3755, 3812, 3816, 3820, 3855, 3859, 3863, 4941, 4985, 4996]","[1845, 2054, 2474, 2693, 3017, 3279, 4355]",4997,28,4969,5,23,4967,2
4.0,MMVPREB2,"[172, 214, 379, 908, 930]",[379],"[172, 214, 908, 930]",[379],1046,5,1041,1,4,1041,0
4.0,MMVPREB3,"[172, 214, 379, 908]",[379],"[172, 214, 908]",[379],1046,4,1042,1,3,1042,0
4.0,MNKEGLOBIM,"[221, 237, 536, 583, 1184, 1196]","[237, 583]","[221, 536, 1184, 1196]","[237, 583]",1694,6,1688,2,4,1688,0
4.0,MNKEGLOBIN,"[221, 237, 536, 583, 1182, 1194]","[237, 583]","[221, 536, 1182, 1194]","[237, 583]",1692,6,1686,2,4,1686,0
4.0,MNKHGBGGAG,"[75, 92, 249, 287, 586, 633, 1064, 1127, 1338]","[287, 633]","[75, 92, 249, 586, 1064, 1127, 1338]","[287, 633]",1698,9,1689,2,7,1689,0
4.0,MNPROP2,[620],[],[620],[278],697,1,696,0,1,695,1
4.0,MUS8HS20,"[257, 271, 280, 940, 962, 1015, 1360, 1388, 1625, 2133, 2530, 2562]",[940],"[257, 271, 280, 962, 1015, 1360, 1388, 1625, 2133, 2530, 2562]",[940],2623,12,2611,1,11,2611,0
4.0,MUSAP,"[34, 110, 499, 810, 814, 931, 1012, 1815, 2551, 2656, 2686, 3186, 3190, 3574, 3815, 4160, 4509, 4740, 4927, 4971, 5211, 5230, 5290, 5369, 5529, 5547, 5619, 5952, 6013, 6067, 6406, 6494, 6554, 6709, 6929, 7201, 7890, 8019]","[3574, 3815, 4509, 4740, 4971, 5290, 5619, 5952, 6406, 6709]","[34, 110, 499, 810, 814, 931, 1012, 1815, 2551, 2656, 2686, 3186, 3190, 4160, 4927, 5211, 5230, 5369, 5529, 5547, 6013, 6067, 6494, 6554, 6929, 7201, 7890, 8019]","[3574, 3815, 4034, 4509, 4740, 4971, 5290, 5619, 5952, 6406, 6709]",8087,38,8049,10,28,8048,1
4.0,MUSAP5A,"[259, 354, 551, 651, 697, 786, 853, 1768, 2064, 2222, 2428, 2454, 2463, 2681, 2759, 3332, 3355, 3744, 3752, 4614, 4657, 4709, 5253, 5266, 5825, 6195, 6254, 6668, 6685, 6816]","[2428, 2759, 4614]","[259, 354, 551, 651, 697, 786, 853, 1768, 2064, 2222, 2454, 2463, 2681, 3332, 3355, 3744, 3752, 4657, 4709, 5253, 5266, 5825, 6195, 6254, 6668, 6685, 6816]","[2428, 2759, 4614]",6822,30,6792,3,27,6792,0
4.0,MUSAPEX,"[300, 372, 768, 1042, 1363, 1389, 1394, 1684, 1773, 1919, 2089, 2436, 2742, 2942]","[1684, 2089, 2742]","[300, 372, 768, 1042, 1363, 1389, 1394, 1773, 1919, 2436, 2942]","[1684, 2089, 2742]",4035,14,4021,3,11,4021,0
4.0,MUSAPOAII,"[112, 474, 559, 723, 940, 1155, 1543, 1618, 2621]","[723, 1155]","[112, 474, 559, 940, 1543, 1618, 2621]","[723, 1155]",2953,9,2944,2,7,2944,0
4.0,MUSAPOIVA,"[63, 470, 529, 588, 975, 1029, 1226, 1256, 1385, 2149, 2299, 2774, 2898, 2914, 2929]","[588, 975]","[63, 470, 529, 1029, 1226, 1256, 1385, 2149, 2299, 2774, 2898, 2914, 2929]","[588, 975]",3013,15,2998,2,13,2998,0
4.0,MUSBMP4,"[336, 441, 510, 664, 768, 1064, 1068, 2095, 2149, 2413, 2473, 2683, 2820, 2888, 2960, 3212, 3697, 3967, 4135, 4198, 4471, 4495, 4806, 5497, 5725, 5890, 6380, 7157, 7179, 7951, 8267, 8446, 8462, 8525, 9626]",[7179],"[336, 441, 510, 664, 768, 1064, 1068, 2095, 2149, 2413, 2473, 2683, 2820, 2888, 2960, 3212, 3697, 3967, 4135, 4198, 4471, 4495, 4806, 5497, 5725, 5890, 6380, 7157, 7951, 8267, 8446, 8462, 8525, 9626]",[7179],9668,35,9633,1,34,9633,0
4.0,MUSBNP,"[336, 412, 488, 680, 753, 903, 1057, 1449]","[336, 753]","[412, 488, 680, 903, 1057, 1449]","[336, 753]",1461,8,1453,2,6,1453,0
4.0,MUSCD14A,"[176, 543, 639, 777, 1122, 1454, 1852]",[176],"[543, 639, 777, 1122, 1454, 1852]",[176],1866,7,1859,1,6,1859,0
4.0,MUSCRKNB,"[96, 460, 1440, 1904, 1989, 2058, 2245, 2455, 2658, 2796, 2829, 2879, 3505, 3842, 3862, 3949]","[1904, 2245, 2455, 2796, 3505, 3842]","[96, 460, 1440, 1989, 2058, 2658, 2829, 2879, 3862, 3949]","[1904, 2245, 2455, 2796, 3505, 3842]",4514,16,4498,6,10,4498,0
4.0,MUSCYTCOVB,"[48, 724, 928, 1064, 1081, 1319, 1585, 1679, 1808, 1925, 1946, 2066, 2168, 2234]","[724, 1319, 1585]","[48, 928, 1064, 1081, 1679, 1808, 1925, 1946, 2066, 2168, 2234]","[724, 1319, 1585]",2533,14,2519,3,11,2519,0
4.0,MUSENDOBA,"[135, 807, 1066, 1500, 1507, 2117, 2130, 2614, 2743, 3027, 3115, 3350, 3618, 3892, 4049, 4342, 4371, 4430, 4853, 4898, 5090, 5527, 5589, 5616, 5696, 5700, 5721, 5817, 5969, 6258, 6358, 6506, 6929, 6980, 7007, 7151, 7585]","[2743, 3618, 4049, 4853, 5090, 5589]","[135, 807, 1066, 1500, 1507, 2117, 2130, 2614, 3027, 3115, 3350, 3892, 4342, 4371, 4430, 4898, 5527, 5616, 5696, 5700, 5721, 5817, 5969, 6258, 6358, 6506, 6929, 6980, 7007, 7151, 7585]","[2743, 3618, 4049, 4853, 5090, 5589]",7872,37,7835,6,31,7835,0
4.0,MUSFAUA,"[544, 760, 783, 846, 925, 1216, 1249, 1253, 1496, 1645, 2068, 2103, 2124, 2650]","[1249, 1496, 2124]","[544, 760, 783, 846, 925, 1216, 1253, 1645, 2068, 2103, 2650]","[1249, 1496, 2124]",2843,14,2829,3,11,2829,0
4.0,MUSFERHC,"[483, 526, 1103, 1107, 1827, 2185, 2319, 2428]","[483, 1827, 2185]","[526, 1103, 1107, 2319, 2428]","[483, 1827, 2185]",2783,8,2775,3,5,2775,0
4.0,MUSFKBP13X,"[321, 736, 764, 904, 928, 1070, 1247, 1282, 1556]","[321, 736, 904, 1282]","[764, 928, 1070, 1247, 1556]","[321, 736, 904, 1282]",1574,9,1565,4,5,1565,0
4.0,MUSGAD45,"[559, 935, 1034, 1126, 1458, 1542, 1595, 1898, 2472, 2647, 3023]","[935, 1126, 1458]","[559, 1034, 1542, 1595, 1898, 2472, 2647, 3023]","[935, 1126, 1458]",3093,11,3082,3,8,3082,0
4.0,MUSGFJE,"[624, 709, 1098, 1194, 1489]","[624, 1489]","[709, 1098, 1194]","[624, 1489]",2404,5,2399,2,3,2399,0
4.0,MUSGPOAD,"[430, 890, 1044, 1048, 1169, 1324, 1328, 1737, 2306, 2538, 2898, 3337, 4023, 4403, 4816, 4916, 4996, 5083, 5250, 5342, 5400, 5719, 5859, 6573, 7850, 7929]","[1044, 2306, 4403, 4916]","[430, 890, 1048, 1169, 1324, 1328, 1737, 2538, 2898, 3337, 4023, 4816, 4996, 5083, 5250, 5342, 5400, 5719, 5859, 6573, 7850, 7929]","[1044, 2306, 4403, 4916]",8069,26,8043,4,22,8043,0
4.0,MUSHBBH0,"[163, 365, 914, 1012, 1112, 1265, 1566, 2081]","[365, 914]","[163, 1012, 1112, 1265, 1566, 2081]","[365, 914]",2128,8,2120,2,6,2120,0
4.0,MUSHBBH1,"[249, 451, 733, 780, 975, 1417, 1493]","[451, 780]","[249, 733, 975, 1417, 1493]","[451, 780]",1919,7,1912,2,5,1912,0
4.0,MUSHES1,"[355, 556, 784, 788, 1108, 1121, 1351, 1367, 1400, 1488, 1797, 1839, 2208]","[556, 784, 1108]","[355, 788, 1121, 1351, 1367, 1400, 1488, 1797, 1839, 2208]","[556, 784, 1108]",2818,13,2805,3,10,2805,0
4.0,MUSHOX35A,"[232, 612, 1535, 1715, 2007, 2012, 2577, 2661, 3150, 3519, 3545]",[],"[232, 612, 1535, 1715, 2007, 2012, 2577, 2661, 3150, 3519, 3545]",[1308],3848,11,3837,0,11,3836,1
4.0,MUSIL1RN,"[168, 512, 652, 656, 660, 709, 713, 886, 1676, 1922, 2186, 2224, 2289, 2328, 2483, 2552, 2789, 3116, 3549, 3883, 3938, 4482, 5269, 6210]","[512, 2483, 3549]","[168, 652, 656, 660, 709, 713, 886, 1676, 1922, 2186, 2224, 2289, 2328, 2552, 2789, 3116, 3883, 3938, 4482, 5269, 6210]","[512, 2483, 3549]",6343,24,6319,3,21,6319,0
4.0,MUSKE3A,"[21, 340, 544, 657, 788, 840, 981, 1088, 1328, 1562, 1569, 1604, 1620, 1881, 1948, 2052, 2194, 3218, 3339, 3400, 3405]","[21, 544, 3218, 3400]","[340, 657, 788, 840, 981, 1088, 1328, 1562, 1569, 1604, 1620, 1881, 1948, 2052, 2194, 3339, 3405]","[21, 544, 3218, 3400]",3613,21,3592,4,17,3592,0
4.0,MUSLMP7A,"[287, 429, 487, 535, 1318, 1354, 1364, 1407, 2153, 2293, 2454, 3029, 3046, 3178, 3674]","[1318, 2153, 2454, 3029, 3674]","[287, 429, 487, 535, 1354, 1364, 1407, 2293, 3046, 3178]","[1318, 2153, 2454, 3029, 3674]",4260,15,4245,5,10,4245,0
4.0,MUSLTA,"[530, 830, 1207, 1632, 1807, 2537]",[1807],"[530, 830, 1207, 1632, 2537]","[1807, 1990]",3287,6,3281,1,5,3280,1
4.0,MUSMC26,"[155, 816, 843, 1581, 1906, 2071, 2419, 2475, 3046, 3075, 3190, 3415, 3666, 3682, 3716, 3964, 3982, 4144, 4182]","[2419, 3190, 4144]","[155, 816, 843, 1581, 1906, 2071, 2475, 3046, 3075, 3415, 3666, 3682, 3716, 3964, 3982, 4182]","[2419, 3190, 4144]",5387,19,5368,3,16,5368,0
4.0,MUSOGC,"[113, 290, 489, 522]","[113, 290, 489]",[522],"[113, 290, 489]",942,4,938,3,1,938,0
4.0,MUSOGCA,"[214, 285, 356, 866, 1043, 1242, 1275, 1495]","[866, 1043, 1242]","[214, 285, 356, 1275, 1495]","[866, 1043, 1242]",1695,8,1687,3,5,1687,0
4.0,MUSOGCB,"[113, 290, 490]","[113, 290, 490]",[],"[113, 290, 490]",943,3,940,3,0,940,0
4.0,MUSPNMT,"[955, 1076, 1665, 1881, 2135, 2343, 2450, 2599, 2755]","[1665, 2343]","[955, 1076, 1881, 2135, 2450, 2599, 2755]","[1665, 2343]",3137,9,3128,2,7,3128,0
4.0,MUSPROTA,"[421, 585, 1945, 2033, 2530, 2585, 2604, 3119, 3224, 3555, 3663, 4024, 4600]","[1945, 2585, 3224, 3663]","[421, 585, 2033, 2530, 2604, 3119, 3555, 4024, 4600]","[1945, 2585, 3224, 3663]",4637,13,4624,4,9,4624,0
4.0,MUSPROTEB,"[337, 496, 594, 647, 765, 803, 993, 1024, 1482, 1920, 1988, 2130]","[337, 594, 993, 1988]","[496, 647, 765, 803, 1024, 1482, 1920, 2130]","[337, 594, 993, 1988]",2390,12,2378,4,8,2378,0
4.0,MUSPRPC2,"[165, 215, 652, 801, 817, 2455, 2470, 2740, 3019, 3141, 3531, 3640, 3778, 3833, 4083, 4087, 4186, 5493, 6607, 6793, 6797]",[801],"[165, 215, 652, 817, 2455, 2470, 2740, 3019, 3141, 3531, 3640, 3778, 3833, 4083, 4087, 4186, 5493, 6607, 6793, 6797]",[801],7299,21,7278,1,20,7278,0
4.0,MUSPRPMPB,"[216, 651, 801, 817, 1480, 1839, 2974]",[801],"[216, 651, 817, 1480, 1839, 2974]",[801],3567,7,3560,1,6,3560,0
4.0,MUSREGI,"[632, 775, 1159, 1258, 1316, 1799, 1965, 2230, 2388, 2450, 2993]","[1159, 1799, 2230, 2993]","[632, 775, 1258, 1316, 1965, 2388, 2450]","[1159, 1799, 2230, 2993]",3749,11,3738,4,7,3738,0
4.0,MUSREGII,"[530, 927, 1626, 1988, 2023, 2526, 2543, 2927, 3091, 3233, 3308, 3463]","[927, 1626, 1988, 3091]","[530, 2023, 2526, 2543, 2927, 3233, 3308, 3463]","[927, 1626, 1988, 3091]",3925,12,3913,4,8,3913,0
4.0,MUSROM1X,"[115, 219, 983, 1030, 1146, 1242, 1848, 2169, 2529, 2555, 2616, 2640]","[1242, 1848]","[115, 219, 983, 1030, 1146, 2169, 2529, 2555, 2616, 2640]","[1242, 1848]",2780,12,2768,2,10,2768,0
4.0,MUSRPL30,"[84, 500, 504, 660, 960, 1050, 1331, 1430, 1505, 1679, 2291, 2459, 2654, 3085, 3124, 3243, 3441]","[660, 1050, 2459]","[84, 500, 504, 960, 1331, 1430, 1505, 1679, 2291, 2654, 3085, 3124, 3243, 3441]","[660, 1050, 2459]",3469,17,3452,3,14,3452,0
4.0,MUSRPS16,"[17, 475, 636, 758, 1030, 1210, 1311, 1491, 1868, 2005, 2355]","[1868, 2005]","[17, 475, 636, 758, 1030, 1210, 1311, 1491, 2355]","[450, 687, 1868, 2005]",2642,11,2631,2,9,2629,2
4.0,MUSS100B,"[213, 342, 1097, 1710, 1721, 1778, 2162, 3151, 3660, 4672, 4920, 5082, 5219, 5329, 5786, 6291, 6295, 6880, 7045, 8033, 8061, 8146, 8612, 8671, 8736]",[4920],"[213, 342, 1097, 1710, 1721, 1778, 2162, 3151, 3660, 4672, 5082, 5219, 5329, 5786, 6291, 6295, 6880, 7045, 8033, 8061, 8146, 8612, 8671, 8736]",[4920],8866,25,8841,1,24,8841,0
4.0,MUSSERPROA,"[217, 1034, 1449, 1831, 2037, 2092, 2114, 2341, 2739, 3178, 3345, 3371, 3997]","[1449, 2092, 2739, 3178]","[217, 1034, 1831, 2037, 2114, 2341, 3345, 3371, 3997]","[1449, 2092, 2739, 3178]",4450,13,4437,4,9,4437,0
4.0,MUSSSATGN,"[29, 613, 840, 844, 1162, 1346, 1774, 1825, 2102, 2165, 2190, 2516, 2905, 2929, 3039, 3233, 3436, 3612, 3706, 3892]","[840, 1162, 1346, 2905, 3039]","[29, 613, 844, 1774, 1825, 2102, 2165, 2190, 2516, 2929, 3233, 3436, 3612, 3706, 3892]","[840, 1162, 1346, 2905, 3039]",4059,20,4039,5,15,4039,0
4.0,MUSTCP,"[453, 470, 908, 1005, 1329, 1705, 1993, 2146, 2164, 2427, 2463, 2496, 2781, 3172, 3270, 3576, 3642, 4019, 4278, 4687, 6098, 6552, 6567, 7230, 7274, 7512, 7562]","[453, 1705, 1993, 3270, 4278, 4687, 6098, 6552, 7230, 7512]","[470, 908, 1005, 1329, 2146, 2164, 2427, 2463, 2496, 2781, 3172, 3576, 3642, 4019, 6567, 7274, 7562]","[453, 1705, 1993, 3270, 3746, 4278, 4687, 6098, 6552, 7230, 7512]",9254,27,9227,10,17,9226,1
4.0,MUSTHY1,"[80, 183, 616, 696, 1009, 1156, 1833, 2181]","[80, 1009]","[183, 616, 696, 1156, 1833, 2181]","[80, 1009]",2683,8,2675,2,6,2675,0
4.0,MUSTLAG,"[153, 261, 269, 547, 705, 901, 1155, 1314, 1327, 1573, 1733, 1790, 2128, 3260, 3494, 3740, 4237, 4788, 5201]","[705, 1155, 1573, 3494, 3740]","[153, 261, 269, 547, 901, 1314, 1327, 1733, 1790, 2128, 3260, 4237, 4788, 5201]","[705, 1155, 1573, 3494, 3740]",5413,19,5394,5,14,5394,0
4.0,MUSTSHBA2,"[69, 388, 464, 830, 1045, 1255]",[464],"[69, 388, 830, 1045, 1255]",[464],1284,6,1278,1,5,1278,0
4.0,MUSY1GLOB,"[334, 354, 377, 690, 829, 1066, 1224, 1249]","[377, 690]","[334, 354, 829, 1066, 1224, 1249]","[377, 690]",1746,8,1738,2,6,1738,0
4.0,OABBGLOB,"[33, 192, 525, 692, 920, 958, 962, 1174, 1262, 1309, 2701]","[958, 1309]","[33, 192, 525, 692, 920, 962, 1174, 1262, 2701]","[958, 1309]",3242,11,3231,2,9,3231,0
4.0,OABCGLOB,"[33, 193, 433, 919, 957, 1177, 1265, 1312, 2648]","[957, 1312]","[33, 193, 433, 919, 1177, 1265, 2648]","[957, 1312]",3193,9,3184,2,7,3184,0
4.0,OAINIGFII1,"[740, 1022, 1165, 1588, 1671, 2106, 2199]",[740],"[1022, 1165, 1588, 1671, 2106, 2199]",[740],2386,7,2379,1,6,2379,0
4.0,OAINTL3,"[115, 134, 674, 813, 850, 1909, 2072, 2099, 2565, 2704]","[674, 813, 1909, 2072]","[115, 134, 850, 2099, 2565, 2704]","[674, 813, 1909, 2072]",2794,10,2784,4,6,2784,0
4.0,OAKRT213,"[144, 975, 1215, 1228, 1328, 1593, 1714, 1992, 2641, 2852, 3198, 3333, 3357, 3938, 4147, 4213, 4467, 4642, 4752, 4813, 5210, 5258, 5288, 5377, 5487, 5584, 5684, 6077, 6474, 6548, 7268, 7393, 7427, 7455, 7752, 8453, 8502, 8931, 9063, 9083, 9294, 9316, 9454]","[3198, 4147, 4813, 5288, 5684, 6077, 6548, 7393]","[144, 975, 1215, 1228, 1328, 1593, 1714, 1992, 2641, 2852, 3333, 3357, 3938, 4213, 4467, 4642, 4752, 5210, 5258, 5377, 5487, 5584, 6474, 7268, 7427, 7455, 7752, 8453, 8502, 8931, 9063, 9083, 9294, 9316, 9454]","[3198, 4147, 4813, 5288, 5684, 6077, 6548, 7393]",9523,43,9480,8,35,9480,0
4.0,OALGB,"[109, 123, 374, 955, 959, 1216, 1459, 1682, 2432, 2438, 2660, 2939, 3336, 3500, 3557, 3883, 4204, 4250, 4387, 4656, 4886, 4911, 5008, 5143, 7320]","[2660, 3883, 4656]","[109, 123, 374, 955, 959, 1216, 1459, 1682, 2432, 2438, 2939, 3336, 3500, 3557, 4204, 4250, 4387, 4886, 4911, 5008, 5143, 7320]","[938, 1742, 2660, 3883, 4656]",7372,25,7347,3,22,7345,2
4.0,OAMETIAG,"[9, 205, 438, 701, 1136, 1479, 1674, 2726]","[701, 1479]","[9, 205, 438, 1136, 1674, 2726]","[701, 1479]",2793,8,2785,2,6,2785,0
4.0,OAMTIB,"[338, 444, 1721, 1922, 2170, 2554, 2983, 3016]",[1721],"[338, 444, 1922, 2170, 2554, 2983, 3016]","[965, 1721]",3212,8,3204,1,7,3203,1
4.0,OAMTIC,"[65, 381, 621, 707, 1295, 1332]","[621, 1295]","[65, 381, 707, 1332]","[621, 1295]",2376,6,2370,2,4,2370,0
4.0,OAMTII,"[326, 799, 1023, 1312, 1378, 1976]","[1023, 1378]","[326, 799, 1312, 1976]","[1023, 1378]",2048,6,2042,2,4,2042,0
4.0,OAPROTP1,[],[],[],[212],525,0,525,0,0,524,1
4.0,OATRICH,"[146, 152, 966, 1183, 1197, 2328, 3157, 3309, 4055, 4062, 4464, 4772, 4947, 5721, 5825, 6075, 6612, 6681, 6750, 7050, 7119, 7209, 7368, 7437, 7506, 7575]",[3157],"[146, 152, 966, 1183, 1197, 2328, 3309, 4055, 4062, 4464, 4772, 4947, 5721, 5825, 6075, 6612, 6681, 6750, 7050, 7119, 7209, 7368, 7437, 7506, 7575]",[3157],9337,26,9311,1,25,9311,0
4.0,OCAPOAIG,"[361, 553, 855, 1152, 1159, 1239, 1467, 1916]","[553, 855]","[361, 1152, 1159, 1239, 1467, 1916]","[553, 855]",1987,8,1979,2,6,1979,0
4.0,OCTNFBETA,"[68, 202, 390, 577, 1637]",[577],"[68, 202, 390, 1637]","[577, 766]",1965,5,1960,1,4,1959,1
4.0,OCUTGLOB,"[1336, 1576, 2050, 2144, 2162, 2566, 2680, 2700, 3077, 3172, 3357, 3424, 3496, 4176, 4265, 4529, 4900, 4912, 5062, 5072, 5207]",[3357],"[1336, 1576, 2050, 2144, 2162, 2566, 2680, 2700, 3077, 3172, 3424, 3496, 4176, 4265, 4529, 4900, 4912, 5062, 5072, 5207]","[3357, 5831]",6561,21,6540,1,20,6539,1
4.0,OOGH,"[200, 333, 768, 849, 914, 946, 1084, 1475]","[333, 1084, 1475]","[200, 768, 849, 914, 946]","[333, 740, 1084, 1475]",2155,8,2147,3,5,2146,1
4.0,OPOP1,[249],[249],[],[249],617,1,616,1,0,616,0
4.0,ORAPROTP1A,"[59, 163, 276]",[163],"[59, 276]",[163],410,3,407,1,2,407,0
4.0,PAA1GL,"[155, 204, 513, 752]","[204, 513]","[155, 752]","[204, 513]",873,4,869,2,2,869,0
4.0,PAAFPG,[214],[214],[],[214],1088,1,1087,1,0,1087,0
4.0,PAU03674,"[361, 1194, 1710, 1853, 2100, 2414, 3171, 3574, 3777, 3870, 4013, 4023, 4171, 4611, 4741, 4765, 5237]","[3171, 3574, 4013, 4611]","[361, 1194, 1710, 1853, 2100, 2414, 3777, 3870, 4023, 4171, 4741, 4765, 5237]","[3171, 3574, 3773, 4013, 4294, 4611]",5438,17,5421,4,13,5419,2
4.0,PIGAPAI,"[35, 62, 107, 449, 562, 794, 1129, 1156, 1823, 1918, 2317, 2693, 2917, 3317]","[794, 1129]","[35, 62, 107, 449, 562, 1156, 1823, 1918, 2317, 2693, 2917, 3317]","[794, 1129]",3326,14,3312,2,12,3312,0
4.0,PIGAPCIII,"[27, 45, 148, 620, 736, 867, 944, 948, 1141, 1432, 1711, 2031, 2083, 2639, 3036]","[1432, 1711]","[27, 45, 148, 620, 736, 867, 944, 948, 1141, 2031, 2083, 2639, 3036]","[1432, 1711]",3269,15,3254,2,13,3254,0
4.0,PIGCNP,"[400, 429, 528, 1150, 1416, 1622, 1662]",[400],"[429, 528, 1150, 1416, 1622, 1662]",[400],1887,7,1880,1,6,1880,0
4.0,PIGFSB,"[515, 589, 1598, 1801, 1849]",[515],"[589, 1598, 1801, 1849]","[515, 1042]",2044,5,2039,1,4,2038,1
4.0,PIKEGLOBIN,"[221, 237, 541, 588, 1011, 1193, 1319]","[237, 588]","[221, 541, 1011, 1193, 1319]","[237, 588]",1702,7,1695,2,5,1695,0
4.0,PPGLTG,"[373, 662, 747, 907]","[373, 662]","[747, 907]","[373, 662]",1065,4,1061,2,2,1061,0
4.0,PPPROP2,"[63, 576, 661]",[],"[63, 576, 661]",[319],740,3,737,0,3,736,1
4.0,PPYPROP2,"[530, 615]",[],"[530, 615]",[272],689,2,687,0,2,686,1
4.0,PTAZGLO,"[441, 840, 943, 965, 974, 1062, 1086, 1603, 1648, 1652, 1679, 1721, 1749, 1791, 1833, 1947, 2120, 2162, 2176, 2244, 2253, 2987, 3077]","[1603, 3077]","[441, 840, 943, 965, 974, 1062, 1086, 1648, 1652, 1679, 1721, 1749, 1791, 1833, 1947, 2120, 2162, 2176, 2244, 2253, 2987]","[1603, 3077]",3612,23,3589,2,21,3589,0
4.0,PTGGGLOG,"[162, 200, 545, 641, 1064, 1076]","[200, 545]","[162, 641, 1064, 1076]","[200, 545]",1815,6,1809,2,4,1809,0
4.0,PTPPINS,"[688, 728, 933, 1054, 1140, 1410, 1985]",[1410],"[688, 728, 933, 1054, 1140, 1985]",[1410],2476,7,2469,1,6,2469,0
4.0,PTPROP2,"[74, 588, 673]",[],"[74, 588, 673]",[330],751,3,748,0,3,747,1
4.0,PVU11715,"[250, 288, 586, 633, 1021, 1272, 1340, 1344]","[288, 633]","[250, 586, 1021, 1272, 1340, 1344]","[288, 633]",1782,8,1774,2,6,1774,0
4.0,QULNFLW,"[15, 648, 867, 961, 1222, 1548, 1667, 2169, 2301, 2364, 2405, 2425, 2461, 2703, 3329, 3662, 3720, 3794, 4139, 4443, 4587, 4656, 4817, 5192, 5612, 5849, 5873, 5894, 5921, 5972, 6211, 6672, 6808, 7385, 7413]","[3794, 4656, 5921]","[15, 648, 867, 961, 1222, 1548, 1667, 2169, 2301, 2364, 2405, 2425, 2461, 2703, 3329, 3662, 3720, 4139, 4443, 4587, 4817, 5192, 5612, 5849, 5873, 5894, 5972, 6211, 6672, 6808, 7385, 7413]","[3794, 4656, 5921]",7926,35,7891,3,32,7891,0
4.0,QULTROPIA,"[67, 240, 469, 591, 678, 689, 694, 1449, 1858, 1998, 2186, 2210, 2360, 2707, 3004, 3149, 3437, 3638, 4007, 4020, 4047, 4052, 4225, 4229, 4336, 4544, 4565, 4823]","[2186, 2360, 3004, 3437, 4047, 4336]","[67, 240, 469, 591, 678, 689, 694, 1449, 1858, 1998, 2210, 2707, 3149, 3638, 4007, 4020, 4052, 4225, 4229, 4544, 4565, 4823]","[2186, 2360, 3004, 3437, 4047, 4336]",4959,28,4931,6,22,4931,0
4.0,RABCRP,"[397, 416, 579, 990, 1221]",[397],"[416, 579, 990, 1221]",[397],1431,5,1426,1,4,1426,0
4.0,RABDNP3AA,"[370, 654, 742, 816, 906, 924, 1030, 1865, 2156, 2435, 2483]",[2156],"[370, 654, 742, 816, 906, 924, 1030, 1865, 2435, 2483]",[2156],3083,11,3072,1,10,3072,0
4.0,RABSURFA,"[471, 503, 636, 679, 780, 1038, 1431, 1642, 3239, 3423, 3443, 3447, 3455, 3550, 4033, 4188, 4361, 4636, 4857, 4987, 5088, 5622, 5899, 6219, 6359, 6529, 6793, 7268, 7760]","[4033, 4361, 5088]","[471, 503, 636, 679, 780, 1038, 1431, 1642, 3239, 3423, 3443, 3447, 3455, 3550, 4188, 4636, 4857, 4987, 5622, 5899, 6219, 6359, 6529, 6793, 7268, 7760]","[4033, 4361, 5088]",8090,29,8061,3,26,8061,0
4.0,RABTNF,"[261, 503, 851, 1355, 1563, 1761, 1792, 2139, 2268]","[851, 1355, 1563]","[261, 503, 1761, 1792, 2139, 2268]","[851, 1355, 1563]",3193,9,3184,3,6,3184,0
4.0,RATCYC,"[70, 362, 572, 833, 1333, 1438, 2350]",[1333],"[70, 362, 572, 833, 1438, 2350]",[1333],2521,7,2514,1,6,2514,0
4.0,RATCYSS,"[81, 1006, 1119, 1174, 1217, 1221, 1268, 1630, 1686, 4026, 4083, 4200, 4283, 4287, 4869]","[1006, 4026]","[81, 1119, 1174, 1217, 1221, 1268, 1630, 1686, 4083, 4200, 4283, 4287, 4869]","[1006, 4026]",5556,15,5541,2,13,5541,0
4.0,RATDCCOVB,"[788, 880, 1545, 1559, 1599, 1943, 2267, 2271, 2292, 2471, 2864, 3126, 3498, 3716, 3782, 4349, 5129]","[2267, 2864, 3126]","[788, 880, 1545, 1559, 1599, 1943, 2271, 2292, 2471, 3498, 3716, 3782, 4349, 5129]","[2267, 2864, 3126]",5324,17,5307,3,14,5307,0
4.0,RATGRG,"[83, 204, 286, 331, 1291, 1302, 1494, 1622, 1696, 1732, 1942, 2187, 2319, 2392, 2525, 2616, 2994, 3290, 3294, 3552, 3715, 3763]","[83, 286, 1291, 1494, 1696, 1942, 2187, 2319, 2616, 2994, 3290]","[204, 331, 1302, 1622, 1732, 2392, 2525, 3294, 3552, 3715, 3763]","[83, 286, 1291, 1494, 1696, 1942, 2187, 2319, 2616, 2994, 3290]",3881,22,3859,11,11,3859,0
4.0,RATGROS,"[397, 401, 621, 746, 1178, 1219, 1349, 1390, 1587, 2001, 2131]","[1178, 1390, 1587]","[397, 401, 621, 746, 1219, 1349, 2001, 2131]","[1178, 1390, 1587]",2489,11,2478,3,8,2478,0
4.0,RATGSTY,"[659, 663, 718, 1310, 1495, 1647, 1862, 1959, 2060, 2086, 2830, 3003, 3022, 3180, 3225, 3376, 3576, 3804, 3854, 3958, 4115, 4691, 4772, 5009, 5995]","[659, 1495, 1862, 2060, 3180, 3376]","[663, 718, 1310, 1647, 1959, 2086, 2830, 3003, 3022, 3225, 3576, 3804, 3854, 3958, 4115, 4691, 4772, 5009, 5995]","[659, 996, 1495, 1862, 2060, 3180, 3376]",6287,25,6262,6,19,6261,1
4.0,RATIGFBA,"[526, 850, 1002, 1242, 1381, 1455, 1788, 1948, 2034, 2203, 3002, 3105, 3214, 3262, 3312, 3450, 3496, 3828, 3873, 4512, 4546]","[526, 2034, 3002]","[850, 1002, 1242, 1381, 1455, 1788, 1948, 2203, 3105, 3214, 3262, 3312, 3450, 3496, 3828, 3873, 4512, 4546]","[526, 2034, 3002]",4993,21,4972,3,18,4972,0
4.0,RATJE,"[417, 1191, 1299, 1989, 2417, 2986]","[1191, 1989]","[417, 1299, 2417, 2986]","[1191, 1989]",3098,6,3092,2,4,3092,0
4.0,RATKALA,"[945, 992, 1062, 1275, 2657, 3167, 3282, 4031, 4047, 4051, 4061, 4424, 4476, 4652, 4709, 4729, 4734, 4826, 4915, 5334, 5689, 5693, 5818, 6007]","[1275, 3282, 4476, 4709]","[945, 992, 1062, 2657, 3167, 4031, 4047, 4051, 4061, 4424, 4652, 4729, 4734, 4826, 4915, 5334, 5689, 5693, 5818, 6007]","[1275, 3282, 4476, 4709]",6250,24,6226,4,20,6226,0
4.0,RATLHB,"[784, 793, 817, 825, 837, 934, 1028, 1230, 1247, 1293, 1359, 1510]","[817, 1230]","[784, 793, 825, 837, 934, 1028, 1247, 1293, 1359, 1510]","[817, 1230]",1791,12,1779,2,10,1779,0
4.0,RATLITHOST,"[80, 2013, 2464, 2496, 2847, 3117, 3471, 3475, 3902, 4652, 4715]","[2847, 3471, 3902, 4652]","[80, 2013, 2464, 2496, 3117, 3475, 4715]","[2847, 3471, 3902, 4652]",5400,11,5389,4,7,5389,0
4.0,RATLYSOZYM,"[38, 960, 1561, 1736, 2210, 2220, 3255, 3588, 3999, 4367, 4497, 4558, 5174, 5339, 5443, 6270, 6539]","[1561, 3255, 5174]","[38, 960, 1736, 2210, 2220, 3588, 3999, 4367, 4497, 4558, 5339, 5443, 6270, 6539]","[1561, 3255, 5174]",6733,17,6716,3,14,6716,0
4.0,RATLYSZYM,"[6, 113, 306, 323, 508, 574, 749, 1007, 1044, 1099, 1108, 1392, 1667, 2912, 3260, 3840, 4290, 4624, 5036, 5423, 5553, 5614, 6230, 6395, 6499, 7325, 7596]","[574, 4290, 6230]","[6, 113, 306, 323, 508, 749, 1007, 1044, 1099, 1108, 1392, 1667, 2912, 3260, 3840, 4624, 5036, 5423, 5553, 5614, 6395, 6499, 7325, 7596]","[574, 4290, 6230]",7944,27,7917,3,24,7917,0
4.0,RATOSCAL,"[1192, 1373, 1540, 1586, 1633, 1828, 2085]","[1192, 1373, 1586]","[1540, 1633, 1828, 2085]","[1192, 1373, 1586]",2120,7,2113,3,4,2113,0
4.0,RATPAP,"[624, 628, 633, 863, 921, 1048, 1076, 1308, 1648, 1737, 1795, 2295, 3305, 3570, 4704]","[1308, 1648, 2295, 3305]","[624, 628, 633, 863, 921, 1048, 1076, 1737, 1795, 3570, 4704]","[1308, 1648, 2295, 2604, 3305]",4864,15,4849,4,11,4848,1
4.0,RATPAPIIB,"[333, 1916, 2291, 2298, 2332, 2532, 2693, 2701, 2705, 2751, 3021, 3387, 3473, 3587, 3817, 3834, 4107]","[2298, 3473, 4107]","[333, 1916, 2291, 2332, 2532, 2693, 2701, 2705, 2751, 3021, 3387, 3587, 3817, 3834]","[2298, 3140, 3473, 4107]",4718,17,4701,3,14,4700,1
4.0,RATPPP,"[118, 740, 1249, 1406, 1497, 1538, 1542, 1983, 2002, 2261, 2451, 2521, 2718, 2853, 2927, 2990, 3270, 3500, 3732, 3991, 4400]",[2261],"[118, 740, 1249, 1406, 1497, 1538, 1542, 1983, 2002, 2451, 2521, 2718, 2853, 2927, 2990, 3270, 3500, 3732, 3991, 4400]",[2261],4535,21,4514,1,20,4514,0
4.0,RATPTBZR02,"[224, 326, 669, 673, 727, 871, 909, 1206, 1222, 1306, 1535, 1927, 2066, 2123, 2200, 2295, 2988, 3110, 3232]","[1306, 2066]","[224, 326, 669, 673, 727, 871, 909, 1206, 1222, 1535, 1927, 2123, 2200, 2295, 2988, 3110, 3232]","[1306, 2066]",3427,19,3408,2,17,3408,0
4.0,RATRGPI,"[1879, 2329, 2361, 2712, 2984, 3339, 3343, 3770, 4521, 4584]","[2712, 3339, 3770, 4521]","[1879, 2329, 2361, 2984, 3343, 4584]","[2712, 3339, 3770, 4521]",5238,10,5228,4,6,5228,0
4.0,RATRPIII,"[1226, 1601, 1608, 1642, 1843, 2009, 2017, 2021, 2067, 2337, 2456, 2704, 2790, 2905, 3135, 3152, 3426, 4044]","[1608, 2456, 2790, 3426]","[1226, 1601, 1642, 1843, 2009, 2017, 2021, 2067, 2337, 2704, 2905, 3135, 3152, 4044]","[1608, 2456, 2790, 3426]",4134,18,4116,4,14,4116,0
4.0,RATSVSIV1,"[67, 72, 244, 659, 814, 892]",[244],"[67, 72, 659, 814, 892]",[244],974,6,968,1,5,968,0
4.0,RATTSHB,"[260, 265, 435, 880, 1661, 2177, 2183, 2711, 3202, 3999, 4093, 4299, 4375]",[4375],"[260, 265, 435, 880, 1661, 2177, 2183, 2711, 3202, 3999, 4093, 4299]",[4375],5160,13,5147,1,12,5147,0
4.0,RN0B2GLOB,"[9, 31, 84, 316, 500, 558, 579, 693, 796, 1134, 1702, 1766]",[693],"[9, 31, 84, 316, 500, 558, 579, 796, 1134, 1702, 1766]","[354, 693]",1791,12,1779,1,11,1778,1
4.0,RN2BGLOB,"[264, 394, 432, 571, 629, 650, 764, 1217, 1760, 1769]","[432, 764]","[264, 394, 571, 629, 650, 1217, 1760, 1769]","[432, 764]",1877,10,1867,2,8,1867,0
4.0,RN3B2GLOB,"[84, 122, 267, 325, 346, 460, 867, 1421]","[122, 460]","[84, 267, 325, 346, 867, 1421]","[122, 460]",1438,8,1430,2,6,1430,0
4.0,RN3B3GLOB,"[75, 129, 365, 403, 546, 604, 625, 739, 1146]","[403, 739]","[75, 129, 365, 546, 604, 625, 1146]","[403, 739]",1739,9,1730,2,7,1730,0
4.0,RN3BGLOB,"[250, 288, 433, 491, 512, 626, 1028]","[288, 626]","[250, 433, 491, 512, 1028]","[288, 626]",1532,7,1525,2,5,1525,0
4.0,RNAC01,"[127, 131, 309, 513, 582, 844, 1367, 1463, 1467, 1694, 1914, 2190, 2597, 2631, 2685, 2867, 3335, 3556, 3767, 3850, 3984]","[1367, 1694, 2597, 2867]","[127, 131, 309, 513, 582, 844, 1463, 1467, 1914, 2190, 2631, 2685, 3335, 3556, 3767, 3850, 3984]","[1367, 1694, 2597, 2867]",4085,21,4064,4,17,4064,0
4.0,RNAC02,"[251, 262, 480, 636, 1368, 1475, 1526, 1734, 1787, 2138, 2180, 2243, 2561, 2759]","[1368, 1787, 2138]","[251, 262, 480, 636, 1475, 1526, 1734, 2180, 2243, 2561, 2759]","[1368, 1787, 2138, 2429, 2743]",3193,14,3179,3,11,3177,2
4.0,RNANTANT,"[62, 236, 1524, 1808, 3119, 3263, 3301, 3420, 3609, 3646, 3883, 3993, 4213, 4532]","[1524, 3263, 3883]","[62, 236, 1808, 3119, 3301, 3420, 3609, 3646, 3993, 4213, 4532]","[1524, 3263, 3883]",5118,14,5104,3,11,5104,0
4.0,RNAPOEG,"[459, 499, 620, 1077, 1152, 1293, 1812, 1955, 2536, 2692, 2705, 2863, 2867, 2884, 3203]","[1293, 1955]","[459, 499, 620, 1077, 1152, 1812, 2536, 2692, 2705, 2863, 2867, 2884, 3203]","[1293, 1955]",3230,15,3215,2,13,3215,0
4.0,RNCALBD9,"[161, 373, 469, 984, 1041, 1399, 1532, 1621, 1739, 1831, 2285, 2736, 3508, 4062, 4587, 4711]",[2736],"[161, 373, 469, 984, 1041, 1399, 1532, 1621, 1739, 1831, 2285, 3508, 4062, 4587, 4711]",[2736],4884,16,4868,1,15,4868,0
4.0,RNGAMT,"[799, 1531, 1564, 2173, 3141, 3319, 3628, 3760, 3802, 4003, 4441, 4635, 4704, 4715]","[2173, 3141, 3319, 3760, 4003]","[799, 1531, 1564, 3628, 3802, 4441, 4635, 4704, 4715]","[2173, 3141, 3319, 3760, 4003]",4957,14,4943,5,9,4943,0
4.0,RNGMTG,"[92, 440, 620, 741, 806, 1011, 1226, 1267, 1406, 1682, 1818, 2067, 2117, 2433, 2443, 2987, 3249, 3481, 3555, 3918, 4048, 4063, 4120, 4463, 4548, 5122, 5252, 5306, 5347]","[1682, 3249, 3918, 4463]","[92, 440, 620, 741, 806, 1011, 1226, 1267, 1406, 1818, 2067, 2117, 2433, 2443, 2987, 3481, 3555, 4048, 4063, 4120, 4548, 5122, 5252, 5306, 5347]","[1682, 3249, 3918, 4254, 4463]",5392,29,5363,4,25,5362,1
4.0,RNGROW3,"[216, 365, 471, 817, 1652, 1751, 1973]","[471, 817, 1652, 1973]","[216, 365, 1751]","[471, 817, 1652, 1973]",2550,7,2543,4,3,2543,0
4.0,RNHSC73,"[498, 522, 954, 1244, 1528, 1713, 1982, 2297, 2506, 2618, 2664, 3034, 3259, 3448, 3452, 3542, 3766, 3942]","[1244, 1713, 1982, 2618, 3034, 3448, 3766]","[498, 522, 954, 1528, 2297, 2506, 2664, 3259, 3452, 3542, 3942]","[1244, 1713, 1982, 2618, 3034, 3448, 3766]",4313,18,4295,7,11,4295,0
4.0,RNLALB01,"[39, 347, 351, 821, 877, 1101, 1237, 1242, 1354, 1414, 1914, 2096, 2419, 2897, 2974, 3297, 3482]","[1414, 1914, 2419]","[39, 347, 351, 821, 877, 1101, 1237, 1242, 1354, 2096, 2897, 2974, 3297, 3482]","[1414, 1914, 2419]",3814,17,3797,3,14,3797,0
4.0,RNLPKG,"[33, 1729, 2062, 2169, 2183, 2847, 3195, 3374, 3949, 4076, 4321, 5806, 6284, 6605, 6805, 7192, 7321, 7818, 7822, 8078, 8286, 8465, 9121, 9142, 9414, 9480, 9919, 11648, 12180, 12937]","[3949, 6284, 6605, 7192, 7818, 8078, 9480]","[33, 1729, 2062, 2169, 2183, 2847, 3195, 3374, 4076, 4321, 5806, 6805, 7321, 7822, 8286, 8465, 9121, 9142, 9414, 9919, 11648, 12180, 12937]","[3219, 3949, 6009, 6284, 6605, 7192, 7453, 7818, 8078, 9480]",13004,30,12974,7,23,12971,3
4.0,RNODC,"[115, 1097, 1339, 1344, 1554, 2666, 3174, 3305, 3525, 3618, 3918, 4182, 4382, 4517, 4698, 4953, 4982, 5631, 5650, 5825, 5851, 5974, 6291, 6350, 6412, 6582, 6692, 7326, 7759]","[3525, 3918, 4182, 4517, 4698, 4953, 5631, 5825, 6291]","[115, 1097, 1339, 1344, 1554, 2666, 3174, 3305, 3618, 4382, 4982, 5650, 5851, 5974, 6350, 6412, 6582, 6692, 7326, 7759]","[3525, 3918, 4182, 4517, 4698, 4953, 5631, 5825, 6291]",7769,29,7740,9,20,7740,0
4.0,RNP9KA,"[22, 30, 207, 248, 723, 727, 736, 823, 905, 910, 1227, 1468, 1612, 2118, 2220, 2224, 2311]",[1227],"[22, 30, 207, 248, 723, 727, 736, 823, 905, 910, 1468, 1612, 2118, 2220, 2224, 2311]",[1227],2333,17,2316,1,16,2316,0
4.0,RNPBPG,"[235, 980, 1117, 1155, 1180, 1808, 2592, 2638, 2950, 3056, 3190, 4056, 4073]","[1117, 2950]","[235, 980, 1155, 1180, 1808, 2592, 2638, 3056, 3190, 4056, 4073]","[1117, 2950]",6022,13,6009,2,11,6009,0
4.0,RNPGMUT,"[32, 63, 370, 1216, 1515, 1596, 1734, 1912, 2242, 2287, 2291]",[1596],"[32, 63, 370, 1216, 1515, 1734, 1912, 2242, 2287, 2291]","[1596, 1872]",2421,11,2410,1,10,2409,1
4.0,RNPROST22,"[45, 237, 438, 444, 499, 733, 876, 1262, 2200, 2321, 2702, 3121, 3647, 3916, 4048, 4526, 4727, 5333, 5680, 6009, 6680, 7004, 7412]","[876, 3647, 4526]","[45, 237, 438, 444, 499, 733, 1262, 2200, 2321, 2702, 3121, 3916, 4048, 4727, 5333, 5680, 6009, 6680, 7004, 7412]","[876, 3647, 4526]",7668,23,7645,3,20,7645,0
4.0,RNREVSV2A,"[12, 67, 71, 121, 290, 848, 1201, 1341]",[67],"[12, 71, 121, 290, 848, 1201, 1341]","[67, 1304]",1731,8,1723,1,7,1722,1
4.0,RNSDHG,"[199, 285, 290, 379, 405, 435, 1376, 1536, 1777, 1993, 2205, 2697, 3035, 3480, 3554, 4077, 4179, 5079, 5590, 5691, 5866, 6052, 6095, 6253, 6479, 6576, 6641, 6877, 6984, 7081, 7600, 7962, 8014, 8314, 8671, 8888, 9541]","[5691, 6052, 6253, 6984, 8671]","[199, 285, 290, 379, 405, 435, 1376, 1536, 1777, 1993, 2205, 2697, 3035, 3480, 3554, 4077, 4179, 5079, 5590, 5866, 6095, 6479, 6576, 6641, 6877, 7081, 7600, 7962, 8014, 8314, 8888, 9541]","[4640, 5691, 6052, 6253, 6984, 8671]",9571,37,9534,5,32,9533,1
4.0,RNSVFG,"[213, 500, 636, 670, 1018, 1250, 1267, 1347]",[500],"[213, 636, 670, 1018, 1250, 1267, 1347]",[500],1844,8,1836,1,7,1836,0
4.0,RNTHYCSG,"[68, 318, 326, 355, 679, 1071, 1906, 2203, 2271]","[68, 1071]","[318, 326, 355, 679, 1906, 2203, 2271]","[68, 1071]",2856,9,2847,2,7,2847,0
4.0,RNU03551,"[64, 584, 620, 715, 832, 1471, 1545, 1969, 2183, 2263, 2418, 3083, 3176, 3226]","[832, 2418, 3083]","[64, 584, 620, 715, 1471, 1545, 1969, 2183, 2263, 3176, 3226]","[832, 2418, 3083]",3591,14,3577,3,11,3577,0
4.0,RNU09193,"[438, 469, 1727, 2084, 2295, 2449, 2630, 2749, 3084, 3584, 3600, 3612, 3787, 3899]","[2084, 2749, 3084, 3787]","[438, 469, 1727, 2295, 2449, 2630, 3584, 3600, 3612, 3899]","[2084, 2749, 3084, 3787]",4188,14,4174,4,10,4174,0
4.0,RNU12250,"[293, 473, 1704, 1708]","[293, 473]","[1704, 1708]","[293, 473]",1864,4,1860,2,2,1860,0
4.0,RNUCPG,"[112, 255, 848, 1396, 1663, 1730, 1796, 1834, 1881, 2428, 2614, 2812, 3539, 3801, 4110, 4187, 4818, 4822, 4896, 4965, 5157, 5677, 5744, 6018, 6121, 6426, 6470, 6660, 6983, 7395, 8157, 9172, 9441, 10198, 10292, 10300, 10603, 10871, 11061, 11092, 11481, 11722]","[5157, 8157]","[112, 255, 848, 1396, 1663, 1730, 1796, 1834, 1881, 2428, 2614, 2812, 3539, 3801, 4110, 4187, 4818, 4822, 4896, 4965, 5677, 5744, 6018, 6121, 6426, 6470, 6660, 6983, 7395, 9172, 9441, 10198, 10292, 10300, 10603, 10871, 11061, 11092, 11481, 11722]","[4310, 5157, 7964, 8157, 9401]",12497,42,12455,2,40,12452,3
4.0,RNVEGP1,"[305, 926, 1043, 1156, 1262, 1286, 1629, 1635, 1834, 1994, 2076, 2108, 2777, 3032, 3809, 3940, 4037, 4126, 4140, 4452, 4844, 4962, 5195, 5630, 5948]","[1262, 1834, 3032, 4037]","[305, 926, 1043, 1156, 1286, 1629, 1635, 1994, 2076, 2108, 2777, 3809, 3940, 4126, 4140, 4452, 4844, 4962, 5195, 5630, 5948]","[1262, 1834, 3032, 4037, 4611]",5949,25,5924,4,21,5923,1
4.0,RNVEGP2C,"[430, 536, 1041, 1159, 1272, 1378, 1402, 1745, 1751, 1950, 2105, 2182, 2213, 2875, 3128, 3918, 4146, 4671, 4960, 5078, 5566]","[1378, 1950, 3128, 4146]","[430, 536, 1041, 1159, 1272, 1402, 1745, 1751, 2105, 2182, 2213, 2875, 3918, 4671, 4960, 5078, 5566]","[1378, 1950, 3128, 4146, 4723]",5745,21,5724,4,17,5723,1
4.0,RRU04320,"[838, 1105, 1126, 1538, 2004, 2008, 2107, 2118, 2500, 2606, 3099, 3301, 3643, 4216, 4275, 5366, 5370, 5456]","[2500, 3643]","[838, 1105, 1126, 1538, 2004, 2008, 2107, 2118, 2606, 3099, 3301, 4216, 4275, 5366, 5370, 5456]","[2500, 3643]",6799,18,6781,2,16,6781,0
4.0,S46763,"[186, 479, 535, 777, 1235, 1252, 1690, 1787, 2111, 2487, 2775, 2928, 2946, 3209, 3245, 3278, 3563, 3954, 4052, 4358, 4424, 4801, 5060, 5469, 6880, 7334, 7349, 8012, 8056, 8294, 8344]","[1235, 2487, 2775, 4052, 5060, 5469, 6880, 7334, 8012, 8294]","[186, 479, 535, 777, 1252, 1690, 1787, 2111, 2928, 2946, 3209, 3245, 3278, 3563, 3954, 4358, 4424, 4801, 7349, 8056, 8344]","[1235, 2487, 2775, 4052, 4528, 5060, 5469, 6880, 7334, 8012, 8294]",10036,31,10005,10,21,10004,1
4.0,S49651,"[246, 471, 1117, 1229, 1652, 2378, 3255, 3571, 3856, 4137, 4577]","[1652, 3255, 4137]","[246, 471, 1117, 1229, 2378, 3571, 3856, 4577]","[1652, 2786, 3255, 4137]",5441,11,5430,3,8,5429,1
4.0,S57980,"[44, 236, 437, 443, 498, 732, 875, 1261, 2198, 2319, 2700, 3119, 3645, 3914, 4046, 4524, 4725, 5331, 5678, 6007, 6678, 7002, 7410]","[875, 3645, 4524]","[44, 236, 437, 443, 498, 732, 1261, 2198, 2319, 2700, 3119, 3914, 4046, 4725, 5331, 5678, 6007, 6678, 7002, 7410]","[875, 3645, 4524]",7666,23,7643,3,20,7643,0
4.0,S62287,"[190, 570, 1493, 1673, 1965, 1970, 2535, 2619, 3108]",[],"[190, 570, 1493, 1673, 1965, 1970, 2535, 2619, 3108]",[1266],3426,9,3417,0,9,3416,1
4.0,S63697,"[280, 829]","[280, 829]",[],"[280, 829]",1332,2,1330,2,0,1330,0
4.0,S66606,"[152, 238, 340, 379, 385, 679, 1076, 1846, 1875, 2506, 3613, 3675, 3899, 3982, 4067, 4530, 4598, 4706, 5644, 5936, 5958, 6167, 6255]","[2506, 3899, 4598]","[152, 238, 340, 379, 385, 679, 1076, 1846, 1875, 3613, 3675, 3982, 4067, 4530, 4706, 5644, 5936, 5958, 6167, 6255]","[2506, 2706, 3899, 4598]",6360,23,6337,3,20,6336,1
4.0,S67057,"[83, 98, 322, 840]",[840],"[83, 98, 322]",[840],1747,4,1743,1,3,1743,0
4.0,S69277,"[142, 207, 857, 1706, 1967, 1971, 2058, 2074, 2103, 3072, 3098, 3229, 3316, 3521, 3723, 3839, 4103, 4385, 4556, 4726, 4852, 5378]","[3098, 3316, 3521, 3839, 4103]","[142, 207, 857, 1706, 1967, 1971, 2058, 2074, 2103, 3072, 3229, 3723, 4385, 4556, 4726, 4852, 5378]","[3098, 3316, 3521, 3839, 4103]",5517,22,5495,5,17,5495,0
4.0,S69278,"[279, 323, 547, 846, 861, 1184, 1402, 1406, 1500, 1529, 2564, 2590, 2739, 2826, 3031, 3231, 3347, 3561, 3832, 4004, 4174, 4236, 4880]","[2590, 2826, 3031, 3347, 3561]","[279, 323, 547, 846, 861, 1184, 1402, 1406, 1500, 1529, 2564, 2739, 3231, 3832, 4004, 4174, 4236, 4880]","[2590, 2826, 3031, 3347, 3561]",5016,23,4993,5,18,4993,0
4.0,S69350,"[235, 1866, 2149]",[235],"[1866, 2149]",[235],2153,3,2150,1,2,2150,0
4.0,SAIEGLOBIM,"[221, 237, 346, 541, 588, 604, 983, 1317, 1329, 1425, 1444]","[237, 588]","[221, 346, 541, 604, 983, 1317, 1329, 1425, 1444]","[237, 588]",1827,11,1816,2,9,1816,0
4.0,SMIGCU,"[799, 911, 1233, 1631, 1779, 1946, 2139, 2173, 2612, 2624]","[799, 1233, 1631]","[911, 1779, 1946, 2139, 2173, 2612, 2624]","[799, 1233, 1631]",2834,10,2824,3,7,2824,0
4.0,SMNPRP1A,"[215, 236]",[215],[236],[215],624,2,622,1,1,622,0
4.0,SOEEGLOBIN,"[17, 220, 236, 344, 539, 586, 602, 1183, 1195, 1291, 1310]","[236, 586]","[17, 220, 344, 539, 602, 1183, 1195, 1291, 1310]","[236, 586]",1689,11,1678,2,9,1678,0
4.0,SSBAT1G,"[260, 482, 518, 1316, 1344, 1446, 1471, 1681, 1843, 2021, 2215, 2323, 2582, 2592, 2610, 2616, 2716, 2814, 2990, 3618, 3837, 4001, 4538, 4875, 5527, 6021, 6104, 6390, 6678, 6735, 6908, 6978, 7799, 8238, 9144, 9674, 10370]","[1316, 2215, 2582, 4538, 8238, 9144, 9674]","[260, 482, 518, 1344, 1446, 1471, 1681, 1843, 2021, 2323, 2592, 2610, 2616, 2716, 2814, 2990, 3618, 3837, 4001, 4875, 5527, 6021, 6104, 6390, 6678, 6735, 6908, 6978, 7799, 10370]","[1316, 2215, 2582, 4538, 5771, 8238, 9144, 9388, 9674]",10667,37,10630,7,30,10628,2
4.0,SSIKBAGE,"[60, 788, 956, 1247, 1729, 2469, 2528, 3151, 3334, 3620, 3713, 3766, 3938, 3954, 4091, 4470, 5251, 5628]","[2469, 3151, 3713, 4091, 4470]","[60, 788, 956, 1247, 1729, 2528, 3334, 3620, 3766, 3938, 3954, 5251, 5628]","[2469, 3151, 3713, 4091, 4470]",5757,18,5739,5,13,5739,0
4.0,SSPINT1B,"[88, 185, 1081, 1518, 1933, 2127, 2551, 2759, 3399, 3407, 3903, 4582, 4793, 5245, 6247, 6605, 6609, 6774, 6790, 7102, 7761, 8049, 8246, 8541, 8611]","[2551, 3903, 5245, 6605]","[88, 185, 1081, 1518, 1933, 2127, 2759, 3399, 3407, 4582, 4793, 6247, 6609, 6774, 6790, 7102, 7761, 8049, 8246, 8541, 8611]","[1971, 2551, 3903, 5245, 6605]",8745,25,8720,4,21,8719,1
4.0,TAPROTP1,[],[],[],[230],548,0,548,0,0,547,1
4.0,TARHBE,"[76, 103, 119, 400, 418, 465]","[119, 465]","[76, 103, 400, 418]","[119, 465]",1683,6,1677,2,4,1677,0
4.0,TARHBG,"[58, 227, 265, 276, 608, 704, 1032, 1488, 2072]",[265],"[58, 227, 276, 608, 704, 1032, 1488, 2072]","[265, 612]",2140,9,2131,1,8,2130,1
4.0,TFLPA2P1,"[266, 272, 596, 650, 972, 1293, 1311, 1749, 1848, 2035, 2108, 2495]","[596, 972, 1749]","[266, 272, 650, 1293, 1311, 1848, 2035, 2108, 2495]","[596, 972, 1749]",2709,12,2697,3,9,2697,0
4.0,TFLPA2P2,"[266, 590, 644, 900, 935, 966, 1017, 1286, 1304, 1565, 1783, 1882, 2072]","[590, 966, 1783]","[266, 644, 900, 935, 1017, 1286, 1304, 1565, 1882, 2072]","[590, 966, 1783]",2432,13,2419,3,10,2419,0
4.0,TFLPA2P3,"[266, 272, 596, 650, 972, 1293, 1311, 1749, 1848, 2035, 2108, 2495]","[596, 972, 1749]","[266, 272, 650, 1293, 1311, 1848, 2035, 2108, 2495]","[596, 972, 1749]",2709,12,2697,3,9,2697,0
4.0,TFLPA2P4,"[266, 590, 644, 900, 935, 966, 1017, 1286, 1304, 1565, 1783, 1882, 2072]","[590, 966, 1783]","[266, 644, 900, 935, 1017, 1286, 1304, 1565, 1882, 2072]","[590, 966, 1783]",2432,13,2419,3,10,2419,0
4.0,TGLHBB,"[155, 519, 888, 1106, 1214, 1256, 1742, 2034, 2233]","[519, 888]","[155, 1106, 1214, 1256, 1742, 2034, 2233]","[519, 888]",2301,9,2292,2,7,2292,0
4.0,TIOPRP1A,"[212, 233]",[212],[233],[212],557,2,555,1,1,555,0
4.0,U00432,"[237, 793, 975, 1101, 1203, 1312, 1459]","[237, 793, 1101, 1312]","[975, 1203, 1459]","[83, 237, 793, 1101, 1312]",1576,7,1569,4,3,1568,1
4.0,U00433,"[83, 267, 752, 936, 1245, 1270, 1424]","[83, 267, 752, 1270]","[936, 1245, 1424]","[83, 267, 752, 1062, 1270]",1546,7,1539,4,3,1538,1
4.0,U00454,"[131, 772, 849, 1031, 1062, 1066, 1090, 1598, 1631, 1967, 2071, 2382, 2781, 2823, 3464, 3905, 4179, 4328, 4529, 4824, 4862, 5011, 5303, 5625, 5820, 6782, 6800, 6887]","[1598, 4862]","[131, 772, 849, 1031, 1062, 1066, 1090, 1631, 1967, 2071, 2382, 2781, 2823, 3464, 3905, 4179, 4328, 4529, 4824, 5011, 5303, 5625, 5820, 6782, 6800, 6887]","[1598, 4862]",7193,28,7165,2,26,7165,0
4.0,U00938,"[60, 71, 102, 247, 832, 912, 1169, 1173, 1465, 2384, 2611, 2715, 2719, 2824, 3013, 3017, 3079, 3311, 3617, 4070, 4796, 5155, 5202, 5261, 5640, 5809, 5962, 6482]","[1169, 4070, 5155]","[60, 71, 102, 247, 832, 912, 1173, 1465, 2384, 2611, 2715, 2719, 2824, 3013, 3017, 3079, 3311, 3617, 4796, 5202, 5261, 5640, 5809, 5962, 6482]","[1169, 4070, 5155]",6781,28,6753,3,25,6753,0
4.0,U01026,"[52, 492, 1364, 1419, 1746, 1927, 2071, 2316, 2537, 2636, 2760, 2826]","[1364, 1746, 2537]","[52, 492, 1419, 1927, 2071, 2316, 2636, 2760, 2826]","[1364, 1746, 2537]",3217,12,3205,3,9,3205,0
4.0,U01027,"[248, 571, 625, 947, 1128, 1272, 1290, 1710, 1809, 1999, 2740]","[571, 947, 1710]","[248, 625, 1128, 1272, 1290, 1809, 1999, 2740]","[571, 947, 1710]",2762,11,2751,3,8,2751,0
4.0,U01844,"[64, 476, 623, 663, 684, 1307, 1559, 1589, 1770, 1919, 1986, 2090, 2141, 2395, 2474, 2585, 2653, 3211, 3256, 3403, 3781, 3843]","[1986, 2141, 2474, 2653, 3211]","[64, 476, 623, 663, 684, 1307, 1559, 1589, 1770, 1919, 2090, 2395, 2585, 3256, 3403, 3781, 3843]","[1986, 2141, 2474, 2653, 3211]",4220,22,4198,5,17,4198,0
4.0,XELCRPGA,"[285, 726, 842, 892, 1096, 1871, 2377, 2504, 3338, 3497, 3794]",[1096],"[285, 726, 842, 892, 1871, 2377, 2504, 3338, 3497, 3794]",[1096],3892,11,3881,1,10,3881,0
4.0,XELCRYB,"[162, 196, 200, 592, 605, 706, 945, 1326, 1500]","[706, 1326]","[162, 196, 200, 592, 605, 945, 1500]","[706, 1326]",2050,9,2041,2,7,2041,0
4.0,XELHBBC,"[263, 678, 715, 1418, 1832, 1844]","[263, 678]","[715, 1418, 1832, 1844]","[263, 678]",1982,6,1976,2,4,1976,0
4.0,XLACTA,"[553, 1260, 1349, 2591, 3422, 3556, 3815, 3868, 4138, 4845, 4946, 4961, 5128, 5338, 5353, 5509, 5898]","[2591, 3868, 4138, 4845, 5128]","[553, 1260, 1349, 3422, 3556, 3815, 4946, 4961, 5338, 5353, 5509, 5898]","[2591, 3868, 4138, 4845, 5128]",5947,17,5930,5,12,5930,0
4.0,XLACTCAG,"[831, 855, 1600, 1638, 2094, 3023, 3128, 3298, 3302, 3325, 3329, 3353, 3561, 3614, 4412, 4769, 4931, 5562, 6279, 6461, 7511, 7853, 8347, 8892]","[3614, 4931, 5562, 6461]","[831, 855, 1600, 1638, 2094, 3023, 3128, 3298, 3302, 3325, 3329, 3353, 3561, 4412, 4769, 6279, 7511, 7853, 8347, 8892]","[2473, 3614, 4931, 5562, 6461]",8901,24,8877,4,20,8876,1
4.0,XLBGL3,"[388, 1175, 1851, 2443, 2638]","[388, 1175]","[1851, 2443, 2638]","[388, 1175]",2965,5,2960,2,3,2960,0
4.0,XLGLAA1,"[137, 502, 559, 590, 594, 650]","[137, 502]","[559, 590, 594, 650]","[137, 502]",1193,6,1187,2,4,1187,0
4.0,XLGLAA2,"[138, 519, 586, 601, 1163]","[138, 519]","[586, 601, 1163]","[138, 519]",1193,5,1188,2,3,1188,0
4.0,XLK81A1G,"[1517, 1618, 1671, 1911, 2294, 2734, 2900, 3026, 3145, 3149, 3240, 3409, 3531, 3647, 3849, 4127, 4170, 4425, 4429, 5318, 5672]","[2294, 2734, 3026, 3531, 3849, 4170]","[1517, 1618, 1671, 1911, 2900, 3145, 3149, 3240, 3409, 3647, 4127, 4425, 4429, 5318, 5672]","[1759, 2294, 2734, 3026, 3531, 3849, 4170]",5893,21,5872,6,15,5871,1
4.0,XLRPL14,"[912, 1141, 1292, 1837, 2087, 2140, 2145, 2624, 3051, 3085, 3651, 3897, 5356, 5856, 6146, 6485, 6804, 7158, 7239, 7618, 7904, 8659, 9072]","[912, 2087, 5356, 7904]","[1141, 1292, 1837, 2140, 2145, 2624, 3051, 3085, 3651, 3897, 5856, 6146, 6485, 6804, 7158, 7239, 7618, 8659, 9072]","[912, 1891, 2087, 4978, 5356, 7904]",9117,23,9094,4,19,9092,2
4.0,XLRPL1AG,"[308, 339, 512, 634, 1078, 1597, 2105, 2121, 2638, 2695, 2818, 3735, 3831, 3844, 4433, 4573, 4994, 5179, 5303, 5480, 5643, 5757, 6206, 6451]","[512, 2121, 2818, 3831, 4573, 5179, 5757]","[308, 339, 634, 1078, 1597, 2105, 2638, 2695, 3735, 3844, 4433, 4994, 5303, 5480, 5643, 6206, 6451]","[512, 2121, 2438, 2818, 3137, 3831, 4573, 5179, 5757]",6950,24,6926,7,17,6924,2
4.0,XLS8,"[87, 164, 692, 804, 1006, 1530, 1867, 1874, 2032, 2326, 2616, 2865, 2893, 3505, 3963, 4181, 4856, 5432, 5618, 5708, 5849, 5912, 6325, 6381, 6468, 6931, 7181, 7381, 8071, 8411, 8542, 9259, 9832, 9886, 10366, 10967, 12388, 12527, 12978, 13088]","[2032, 5912, 7381]","[87, 164, 692, 804, 1006, 1530, 1867, 1874, 2326, 2616, 2865, 2893, 3505, 3963, 4181, 4856, 5432, 5618, 5708, 5849, 6325, 6381, 6468, 6931, 7181, 8071, 8411, 8542, 9259, 9832, 9886, 10366, 10967, 12388, 12527, 12978, 13088]","[2032, 3938, 5912, 7381, 12177]",13517,40,13477,3,37,13475,2
4.0,XLTUBAG,"[272, 591, 595, 678, 1023, 1030, 1280, 1323, 1454, 1541, 2006, 2020, 2440, 2610, 2870, 3080, 3094, 3268, 3744, 4024, 4179, 4224, 4401, 4775, 4898, 5039, 5431, 5575, 6312, 6604, 6612, 6618, 6630, 6686]","[678, 4401, 5575]","[272, 591, 595, 1023, 1030, 1280, 1323, 1454, 1541, 2006, 2020, 2440, 2610, 2870, 3080, 3094, 3268, 3744, 4024, 4179, 4224, 4775, 4898, 5039, 5431, 6312, 6604, 6612, 6618, 6630, 6686]","[678, 4401, 5575]",6889,34,6855,3,31,6855,0
4.0,XLXANF1A,"[1460, 1960, 2706, 3255, 3259, 4595]","[1460, 1960, 2706]","[3255, 3259, 4595]","[1460, 1960, 2706]",4879,6,4873,3,3,4873,0
4.0,XTGLA,"[158, 235, 269, 286, 419, 731, 1323, 2034, 2283, 2838, 2861, 3340, 3493, 4013, 4344, 4437, 4443]","[731, 2838]","[158, 235, 269, 286, 419, 1323, 2034, 2283, 2861, 3340, 3493, 4013, 4344, 4437, 4443]","[731, 2838]",4839,17,4822,2,15,4822,0
4.0,XTGLAA,"[416, 541, 656, 1036, 1411]","[1036, 1411]","[416, 541, 656]","[1036, 1411]",1993,5,1988,2,3,1988,0
4.0,XTGLB,"[21, 212, 389, 1398, 1823, 2097, 2384, 2643, 2836, 4034]","[2384, 2836]","[21, 212, 389, 1398, 1823, 2097, 2643, 4034]","[2384, 2836]",4044,10,4034,2,8,4034,0
4.0,ZEFB2MICB,"[304, 985, 1187, 1345]","[304, 1187]","[985, 1345]","[304, 1187]",2194,4,2190,2,2,2190,0
