Threshold,Locus,Predict Sites,Positive Sites,Negative Sites,Actual Donor Sites,Predict Num,Predict Positive Num,Predict Negative Num,TP,FP,TN,FN
5.5,ACU08131,"[845, 1024, 2029, 2350, 2803, 3336, 5313]","[2029, 2803]","[845, 1024, 2350, 3336, 5313]","[642, 1363, 2029, 2803, 3798]",5384,7,5377,2,5,5374,3
5.5,AGGGLINE,"[70, 2946, 2963, 3158, 3504, 4309, 6262, 6387]","[3158, 3504]","[70, 2946, 2963, 4309, 6262, 6387]","[3158, 3504]",7220,8,7212,2,6,7212,0
5.5,AGU04852,"[536, 3877, 3956, 4566, 5517, 5912, 6740, 8817, 8961, 10812]","[3956, 5517, 5912, 6740]","[536, 3877, 4566, 8817, 8961, 10812]","[3956, 5517, 5912, 6740]",10976,10,10966,4,6,10966,0
5.5,ALOEGLOBIM,"[237, 583, 1170]","[237, 583]",[1170],"[237, 583]",1683,3,1680,2,1,1680,0
5.5,ALOEGLOBIN,"[237, 583, 1170]","[237, 583]",[1170],"[237, 583]",1683,3,1680,2,1,1680,0
5.5,ALOPROTP1A,[],[],[],[166],410,0,410,0,0,409,1
5.5,AMU12024,"[257, 667, 1583, 2482]","[257, 667, 2482]",[1583],"[257, 667, 1864, 2126, 2482]",3644,4,3640,3,1,3638,2
5.5,AMU12025,"[1080, 1412, 1830, 2654, 3278, 3313]","[1412, 1830, 2654, 3278]","[1080, 3313]","[1412, 1830, 2654, 2902, 3278]",5375,6,5369,4,2,5368,1
5.5,AOIRHODOPS,"[894, 1702, 1969, 2754, 4005, 4067, 4840, 5373, 9133]","[1702, 4067, 5373]","[894, 1969, 2754, 4005, 4840, 9133]","[1702, 4067, 5373, 6243]",9915,9,9906,3,6,9905,1
5.5,ASPROP2,[],[],[],[325],664,0,664,0,0,663,1
5.5,ASYRVISP,"[625, 656, 1042, 1585]","[625, 1042, 1585]",[656],"[625, 1042, 1335, 1585, 1916]",2221,4,2217,3,1,2215,2
5.5,ATREGLOBIN,"[237, 588, 1187]","[237, 588]",[1187],"[237, 588]",1691,3,1688,2,1,1688,0
5.5,BABAPOE,"[60, 897, 2847]","[897, 2847]",[60],"[897, 2847]",4754,3,4751,2,1,4751,0
5.5,BATROX,"[341, 2078, 3011, 3975, 4110, 5035, 7378, 7655]","[341, 3011, 5035]","[2078, 3975, 4110, 7378, 7655]","[341, 3011, 5035, 6955]",8092,8,8084,3,5,8083,1
5.5,BCHEGLOBIN,"[237, 583, 1184]","[237, 583]",[1184],"[237, 583]",1697,3,1694,2,1,1694,0
5.5,BOVANPA,"[433, 858]","[433, 858]",[],"[433, 858]",1761,2,1759,2,0,1759,0
5.5,BOVCOX7AL,"[1540, 2470, 2630, 3328, 3721, 3969, 5049]","[1540, 5049]","[2470, 2630, 3328, 3721, 3969]","[1540, 2812, 5049]",6848,7,6841,2,5,6840,1
5.5,BOVGAS,[751],[751],[],[751],1058,1,1057,1,0,1057,0
5.5,BOVIAP,"[437, 457, 602, 926, 1318, 1764, 1994, 3392, 3535, 3782, 3996]","[1764, 1994, 3392, 3996]","[437, 457, 602, 926, 1318, 3535, 3782]","[1568, 1764, 1994, 2354, 2606, 2999, 3157, 3392, 3667, 3996]",5391,11,5380,4,7,5374,6
5.5,BOVIRBP,"[129, 2586, 2649, 3174, 3723, 3801, 4212, 5761, 6214, 6494, 7699, 9959, 10082, 11020]","[3174, 7699]","[129, 2586, 2649, 3723, 3801, 4212, 5761, 6214, 6494, 9959, 10082, 11020]","[3174, 5595, 7699]",11785,14,11771,2,12,11770,1
5.5,BOVLHB,"[803, 1272]","[803, 1272]",[],"[803, 1272]",1856,2,1854,2,0,1854,0
5.5,BOVLYSOZMA,"[3039, 3208, 5771, 8654, 9247]","[3039, 5771, 8654]","[3208, 9247]","[3039, 5771, 8654]",12214,5,12209,3,2,12209,0
5.5,BOVLYSOZMB,"[140, 1229, 1662, 1993, 2673, 2843, 3717, 3743, 4005, 4797, 5148, 6212, 6807, 7058, 10002]","[2673, 4005, 6212]","[140, 1229, 1662, 1993, 2843, 3717, 3743, 4797, 5148, 6807, 7058, 10002]","[2673, 4005, 6212]",10204,15,10189,3,12,10189,0
5.5,BOVLYSOZMC,"[905, 2323, 4194, 4964, 6245]","[905, 2323, 4194]","[4964, 6245]","[905, 2323, 4194]",8043,5,8038,3,2,8038,0
5.5,BOVMYF5A,"[273, 698, 1625]","[698, 1625]",[273],"[698, 1625]",5211,3,5208,2,1,5208,0
5.5,BRHOX22,[1431],[1431],[],[1431],3434,1,3433,1,0,3433,0
5.5,BRHOX34A,"[588, 3491]",[],"[588, 3491]",[981],3490,2,3488,0,2,3487,1
5.5,BRU12895,"[1135, 1986]",[1135],[1986],[1135],3232,2,3230,1,1,3230,0
5.5,BTATPAAA,"[740, 826, 1146, 2314, 4106, 4188, 5556, 5729, 9129]","[740, 2314, 5729, 9129]","[826, 1146, 4106, 4188, 5556]","[740, 2314, 3707, 5729, 5984, 6337, 6827, 7151, 7770, 8023, 9129]",9907,9,9898,4,5,9891,7
5.5,BTEBGL2,"[294, 310, 327, 658]","[310, 658]","[294, 327]","[310, 658]",1833,4,1829,2,2,1829,0
5.5,BTEBGL4,"[294, 310, 327, 658, 815]","[310, 658]","[294, 327, 815]","[310, 658]",1828,5,1823,2,3,1823,0
5.5,BTGL01,"[365, 1008]","[365, 1008]",[],"[365, 1008]",2040,2,2038,2,0,2038,0
5.5,BTHOR02,[484],[484],[],"[484, 1920]",2419,1,2418,1,0,2417,1
5.5,BTKER6B,"[1678, 2913]",[1678],[2913],"[1678, 2559, 3070, 3315, 3530, 4056, 4666]",5718,2,5716,1,1,5710,6
5.5,BTSPDNA,[],[],[],[1541],2148,0,2148,0,0,2147,1
5.5,BTSVSP109,"[52, 799, 2189, 2359, 2555, 5292, 5315, 5643, 6096]","[2359, 5292]","[52, 799, 2189, 2555, 5315, 5643, 6096]","[2359, 3984, 5292]",6948,9,6939,2,7,6938,1
5.5,BTTNP2G,[847],[],[847],[774],1841,1,1840,0,1,1839,1
5.5,BTU02285,"[21, 1858, 2873, 4222, 4487, 4780, 5056, 5654]","[4222, 4487, 4780, 5056]","[21, 1858, 2873, 5654]","[3792, 4222, 4487, 4780, 5056]",6388,8,6380,4,4,6379,1
5.5,CALEGLOBIM,"[236, 587, 1185]","[236, 587]",[1185],"[236, 587]",1690,3,1687,2,1,1687,0
5.5,CBUEGLOBIM,"[236, 587, 1185]","[236, 587]",[1185],"[236, 587]",1690,3,1687,2,1,1687,0
5.5,CCALAC,"[1358, 1852, 2409]","[1358, 1852, 2409]",[],"[1358, 1852, 2409]",3619,3,3616,3,0,3616,0
5.5,CCBEGLOBIM,"[237, 587, 1191]","[237, 587]",[1191],"[237, 587]",1695,3,1692,2,1,1692,0
5.5,CCBEGLOBIN,"[238, 589, 1194]","[238, 589]",[1194],"[238, 589]",1698,3,1695,2,1,1695,0
5.5,CCGHG,"[283, 1778]","[283, 1778]",[],"[283, 706, 1051, 1778]",2830,2,2828,2,0,2826,2
5.5,CCGONBS1,[1767],[1767],[],"[1767, 2072]",3463,1,3462,1,0,3461,1
5.5,CCGONBS2,[1785],[1785],[],"[1785, 2091]",3482,1,3481,1,0,3480,1
5.5,CCGTHA1,[302],[302],[],"[302, 572]",1144,1,1143,1,0,1142,1
5.5,CCT64CLU,"[563, 1644, 1664, 2757, 3005, 3496, 5272, 5659]","[1644, 2757, 3005, 3496, 5272, 5659]","[563, 1664]","[1644, 2757, 3005, 3496, 4514, 5272, 5659]",6276,8,6268,6,2,6267,1
5.5,CEPPINS,[858],[858],[],[858],1901,1,1900,1,0,1900,0
5.5,CHBLG,"[698, 928, 3794, 4019, 4298, 4700, 4861, 6025]","[4019, 6025]","[698, 928, 3794, 4298, 4700, 4861]","[2285, 3090, 4019, 5246, 6025]",8080,8,8072,2,6,8069,3
5.5,CHEBGLI,"[909, 1213]",[909],[1213],"[570, 909]",2204,2,2202,1,1,2201,1
5.5,CHEBGLII,"[547, 563, 580, 912]","[563, 912]","[547, 580]","[563, 912]",2258,4,2254,2,2,2254,0
5.5,CHKALDB,"[1452, 4004, 5731, 5748, 6172, 6664, 6955, 6960, 7504, 8186, 9185, 10844]","[6172, 6664, 6955, 8186, 9185]","[1452, 4004, 5731, 5748, 6960, 7504, 10844]","[6172, 6664, 6955, 7265, 8186, 8842, 9185]",11643,12,11631,5,7,11629,2
5.5,CHKAPOII,"[1839, 1891, 2131, 3317, 3820]","[3317, 3820]","[1839, 1891, 2131]","[3317, 3820]",4953,5,4948,2,3,4948,0
5.5,CHKDPCP,"[347, 637, 1624]",[637],"[347, 1624]",[637],1902,3,1899,1,2,1899,0
5.5,CHKMAX,"[1236, 2127, 2291, 3928, 4295]","[2127, 2291, 3928, 4295]",[1236],"[2127, 2291, 3928, 4295]",5690,5,5685,4,1,5685,0
5.5,CHKMYOD,"[3468, 4941, 6150]","[4941, 6150]",[3468],"[4941, 6150]",7381,3,7378,2,1,7378,0
5.5,CHKOVAL,"[1390, 3164, 3812, 4176, 4694, 5144, 6282, 8791]","[3164, 4176, 4694, 6282]","[1390, 3812, 5144, 8791]","[3164, 3466, 4176, 4694, 5795, 6282]",9198,8,9190,4,4,9188,2
5.5,CHKRPL30,"[671, 749, 801, 1872, 2753, 2816]","[801, 1872, 2753]","[671, 749, 2816]","[801, 1872, 2753]",3884,6,3878,3,3,3878,0
5.5,CHKRPL37A,"[798, 996, 1376, 2125, 2255]","[798, 1376]","[996, 2125, 2255]","[798, 1376, 2386]",3465,5,3460,2,3,3459,1
5.5,CHKRPL5G,"[1419, 1632, 2618]","[1419, 1632]",[2618],"[498, 1419, 1632, 3157, 3955, 5165, 6897]",8313,3,8310,2,1,8305,5
5.5,CHKTUB4B,"[779, 949, 1469, 1573]","[949, 1573]","[779, 1469]","[437, 949, 1573]",3145,4,3141,2,2,3140,1
5.5,CHKY,"[641, 1650, 1664, 3603, 4199, 4683, 5213, 5648, 6012, 8361]","[3603, 4199, 4683, 5648, 6012]","[641, 1650, 1664, 5213, 8361]","[3603, 4199, 4683, 5648, 6012, 6249]",8364,10,8354,5,5,8353,1
5.5,CHPPHYGEN,"[22, 2214, 3786, 4599, 4945, 7000, 8862, 10818, 10833, 10849, 11193, 11903, 11936, 12603]","[4599, 4945]","[22, 2214, 3786, 7000, 8862, 10818, 10833, 10849, 11193, 11903, 11936, 12603]","[4599, 4945]",13689,14,13675,2,12,13675,0
5.5,CHPPROTP1A,[],[],[],[159],397,0,397,0,0,396,1
5.5,CHPPROTP1B,[],[],[],[160],396,0,396,0,0,395,1
5.5,CHWEGLOBIM,"[237, 588, 1193]","[237, 588]",[1193],"[237, 588]",1701,3,1698,2,1,1698,0
5.5,CIGH,"[1281, 2029, 2889]","[1281, 2889]",[2029],"[1281, 1691, 2280, 2889]",3967,3,3964,2,1,3962,2
5.5,CITEGLOBIM,"[236, 587, 1186]","[236, 587]",[1186],"[236, 587]",1691,3,1688,2,1,1688,0
5.5,CJAEGLOBIN,"[237, 588, 1193]","[237, 588]",[1193],"[237, 588]",1702,3,1699,2,1,1699,0
5.5,CJINTERFG,"[3303, 4187, 4465, 6036]","[4187, 4465]","[3303, 6036]","[2881, 4187, 4465]",8519,4,8515,2,2,8514,1
5.5,CL54K,"[512, 649, 959, 1177, 1294, 1538, 2581, 2696, 2715]",[512],"[649, 959, 1177, 1294, 1538, 2581, 2696, 2715]",[512],3407,9,3398,1,8,3398,0
5.5,CMBGA2B2,"[383, 718, 989, 1597]","[383, 718]","[989, 1597]","[383, 718]",2684,4,2680,2,2,2680,0
5.5,CMEGA2E2,[416],[416],[],"[416, 753]",2046,1,2045,1,0,2044,1
5.5,CMU11711,"[15, 790, 1685, 2031]","[1685, 2031]","[15, 790]","[1685, 2031]",3163,4,3159,2,2,3159,0
5.5,CPPROT1GN,[],[],[],[164],390,0,390,0,0,389,1
5.5,CRASEQB,"[2825, 3434, 3464, 3635, 3641, 3647]",[2825],"[3434, 3464, 3635, 3641, 3647]","[1920, 2825]",5120,6,5114,1,5,5113,1
5.5,CRUCH7AHYD,"[1731, 2941, 3016, 5283, 7866]","[1731, 7866]","[2941, 3016, 5283]","[1731, 3651, 4938, 6076, 7866]",10606,5,10601,2,3,10598,3
5.5,CRUGAD45A,"[208, 859, 1877, 2417, 2553]","[1877, 2417]","[208, 859, 2553]","[1877, 2063, 2417]",4427,5,4422,2,3,4421,1
5.5,DMPROTP1,[],[],[],[249],616,0,616,0,0,615,1
5.5,DMU11712,"[16, 792, 1705, 2043]","[1705, 2043]","[16, 792]","[1705, 2043]",3019,4,3015,2,2,3015,0
5.5,DOGCOLIP,"[224, 249, 416, 1108, 1411, 2378, 2508]","[1108, 2378]","[224, 249, 416, 1411, 2508]","[1108, 2378]",3156,7,3149,2,5,3149,0
5.5,DOGIL8T,"[118, 1206, 1406, 1769]","[118, 1406, 1769]",[1206],"[118, 1406, 1769]",2229,4,2225,3,1,2225,0
5.5,ECGLOAP1,[657],[657],[],"[363, 657]",1133,1,1132,1,0,1131,1
5.5,ECPZA2GL,"[1560, 1623, 3576, 4059]","[3576, 4059]","[1560, 1623]","[3576, 4059]",5081,4,5077,2,2,5077,0
5.5,ECZGL1,"[700, 763]",[700],[763],"[700, 1534]",1993,2,1991,1,1,1990,1
5.5,ECZGL2,"[255, 318]",[255],[318],"[255, 1084]",1555,2,1553,1,1,1552,1
5.5,ELMETL,"[1097, 1291]","[1097, 1291]",[],"[1097, 1291]",1865,2,1863,2,0,1863,0
5.5,FDFELDI2,"[678, 1070, 1882, 2011]",[],"[678, 1070, 1882, 2011]","[276, 970]",2417,4,2413,0,4,2411,2
5.5,FDTNFA,[187],[187],[],"[187, 790, 972]",1714,1,1713,1,0,1711,2
5.5,GDMYF5G,"[639, 655, 1036, 1104]","[639, 1036]","[655, 1104]","[639, 1036]",1601,4,1597,2,2,1597,0
5.5,GGAC01,"[22, 273, 634, 1586, 1666, 2226, 3189, 3495, 3677, 3831]","[1666, 2226, 3189, 3677]","[22, 273, 634, 1586, 3495, 3831]","[1666, 2226, 3189, 3677]",5038,10,5028,4,6,5028,0
5.5,GGACTAC,"[339, 2914, 3218, 4216, 4398]","[2914, 3218, 4398]","[339, 4216]","[970, 2127, 2914, 3218, 4398]",5455,5,5450,3,2,5448,2
5.5,GGACTI,"[153, 841, 1659, 1841]","[841, 1841]","[153, 1659]","[404, 841, 1137, 1554, 1841]",2418,4,2414,2,2,2411,3
5.5,GGCALB,"[386, 421, 1292, 1863, 2289, 3617, 3793, 6149, 6784, 7824, 8249, 8718, 9052]","[386, 1863, 2289, 3793, 6784, 7824, 8718, 9052]","[421, 1292, 3617, 6149, 8249]","[386, 1863, 2289, 3467, 3793, 4235, 4894, 5205, 5933, 6784, 7035, 7824, 8718, 9052, 9685, 10195]",11060,13,11047,8,5,11039,8
5.5,GGCRYD1,"[267, 441, 2742, 3516, 5234, 5899, 6138, 6395]","[441, 2742, 3516, 5234, 5899, 6138, 6395]",[267],"[441, 1734, 2742, 3150, 3516, 3944, 4332, 4528, 4907, 5234, 5899, 6138, 6395, 6734, 7213]",8152,8,8144,7,1,8136,8
5.5,GGGL03,"[432, 768, 1160]","[432, 768]",[1160],"[432, 768]",1199,3,1196,2,1,1196,0
5.5,GGGNRHIA,"[1684, 3627, 4392, 4544]","[3627, 4392]","[1684, 4544]","[3627, 4392]",6274,4,6270,2,2,6270,0
5.5,GGNFM1D,"[1541, 3595, 5057]",[],"[1541, 3595, 5057]","[2132, 2451]",5630,3,5627,0,3,5625,2
5.5,GGPROP2,[],[],[],[307],640,0,640,0,0,639,1
5.5,GGRIHBGEN,"[1038, 1973, 2982, 3454]","[2982, 3454]","[1038, 1973]","[2982, 3219, 3454]",3878,4,3874,2,2,3873,1
5.5,GGVITIIG,"[54, 190, 2561, 2694, 2948, 3064, 3138, 4818, 5441, 5848, 6229, 6443, 8302, 8481, 9149, 9467, 10714, 10951, 10971, 11663, 12272, 12791, 13505, 14413, 15771, 15880, 17492, 19081, 19337, 20126]","[54, 190, 2694, 2948, 4818, 5441, 6229, 6443, 8302, 9149, 9467, 10714, 12272, 13505, 15771, 19081]","[2561, 3064, 3138, 5848, 8481, 10951, 10971, 11663, 12791, 14413, 15880, 17492, 19337, 20126]","[54, 190, 442, 2021, 2694, 2948, 3267, 3543, 3791, 4818, 5441, 6229, 6443, 7045, 7268, 8026, 8302, 9149, 9467, 10104, 10448, 10714, 11757, 12272, 12615, 13267, 13505, 14028, 14704, 15348, 15771, 16955, 17864, 19081]",20335,30,20305,16,14,20287,18
5.5,GIBPROTP1A,[],[],[],[160],393,0,393,0,0,392,1
5.5,GORAFPA,"[75, 1860, 2955, 3434, 4192, 4369, 6976, 7766, 11145, 14707, 15952, 17195]","[1860, 2955, 7766, 14707]","[75, 3434, 4192, 4369, 6976, 11145, 15952, 17195]","[999, 1860, 2955, 5457, 6760, 7766, 9445, 11629, 13421, 14087, 14707, 16581, 17834]",24599,12,24587,4,8,24578,9
5.5,GORPROTP1A,[],[],[],[164],404,0,404,0,0,403,1
5.5,GPIINS,[526],[526],[],[526],1464,1,1463,1,0,1463,0
5.5,HAMAMYLP,"[1394, 1473, 2308, 4561, 5045]",[2308],"[1394, 1473, 4561, 5045]",[2308],5947,5,5942,1,4,5942,0
5.5,HAMHG5,"[640, 1373, 1640, 2817, 3433, 4856, 6597, 7441, 7668, 8396]","[4856, 6597, 7441]","[640, 1373, 1640, 2817, 3433, 7668, 8396]","[4856, 5517, 6188, 6597, 7441]",9711,10,9701,3,7,9699,2
5.5,HROAMD1,"[237, 289, 1072, 2687, 3486, 4700, 4816, 5962]","[2687, 3486, 4700]","[237, 289, 1072, 4816, 5962]","[2687, 3486, 4700]",7091,8,7083,3,5,7083,0
5.5,HROMA2,"[739, 1174, 1285]","[739, 1174]",[1285],"[739, 1174]",1779,3,1776,2,1,1776,0
5.5,HROMA4A,"[1108, 1670, 1774]","[1108, 1670]",[1774],"[1108, 1670]",2331,3,2328,2,1,2328,0
5.5,HRSPRMI,[1880],[],[1880],[722],2198,1,2197,0,1,2196,1
5.5,HS1D3HLH,"[173, 1039, 1231]",[1039],"[173, 1231]",[1039],2473,3,2470,1,2,2470,0
5.5,HS2OXOC,"[116, 1162, 1421, 1694, 1719, 1825]","[116, 1162, 1421, 1694, 1825]",[1719],"[116, 871, 1162, 1421, 1694, 1825]",2510,6,2504,5,1,2503,1
5.5,HSABLGR1,"[371, 3140, 3344, 4865, 5465, 5666, 6508, 6820, 8470, 8720, 10016, 10073, 10400, 10509, 10623, 11951, 12239, 13058, 15514, 15741, 16572, 17116, 17249, 20105, 20665, 24805, 24896, 25292, 25849, 25906, 26127, 29268, 32399, 33787, 35562]","[8720, 10400, 15741, 17116]","[371, 3140, 3344, 4865, 5465, 5666, 6508, 6820, 8470, 10016, 10073, 10509, 10623, 11951, 12239, 13058, 15514, 16572, 17249, 20105, 20665, 24805, 24896, 25292, 25849, 25906, 26127, 29268, 32399, 33787, 35562]","[8720, 10400, 12434, 14200, 15741, 17116, 17991]",35954,35,35919,4,31,35916,3
5.5,HSALDCG,"[1283, 2098, 2481, 2641, 2663, 3366, 3567]","[2641, 3366, 3567]","[1283, 2098, 2481, 2663]","[2641, 2939, 3110, 3366, 3567, 3994, 4326]",5190,7,5183,3,4,5179,4
5.5,HSAPC3A,"[1246, 2325]",[],"[1246, 2325]","[919, 1178]",6039,2,6037,0,2,6035,2
5.5,HSAPOA2B,"[245, 338, 490, 698, 916, 1554]","[490, 916]","[245, 338, 698, 1554]","[490, 916]",1747,6,1741,2,4,1741,0
5.5,HSAPOAIA,"[57, 317]",[317],[57],"[317, 661]",2183,2,2181,1,1,2180,1
5.5,HSAPOAIT,"[231, 491]",[491],[231],"[491, 835]",2377,2,2375,1,1,2374,1
5.5,HSAPOC2G,"[231, 255, 1276, 1494, 2714, 2943]",[2714],"[231, 255, 1276, 1494, 2943]","[2714, 3041]",3832,6,3826,1,5,3825,1
5.5,HSAQUPN2,[],[],[],"[431, 632, 746]",987,0,987,0,0,984,3
5.5,HSARYLA,"[1238, 1571, 2470, 2528, 2666, 3040]","[1238, 1571, 2470]","[2528, 2666, 3040]","[848, 1238, 1571, 1815, 2252, 2470, 2823]",3629,6,3623,3,3,3619,4
5.5,HSAT3,"[646, 3311, 4823, 4978, 6059, 6879, 6934, 8536, 10401, 11303, 11320, 12719, 13056]","[646, 3311, 6059, 10401]","[4823, 4978, 6879, 6934, 8536, 11303, 11320, 12719, 13056]","[646, 3311, 6059, 7102, 8303, 10401]",14198,13,14185,4,9,14183,2
5.5,HSATPCP1,"[831, 4773, 5389, 6382, 6830, 6999, 7267, 7854]","[5389, 6382, 7267]","[831, 4773, 6830, 6999, 7854]","[5389, 6382, 7267]",9449,8,9441,3,5,9441,0
5.5,HSATPCP2,"[4013, 6152, 7310, 7490, 8957, 9194, 9752, 10918, 13435]","[7490, 10918]","[4013, 6152, 7310, 8957, 9194, 9752, 13435]","[7490, 10195, 10918]",15008,9,14999,2,7,14998,1
5.5,HSB3A,"[1843, 2623, 2670]",[1843],"[2623, 2670]",[1843],3675,3,3672,1,2,3672,0
5.5,HSBGPG,"[560, 856, 1593]",[560],"[856, 1593]","[560, 850, 1096]",1667,3,1664,1,2,1662,2
5.5,HSBSF2,"[238, 477, 1242, 2450, 2930, 3601, 4505, 4715, 4943]","[1242, 3601]","[238, 477, 2450, 2930, 4505, 4715, 4943]","[1242, 1587, 2748, 3601]",5953,9,5944,2,7,5942,2
5.5,HSCBMYHC,"[369, 1577, 2583, 2868, 3193, 3932, 4595, 5485, 5644, 6694, 7246, 7567, 7735, 7912, 8898, 9174, 10877, 11339, 12155, 12427, 13037, 13342, 14210, 14571, 17120, 18228, 18590, 18777, 18896, 19262, 21839, 22088, 23454, 23701]","[4595, 5485, 5644, 6694, 7246, 7567, 8898, 9174, 10877, 11339, 12155, 12427, 13342, 14210, 14571, 17120, 18228, 18590, 18896, 19262, 21839, 22088, 23454, 23701]","[369, 1577, 2583, 2868, 3193, 3932, 7735, 7912, 13037, 18777]","[4595, 5041, 5485, 5644, 6354, 6529, 6694, 7246, 7567, 8354, 8898, 9174, 9626, 10530, 10877, 11339, 12155, 12427, 12829, 13342, 14210, 14571, 15900, 17120, 18228, 18590, 18896, 19262, 19970, 20319, 20604, 21466, 21839, 22088, 22474, 23454, 23701]",24992,34,24958,24,10,24945,13
5.5,HSCD14G,[159],[159],[],[159],1562,1,1561,1,0,1561,0
5.5,HSCKBG,"[876, 1619, 1824, 2570, 3521]","[1619, 1824, 3521]","[876, 2570]","[1341, 1619, 1824, 2380, 3174, 3521]",4192,5,4187,3,2,4184,3
5.5,HSCOMT2,"[1075, 2378, 2897]",[2378],"[1075, 2897]","[1630, 1959, 2378]",3643,3,3640,1,2,3638,2
5.5,HSCPH70,"[205, 633, 865, 2936, 4407]",[4407],"[205, 633, 865, 2936]","[1729, 4204, 4407, 4801]",6703,5,6698,1,4,6695,3
5.5,HSCSF1PO,"[359, 779, 1965, 2816, 4479, 5647, 7572, 7831, 8287, 8680, 8943, 9217, 9575, 10227, 10517, 11063, 11515, 12975, 15733, 17882, 18046, 18156, 18208, 18465, 20123, 21444, 24260, 26732, 27465, 30823, 31040, 31942, 32108, 32862, 34006, 34399]","[1965, 7572, 8287, 10227, 11063, 17882, 18156, 18465, 20123, 27465, 30823, 31040, 32108, 34006]","[359, 779, 2816, 4479, 5647, 7831, 8680, 8943, 9217, 9575, 10517, 11515, 12975, 15733, 18046, 18208, 21444, 24260, 26732, 31942, 32862, 34399]","[1965, 7572, 8287, 10227, 11063, 15036, 17882, 18156, 18465, 20123, 26605, 26837, 27465, 28627, 30823, 31040, 32108, 32301, 33091, 34006]",35092,36,35056,14,22,35050,6
5.5,HSCST3G,"[1328, 3064, 3468, 3694, 3783, 3865, 4129, 5518, 7112]","[1328, 3694]","[3064, 3468, 3783, 3865, 4129, 5518, 7112]","[1328, 3694]",7284,9,7275,2,7,7275,0
5.5,HSCYCLA,"[2406, 3668, 4168, 5338, 6323, 6982]","[2406, 4168, 5338]","[3668, 6323, 6982]","[1393, 2406, 3731, 4168, 5338, 5911, 6667]",8355,6,8349,3,3,8345,4
5.5,HSCYP216,"[255, 879, 1278, 1836, 2402]","[255, 879, 1278, 1836, 2402]",[],"[255, 442, 879, 1088, 1278, 1466, 1836, 2215, 2402]",2763,5,2758,5,0,2754,4
5.5,HSCYP45C,"[185, 947, 1772, 2667, 4680, 4963, 5008, 6016, 6248, 6562]","[6016, 6248]","[185, 947, 1772, 2667, 4680, 4963, 5008, 6562]","[4942, 5624, 5801, 6016, 6248]",7546,10,7536,2,8,7533,3
5.5,HSCYTOK17,"[396, 452, 581, 1709, 2079, 2304, 2928, 3468, 4000, 4123, 4987]","[581, 1709, 2304, 4000, 4123]","[396, 452, 2079, 2928, 3468, 4987]","[581, 1709, 2304, 3066, 3693, 4000, 4123]",5252,11,5241,5,6,5239,2
5.5,HSCYTOK20,"[1277, 3128, 3978, 5281, 8722, 9313, 9470, 10005, 12705, 16343, 16620]","[5281, 9470, 12705]","[1277, 3128, 3978, 8722, 9313, 10005, 16343, 16620]","[5281, 7512, 9470, 9984, 10271, 11940, 12705]",18053,11,18042,3,8,18038,4
5.5,HSDAO,"[588, 956, 1177, 2551, 6426, 7431]","[6426, 7431]","[588, 956, 1177, 2551]","[6426, 7431, 9013]",9895,6,9889,2,4,9888,1
5.5,HSERPG,"[628, 1340, 1683, 1943, 2474, 2768]","[628, 1340, 1683, 2474]","[1943, 2768]","[628, 1340, 1683, 2474]",3390,6,3384,4,2,3384,0
5.5,HSFAU1,"[505, 857, 1096, 1129, 1557, 1613]","[857, 1096, 1613]","[505, 1129, 1557]","[857, 1096, 1613]",2008,6,2002,3,3,2002,0
5.5,HSFESFPS,"[1227, 1553, 4008, 4522, 5924, 6240, 6445, 7150, 7634, 8069, 8782, 9151, 9176, 9371, 10015, 11511]","[1227, 1553, 5924, 6240, 6445, 7150, 7634, 8069, 8782, 9151, 9371, 10015]","[4008, 4522, 9176, 11511]","[1227, 1553, 3023, 3336, 5405, 5598, 5924, 6240, 6445, 7150, 7634, 8069, 8782, 9151, 9371, 9768, 10015]",12255,16,12239,12,4,12234,5
5.5,HSGCSFG,"[404, 735, 744, 1230, 1521]","[404, 744, 1230, 1521]",[735],"[404, 744, 1230, 1521]",2952,5,2947,4,1,2947,0
5.5,HSGEBCMA,"[607, 700, 1648, 3234]",[607],"[700, 1648, 3234]","[607, 1496]",3711,4,3707,1,3,3706,1
5.5,HSGGL2,"[202, 547]","[202, 547]",[],"[202, 547]",1620,2,1618,2,0,1618,0
5.5,HSGLA,"[852, 2148, 8378, 8413, 10369, 11761]",[8413],"[852, 2148, 8378, 10369, 11761]","[1374, 5269, 7447, 8413, 10293, 10708]",12428,6,12422,1,5,12417,5
5.5,HSGROW2,"[345, 1091]","[345, 1091]",[],"[345, 762, 1091, 1349]",1956,2,1954,2,0,1952,2
5.5,HSGSTM4,"[37, 522, 2232, 3953]",[37],"[522, 2232, 3953]","[37, 391, 874, 1262, 1458, 2469, 2670]",4834,4,4830,1,3,4824,6
5.5,HSGTRH,"[442, 515, 2205, 2322, 3816, 5548, 6275]","[2205, 3816]","[442, 515, 2322, 5548, 6275]","[2205, 3816]",7216,7,7209,2,5,7209,0
5.5,HSHMG17G,"[1538, 1793, 2037, 2279, 2524, 3415, 3620, 4021, 5920, 7188]","[2524, 3415, 3620, 4021]","[1538, 1793, 2037, 2279, 5920, 7188]","[2524, 3415, 3620, 4021, 4553]",7187,10,7177,4,6,7176,1
5.5,HSHNRNPA,"[49, 707, 814, 868, 1936, 2481, 2869, 3602, 3962, 4312]","[814, 1936, 2481, 2869, 3962]","[49, 707, 868, 3602, 4312]","[814, 1494, 1936, 2295, 2481, 2660, 2869, 3962]",5360,10,5350,5,5,5347,3
5.5,HSHOX51,"[1278, 1791, 2052, 2415, 4023]",[2052],"[1278, 1791, 2415, 4023]",[2052],6297,5,6292,1,4,6292,0
5.5,HSHSC70,"[27, 1245, 1773, 2250, 3307, 3734, 5378]","[1245, 1773, 2250, 3307, 3734]","[27, 5378]","[1245, 1773, 2250, 2893, 3307, 3734, 4114]",5400,7,5393,5,2,5391,2
5.5,HSIFNAR,"[329, 631, 830, 2696, 4612, 5386, 7976, 8594, 10423, 13828, 15482, 16062, 16944, 19442, 20346, 21132, 21239, 22586, 23783, 24341, 25061, 27880, 28142, 28272, 29554, 30489]","[830, 16944, 19442, 21132, 25061, 29554]","[329, 631, 2696, 4612, 5386, 7976, 8594, 10423, 13828, 15482, 16062, 20346, 21239, 22586, 23783, 24341, 27880, 28142, 28272, 30489]","[830, 11325, 16944, 19188, 19442, 21132, 25061, 25314, 28679, 29554]",32898,26,32872,6,20,32868,4
5.5,HSIFNG,"[1897, 2175, 2413]","[1897, 2175]",[2413],"[589, 1897, 2175]",5953,3,5950,2,1,5949,1
5.5,HSIL1AG,"[2208, 2949, 3215, 3939, 4326, 5580, 7940, 9875]","[2208, 3215, 4326, 7940]","[2949, 3939, 5580, 9875]","[2208, 3215, 4326, 6433, 7940]",11962,8,11954,4,4,11953,1
5.5,HSIL1B,"[2528, 3144, 7406]","[2528, 3144, 7406]",[],"[2528, 3144, 5327, 6039, 7406]",9703,3,9700,3,0,9698,2
5.5,HSINT2,"[1156, 3549, 9331, 9480, 10216, 10533, 10644, 10708]","[1156, 3549]","[9331, 9480, 10216, 10533, 10644, 10708]","[1156, 3549]",11600,8,11592,2,6,11592,0
5.5,HSL7A,"[2073, 2867, 3525, 4052, 4164, 4572, 4919]","[2073, 2867, 3525, 4164, 4572, 4919]",[4052],"[2073, 2867, 3525, 3881, 4164, 4572, 4919]",5498,7,5491,6,1,5490,1
5.5,HSLCATG,"[991, 1352, 1590, 2266, 2574, 5372, 5638, 6574]","[991, 2266, 2574]","[1352, 1590, 5372, 5638, 6574]","[991, 1881, 2076, 2266, 2574]",6893,8,6885,3,5,6883,2
5.5,HSMECDAG,"[716, 1393, 2517, 2584, 2593, 2776, 2966, 3170, 3202, 3852]","[1393, 2517, 2776, 2966, 3852]","[716, 2584, 2593, 3170, 3202]","[1393, 2517, 2776, 2966, 3544, 3852]",4362,10,4352,5,5,4351,1
5.5,HSMED,"[52, 636, 789, 1354, 1998]",[1354],"[52, 636, 789, 1998]","[1354, 1943, 2315, 4716]",5284,5,5279,1,4,5276,3
5.5,HSMT1H,"[816, 2125]",[816],[2125],"[816, 1475]",2134,2,2132,1,1,2131,1
5.5,HSNCAMX1,"[1550, 1609, 2245, 2486, 2537, 4142, 4190, 6582, 7569, 7640, 7852, 8529, 8552, 9373, 9522, 10015, 10317, 10722, 11726, 12072, 12550, 12786, 13049, 13893, 14002]","[1609, 4142, 6582, 7569, 7852, 8529, 9373, 10015, 10317, 10722, 12072, 12550, 12786, 13049, 13893, 14002]","[1550, 2245, 2486, 2537, 4190, 7640, 8552, 9522, 11726]","[1609, 4142, 4778, 5218, 6315, 6582, 6983, 7316, 7569, 7852, 8529, 8809, 9068, 9373, 9571, 10015, 10317, 10722, 11667, 12072, 12283, 12550, 12786, 13049, 13487, 13893, 14002]",16280,25,16255,16,9,16244,11
5.5,HSNFM,"[417, 432, 1822, 2675, 3849, 4491]","[1822, 2675]","[417, 432, 3849, 4491]","[1822, 2675]",6228,6,6222,2,4,6222,0
5.5,HSODCG,"[1002, 1938, 2912, 3745, 3968, 4649, 5028, 5421, 5633, 7111, 7614, 8052, 8090, 8842, 8854]","[4649, 5028, 5421, 5633, 7111, 7614]","[1002, 1938, 2912, 3745, 3968, 8052, 8090, 8842, 8854]","[4192, 4649, 5028, 5421, 5633, 5893, 7111, 7306, 7614]",9035,15,9020,6,9,9017,3
5.5,HSODF2,"[4, 158, 964, 993]",[],"[4, 158, 964, 993]",[600],1422,4,1418,0,4,1417,1
5.5,HSPAT133,"[393, 654, 794, 1173, 1447]",[1447],"[393, 654, 794, 1173]",[1447],3712,5,3707,1,4,3707,0
5.5,HSPLAPL,"[599, 827]","[599, 827]",[],"[403, 599, 827]",1274,2,1272,2,0,1271,1
5.5,HSPRB3L,"[566, 789, 2934]",[566],"[789, 2934]","[566, 1537]",4508,3,4505,1,2,4504,1
5.5,HSPRB4S,"[913, 1018, 2812, 2957]",[],"[913, 1018, 2812, 2957]","[693, 1658]",5805,4,5801,0,4,5799,2
5.5,HSPSAG,"[1848, 4044, 4080]","[1848, 4044]",[4080],"[447, 1848, 3764, 4044]",5865,3,5862,2,1,5860,2
5.5,HSRPII145,"[449, 588, 1181, 1233, 1535, 1688, 1729]","[449, 588, 1233]","[1181, 1535, 1688, 1729]","[449, 588, 908, 1071, 1233]",2085,7,2078,3,4,2076,2
5.5,HSRPS7,"[115, 404, 516, 1831, 2166, 2369, 2530, 3329, 4254, 5100, 5409, 6064, 6325, 6429]","[2166, 2369, 4254]","[115, 404, 516, 1831, 2530, 3329, 5100, 5409, 6064, 6325, 6429]","[2166, 2369, 3108, 4254, 6734]",7505,14,7491,3,11,7489,2
5.5,HSSAA1B,"[862, 1009, 1543, 2345, 2367, 4712, 4744]",[1543],"[862, 1009, 2345, 2367, 4712, 4744]","[1543, 3845]",4815,7,4808,1,6,4807,1
5.5,HSSHBG,"[1016, 1058, 2672, 3148]","[1058, 3148]","[1016, 2672]","[472, 696, 1058, 1551, 1938, 2205, 3148]",3802,4,3798,2,2,3793,5
5.5,HSSSPN1AG,"[2330, 3360, 3491]","[3360, 3491]",[2330],"[1343, 1635, 1809, 3360, 3491]",4088,3,4085,2,1,4082,3
5.5,HSSURF3,"[284, 1033, 1692, 2048, 2209, 2321, 2729, 3074]","[284, 1033, 1692, 2048, 2321, 2729, 3074]",[2209],"[284, 1033, 1692, 2048, 2321, 2729, 3074]",3407,8,3399,7,1,3399,0
5.5,HSTNFB,"[836, 1375, 3015]",[1375],"[836, 3015]","[1375, 1567]",3029,3,3026,1,2,3025,1
5.5,HSTPI1G,"[746, 919, 972, 1558, 1685, 1817, 2035, 3181, 4376, 4651]","[746, 2035, 3181]","[919, 972, 1558, 1685, 1817, 4376, 4651]","[746, 2035, 2231, 2438, 2821, 3181]",4987,10,4977,3,7,4974,3
5.5,HSTUBAG,"[536, 2065, 2287, 2584, 3733, 3759, 3843]","[536, 2287, 2584]","[2065, 3733, 3759, 3843]","[536, 2287, 2584]",4079,7,4072,3,4,4072,0
5.5,HSU01102,"[668, 817, 1671, 2568]",[668],"[817, 1671, 2568]","[668, 3896]",4987,4,4983,1,3,4982,1
5.5,HSU04357,"[97, 1201, 1342, 1963]","[97, 1342]","[1201, 1963]","[97, 1342]",2074,4,2070,2,2,2070,0
5.5,HSU04636,"[103, 1018, 1935, 2199, 2996, 4424, 5359, 5723, 6008]","[1018, 1935, 2199, 2996, 4424, 5359, 6008]","[103, 5723]","[1018, 1935, 2199, 2996, 3608, 4424, 4790, 5359, 6008]",9445,9,9436,7,2,9434,2
5.5,HSU05259,"[2091, 2173, 2435, 2685, 3045, 4128]","[2685, 3045, 4128]","[2091, 2173, 2435]","[782, 2685, 3045, 4128]",5662,6,5656,3,3,5655,1
5.5,HSU07807,"[454, 459, 757, 1040, 2736]",[757],"[454, 459, 1040, 2736]","[757, 3386]",4831,5,4826,1,4,4825,1
5.5,HSU07983,"[390, 1286]",[390],[1286],[390],1418,2,1416,1,1,1416,0
5.5,HSU08198,"[676, 707, 1072, 1124, 1316, 1689, 1811, 1900]","[1124, 1316, 1689, 1811]","[676, 707, 1072, 1900]","[583, 895, 1124, 1316, 1689, 1811]",2336,8,2328,4,4,2326,2
5.5,HSU12421,"[1400, 1941, 2080, 2255, 3573, 3747]",[2080],"[1400, 1941, 2255, 3573, 3747]","[311, 2080]",4250,6,4244,1,5,4243,1
5.5,HSUBR,"[1589, 2324]","[1589, 2324]",[],"[1589, 2324]",3287,2,3285,2,0,3285,0
5.5,HSXBXVIII,"[473, 1189, 2137, 2596, 3019, 3123, 3248, 3371, 3859, 4586, 5486, 6115, 6240, 7675, 9475, 10107, 10687, 11843, 11870, 12085]","[11843, 12085]","[473, 1189, 2137, 2596, 3019, 3123, 3248, 3371, 3859, 4586, 5486, 6115, 6240, 7675, 9475, 10107, 10687, 11870]","[11405, 11589, 11843, 12085]",12630,20,12610,2,18,12608,2
5.5,HSZNGP1,"[445, 518, 565, 2672, 6347, 8597]",[518],"[445, 565, 2672, 6347, 8597]","[518, 4718, 8313]",9815,6,9809,1,5,9807,2
5.5,HUMADAG,"[1309, 1355, 1677, 2405, 3737, 4817, 5267, 5278, 5341, 5657, 11568, 13458, 14450, 18465, 19292, 19529, 20776, 21114, 23808, 24224, 24752, 26467, 29419, 29939, 30860, 31115, 31304, 32497, 32675, 32916, 33952, 34484, 35203]","[19292, 26467, 29939, 31304, 32497, 32675, 32916, 34484, 35203]","[1309, 1355, 1677, 2405, 3737, 4817, 5267, 5278, 5341, 5657, 11568, 13458, 14450, 18465, 19529, 20776, 21114, 23808, 24224, 24752, 29419, 30860, 31115, 33952]","[4064, 19292, 26467, 29052, 29939, 31304, 32497, 32675, 32916, 34484, 35203]",36733,33,36700,9,24,36698,2
5.5,HUMADPRF02,"[1308, 1650, 3035, 3392, 4213, 4870, 5150]","[1308, 1650]","[3035, 3392, 4213, 4870, 5150]","[359, 1308, 1650]",5159,7,5152,2,5,5151,1
5.5,HUMAPEXN,"[349, 1465, 1535, 1863]","[1465, 1863]","[349, 1535]","[1465, 1863, 2622]",3722,4,3718,2,2,3717,1
5.5,HUMAPOCII,"[184, 547, 571, 1557, 1778, 2995, 3223]",[2995],"[184, 547, 571, 1557, 1778, 3223]","[2995, 3321]",4332,7,4325,1,6,4324,1
5.5,HUMAPOE4,"[1091, 1914, 3200]","[1914, 3200]",[1091],"[1914, 3200]",5507,3,5504,2,1,5504,0
5.5,HUMATPGG,"[1445, 1902, 4293, 5307, 6534, 6749, 7456, 7885, 9672, 10406, 14100]","[1445, 1902, 4293, 5307, 6534, 6749, 7456, 9672, 14100]","[7885, 10406]","[1445, 1727, 1902, 2677, 4293, 4749, 5307, 6118, 6534, 6749, 7456, 8198, 9436, 9672, 9946, 10190, 11405, 12074, 13663, 14100, 14276]",15107,11,15096,9,2,15084,12
5.5,HUMBETGLOA,"[376, 687, 1311, 2559]",[1311],"[376, 687, 2559]","[958, 1311]",2994,4,2990,1,3,2989,1
5.5,HUMBETGLOB,"[374, 685, 1309, 2557]",[1309],"[374, 685, 2557]","[956, 1309]",2992,4,2988,1,3,2987,1
5.5,HUMBETGLOC,"[376, 687, 1311, 2559]",[1311],"[376, 687, 2559]","[958, 1311]",2994,4,2990,1,3,2989,1
5.5,HUMBETGLOD,"[376, 687, 1311, 2559]",[1311],"[376, 687, 2559]","[958, 1311]",2994,4,2990,1,3,2989,1
5.5,HUMBETGLOE,"[374, 685, 1309, 2557]",[1309],"[374, 685, 2557]","[956, 1309]",2992,4,2988,1,3,2987,1
5.5,HUMBETGLOF,"[376, 687, 1311, 2559]",[1311],"[376, 687, 2559]","[958, 1311]",2994,4,2990,1,3,2989,1
5.5,HUMBETGLOG,"[376, 687, 1311, 2559]",[1311],"[376, 687, 2559]","[958, 1311]",2994,4,2990,1,3,2989,1
5.5,HUMBETGLOH,"[376, 687, 1311, 2559]",[1311],"[376, 687, 2559]","[958, 1311]",2994,4,2990,1,3,2989,1
5.5,HUMBETGLOI,"[374, 685, 1309, 2557]",[1309],"[374, 685, 2557]","[956, 1309]",2992,4,2988,1,3,2987,1
5.5,HUMBETGLOJ,"[374, 685, 1309, 2557]",[1309],"[374, 685, 2557]","[956, 1309]",2992,4,2988,1,3,2987,1
5.5,HUMBETGLOK,"[374, 685, 1309, 2557]",[1309],"[374, 685, 2557]","[956, 1309]",2992,4,2988,1,3,2987,1
5.5,HUMBETGLOL,"[374, 685, 1309, 2557]",[1309],"[374, 685, 2557]","[956, 1309]",2992,4,2988,1,3,2987,1
5.5,HUMBETGLOM,"[373, 684, 1308, 2556]",[1308],"[373, 684, 2556]","[955, 1308]",2991,4,2987,1,3,2986,1
5.5,HUMBETGLON,"[374, 685, 1309, 2557]",[1309],"[374, 685, 2557]","[956, 1309]",2992,4,2988,1,3,2987,1
5.5,HUMBETGLOO,"[374, 685, 1309, 2557]",[1309],"[374, 685, 2557]","[956, 1309]",2992,4,2988,1,3,2987,1
5.5,HUMBETGLOP,"[374, 685, 1309, 2557]",[1309],"[374, 685, 2557]","[956, 1309]",2992,4,2988,1,3,2987,1
5.5,HUMBETGLOR,"[374, 685, 1309, 2557]",[1309],"[374, 685, 2557]","[956, 1309]",2992,4,2988,1,3,2987,1
5.5,HUMCBRG,[1220],[1220],[],"[567, 1220]",3318,1,3317,1,0,3316,1
5.5,HUMCHYMASE,"[969, 5216, 6037, 7220, 7463]","[5216, 6037]","[969, 7220, 7463]","[5216, 6037, 6922, 7363]",8107,5,8102,2,3,8100,2
5.5,HUMCP21OH,"[947, 1571, 1970, 2528, 3094]","[947, 1571, 1970, 2528, 3094]",[],"[947, 1134, 1571, 1780, 1970, 2158, 2528, 2907, 3094]",4034,5,4029,5,0,4025,4
5.5,HUMCP21OHC,"[948, 1572, 1971, 2529, 3096]","[948, 1572, 1971, 2529, 3096]",[],"[948, 1135, 1572, 1781, 1971, 2159, 2529, 2908, 3096]",4036,5,4031,5,0,4027,4
5.5,HUMCS1,"[310, 565, 669, 1334]","[565, 1334]","[310, 669]","[565, 991, 1334, 1591]",2293,4,2289,2,2,2287,2
5.5,HUMCS3,"[312, 566, 671, 1334, 2520]","[566, 1334]","[312, 671, 2520]","[566, 991, 1334, 1588]",2732,5,2727,2,3,2725,2
5.5,HUMCSN2A,"[122, 3194, 4855, 5620, 5747, 7789, 8805, 9482]","[4855, 5747]","[122, 3194, 5620, 7789, 8805, 9482]","[4855, 5747, 6747, 6887, 8522]",10600,8,10592,2,6,10589,3
5.5,HUMCSPA,"[982, 2276, 2929, 3200, 3691]","[982, 2276, 2929]","[3200, 3691]","[982, 2276, 2929, 3392]",4783,5,4778,3,2,4777,1
5.5,HUMCTLA1,"[988, 1812, 2179, 2770, 3041, 3236, 3532]","[988, 2179, 2770, 3236]","[1812, 3041, 3532]","[988, 2179, 2770, 3236]",4520,7,4513,4,3,4513,0
5.5,HUMDEF5A,"[1571, 2601]",[1571],[2601],[1571],2872,2,2870,1,1,2870,0
5.5,HUMDZA2G,"[5316, 5389, 5436, 7542, 11212, 13467]",[5389],"[5316, 5436, 7542, 11212, 13467]","[5389, 9590, 13183]",14686,6,14680,1,5,14678,2
5.5,HUMELAFIN,"[326, 1461]",[326],[1461],[326],1870,2,1868,1,1,1868,0
5.5,HUMEPOHYDD,"[2289, 5656, 6422, 6542, 8696, 9045, 11832, 12105, 12409, 13804, 13924, 16085, 16775, 19204, 20683, 20857, 20883, 20979, 20994, 21354, 22952, 23010, 24469]","[5656, 8696, 16085, 16775, 19204, 21354]","[2289, 6422, 6542, 9045, 11832, 12105, 12409, 13804, 13924, 20683, 20857, 20883, 20979, 20994, 22952, 23010, 24469]","[5656, 8696, 15620, 16085, 16775, 19204, 21354]",24782,23,24759,6,17,24758,1
5.5,HUMG0S24B,[631],[631],[],[631],3127,1,3126,1,0,3126,0
5.5,HUMG0S8PP,"[2682, 3768, 3932, 4646]","[2682, 3768, 3932, 4646]",[],"[2682, 3768, 3932, 4646]",7337,4,7333,4,0,7333,0
5.5,HUMGAD45A,"[2457, 2596, 2968, 3184, 3645, 3880]","[2596, 3184, 3645]","[2457, 2968, 3880]","[2596, 3184, 3645]",5370,6,5364,3,3,5364,0
5.5,HUMGARE,"[810, 1467, 2653, 3207, 4469]","[810, 2653]","[1467, 3207, 4469]","[810, 2239, 2653, 3118]",4746,5,4741,2,3,4739,2
5.5,HUMGCK,"[1989, 3799, 3882, 5808, 6475]","[3882, 6475]","[1989, 3799, 5808]","[1188, 3360, 3882, 4312, 4806, 5015, 5452, 5964, 6475]",7519,5,7514,2,3,7507,7
5.5,HUMGFP40H,"[910, 1058, 1846, 2593, 3126, 4025]","[910, 1058, 2593]","[1846, 3126, 4025]","[910, 1058, 1173, 2593]",4371,6,4365,3,3,4364,1
5.5,HUMGHG,"[689, 1983, 2636, 2907, 3398]","[689, 1983, 2636]","[2907, 3398]","[689, 1983, 2636, 3099]",4444,5,4439,3,2,4438,1
5.5,HUMGHN,"[569, 673, 1316]","[569, 1316]",[673],"[569, 989, 1316, 1574]",2649,3,2646,2,1,2644,2
5.5,HUMGHV,"[432, 566, 2485]",[566],"[432, 2485]","[566, 998, 1328, 1584]",2652,3,2649,1,2,2646,3
5.5,HUMGSTM4A,"[777, 1272, 1844, 3023, 4760]",[777],"[1272, 1844, 3023, 4760]","[777, 1139, 1631, 2024, 2225, 3262, 3463]",6074,5,6069,1,4,6063,6
5.5,HUMHMGIY,"[1075, 1472, 4627, 4660, 5150, 5496, 6544, 7133, 7166, 7270, 8043, 9286, 9390, 10022]","[4660, 6544, 7270]","[1075, 1472, 4627, 5150, 5496, 7133, 7166, 8043, 9286, 9390, 10022]","[4660, 6544, 7270]",10098,14,10084,3,11,10084,0
5.5,HUMHOX13G,[380],[],[380],[811],3062,1,3061,0,1,3060,1
5.5,HUMHPARS1,"[1046, 1300, 2632, 3020, 3855, 4744, 5577, 7692, 8728, 9649, 9904, 11385]","[1046, 2632, 3020, 3855, 4744, 5577]","[1300, 7692, 8728, 9649, 9904, 11385]","[1046, 2632, 3020, 3855, 4744, 5577]",11543,12,11531,6,6,11531,0
5.5,HUMIBP3,"[1409, 2441, 2457, 2845, 2935, 3142, 3356, 3924, 4247, 4304, 4358, 4406, 4924, 6617, 8353, 8677]","[2441, 6617]","[1409, 2457, 2845, 2935, 3142, 3356, 3924, 4247, 4304, 4358, 4406, 4924, 8353, 8677]","[2441, 5953, 6617]",10876,16,10860,2,14,10859,1
5.5,HUMIDS,"[1972, 2038, 2376, 4119, 4174, 4778, 5244, 5385, 5850, 8364, 9161, 11397, 14418, 14655, 15879, 15901, 18552, 18689, 21930, 22809, 23494, 25810, 29400, 30410, 31004, 32099, 34645, 35761]","[2038, 5244, 15879]","[1972, 2376, 4119, 4174, 4778, 5385, 5850, 8364, 9161, 11397, 14418, 14655, 15901, 18552, 18689, 21930, 22809, 23494, 25810, 29400, 30410, 31004, 32099, 34645, 35761]","[1160, 2038, 2882, 5244, 8086, 9847, 15879, 19268]",36837,28,36809,3,25,36804,5
5.5,HUMIGERA,"[68, 1342, 1797, 2173, 3105, 4527, 4792, 5168]","[1342, 1797, 3105, 5168]","[68, 2173, 4527, 4792]","[1342, 1797, 3105, 5168]",7651,8,7643,4,4,7643,0
5.5,HUMIL2RGA,"[231, 772, 840, 1476, 1646, 1980, 3031, 3126, 3353]","[1476, 3031, 3353]","[231, 772, 840, 1646, 1980, 3126]","[203, 735, 1128, 1476, 2402, 3031, 3353]",4030,9,4021,3,6,4017,4
5.5,HUMIL4A,"[1306, 1626, 3234, 3254, 7433, 8407, 8466]","[1306, 1626]","[3234, 3254, 7433, 8407, 8466]","[1306, 1626, 7003]",9892,7,9885,2,5,9884,1
5.5,HUMIRBPG,"[786, 1819, 3181, 3550, 4672, 5069, 6592, 7160]","[3181, 7160]","[786, 1819, 3550, 4672, 5069, 6592]","[3181, 5157, 7160]",9703,8,9695,2,6,9694,1
5.5,HUMLHDC,"[166, 1727, 3070, 6016, 7415, 10512, 11221, 11774, 12354, 13017, 14169, 14605, 18382, 18464, 18855, 19921, 20300, 20482, 22046, 22140, 23463, 30438, 31819]","[7415, 14605, 18382, 20300, 20482]","[166, 1727, 3070, 6016, 10512, 11221, 11774, 12354, 13017, 14169, 18464, 18855, 19921, 22046, 22140, 23463, 30438, 31819]","[7415, 9773, 14605, 15584, 18382, 18782, 19312, 20300, 20482, 24666, 29773]",32343,23,32320,5,18,32314,6
5.5,HUMLUCT,"[1550, 2861]","[1550, 2861]",[],"[1550, 2505, 2861]",3288,2,3286,2,0,3285,1
5.5,HUMLYTOXBB,"[1235, 1357, 2934, 5345, 6032]",[2934],"[1235, 1357, 5345, 6032]","[2934, 3376, 3631]",6297,5,6292,1,4,6290,2
5.5,HUMMCHEMP,"[159, 674, 1590]","[674, 1590]",[159],"[674, 1590]",2756,3,2753,2,1,2753,0
5.5,HUMMET2,"[866, 1233]","[866, 1233]",[],"[866, 1233]",1695,2,1693,2,0,1693,0
5.5,HUMMGPA,"[3516, 3748, 4493, 7617]",[3516],"[3748, 4493, 7617]","[3516, 5093, 6334]",7726,4,7722,1,3,7720,2
5.5,HUMMIF,"[753, 1643]",[1643],[753],"[1281, 1643]",2159,2,2157,1,1,2156,1
5.5,HUMMIS,"[623, 1887]","[623, 1887]",[],"[623, 1358, 1639, 1887]",3092,2,3090,2,0,3088,2
5.5,HUMMKXX,"[1168, 2463, 2985]",[],"[1168, 2463, 2985]","[1415, 1737, 2019]",3300,3,3297,0,3,3294,3
5.5,HUMNKG5PRO,"[1055, 2262, 2639, 3215, 3848, 5468]","[2262, 3215, 3848, 5468]","[1055, 2639]","[2262, 3215, 3848, 5468]",6738,6,6732,4,2,6732,0
5.5,HUMNTRI,"[2145, 2802, 3141, 3151]",[2802],"[2145, 3141, 3151]",[2802],3702,4,3698,1,3,3698,0
5.5,HUMNTRIII,"[2145, 2802, 3141, 3151]",[2802],"[2145, 3141, 3151]",[2802],3702,4,3698,1,3,3698,0
5.5,HUMOSTP,"[214, 3509, 3657, 6420, 6986, 7897, 8035, 10776]","[3509, 3657, 6986]","[214, 6420, 7897, 8035, 10776]","[3509, 3657, 6679, 6986, 8349]",10714,8,10706,3,5,10704,2
5.5,HUMPAP,"[1012, 1410, 1970, 2089, 3167, 3342, 4164]","[1410, 2089, 3167]","[1012, 1970, 3342, 4164]","[1410, 2089, 2414, 3167]",4489,7,4482,3,4,4481,1
5.5,HUMPCI,"[1538, 2078, 2226, 2812, 3307, 3575, 4697, 5543, 7199, 8568, 8725, 11483, 14117, 14247]","[8568, 11483]","[1538, 2078, 2226, 2812, 3307, 3575, 4697, 5543, 7199, 8725, 14117, 14247]","[8568, 10898, 11483]",15563,14,15549,2,12,15548,1
5.5,HUMPEM,"[934, 1033, 2266, 2707, 2973, 3203, 3297, 3904]","[934, 2266, 2707, 2973, 3203]","[1033, 3297, 3904]","[934, 2266, 2421, 2707, 2973, 3203]",4235,8,4227,5,3,4226,1
5.5,HUMPEPYYA,"[727, 1201, 1307, 1824]",[1201],"[727, 1307, 1824]","[1201, 1388]",2370,4,2366,1,3,2365,1
5.5,HUMPF4V1A,"[11, 199, 381, 826]","[381, 826]","[11, 199]","[381, 826]",1460,4,1456,2,2,1456,0
5.5,HUMPHOSA,"[233, 850, 1494, 1555, 1810, 3209]","[233, 850, 1494, 1810, 3209]",[1555],"[233, 850, 1494, 1810, 2323, 2988, 3209, 3729]",4884,6,4878,5,1,4875,3
5.5,HUMPRCA,"[130, 684, 1687, 2309, 2354, 3438, 4175, 5118, 5348, 5452, 5585, 10977, 11461]","[5118, 5348, 5585]","[130, 684, 1687, 2309, 2354, 3438, 4175, 5452, 10977, 11461]","[2201, 3631, 5118, 5348, 5585, 8396, 9387]",11717,13,11704,3,10,11700,4
5.5,HUMPREELAS,"[596, 1729]",[596],[1729],[596],2291,2,2289,1,1,2289,0
5.5,HUMPRPHX,"[1143, 1475, 1838, 2127, 2502, 2869, 3173, 3322, 3633]","[1838, 2127, 2869, 3173, 3322, 3633]","[1143, 1475, 2502]","[1346, 1838, 2127, 2652, 2869, 3173, 3322, 3633]",4524,9,4515,6,3,4513,2
5.5,HUMRCC1,"[638, 654, 2711, 4304, 4379, 4555, 4733, 5210, 5479, 5741, 7271, 11134, 12573, 13360, 14368, 14697, 15440, 15532, 16316, 16526, 20918, 22033, 24201, 26218, 26579, 26701, 26808, 28010, 28244, 28523, 29247, 29766]","[24201, 26218, 26579, 28010, 28244, 29247, 29766]","[638, 654, 2711, 4304, 4379, 4555, 4733, 5210, 5479, 5741, 7271, 11134, 12573, 13360, 14368, 14697, 15440, 15532, 16316, 16526, 20918, 22033, 26701, 26808, 28523]","[24201, 26218, 26579, 28010, 28244, 28893, 29247, 29766]",34633,32,34601,7,25,34600,1
5.5,HUMREGHOM,"[52, 274, 684, 1419, 1864, 1909, 2739, 2825]","[684, 1419, 1864, 2739]","[52, 274, 1909, 2825]","[684, 1419, 1864, 2739]",3403,8,3395,4,4,3395,0
5.5,HUMROD1X,[1876],[1876],[],"[1242, 1876]",2833,1,2832,1,0,2831,1
5.5,HUMRPIB2,"[899, 1121, 1531, 2268, 2713, 2758, 3588, 3674]","[1531, 2268, 2713, 3588]","[899, 1121, 2758, 3674]","[1531, 2268, 2713, 3588]",4329,8,4321,4,4,4321,0
5.5,HUMRPS6B,"[359, 1168, 1838, 4432]","[359, 1838]","[1168, 4432]","[359, 1059, 1838, 2178, 4051]",4964,4,4960,2,2,4957,3
5.5,HUMSEMI,"[793, 806, 2547, 2979, 3496]",[793],"[806, 2547, 2979, 3496]",[793],4156,5,4151,1,4,4151,0
5.5,HUMSEMIIB,"[493, 1316, 2616, 4486, 4499, 4667, 5820, 6304, 6446, 7146]",[4486],"[493, 1316, 2616, 4499, 4667, 5820, 6304, 6446, 7146]",[4486],8216,10,8206,1,9,8206,0
5.5,HUMSTATH2,"[1553, 2025, 2848]",[1553],"[2025, 2848]","[353, 1553, 1675]",4715,3,4712,1,2,4710,2
5.5,HUMTBGA,"[854, 1021, 2681, 4941, 5164, 6314, 7144, 7395, 8362]","[4941, 7144]","[854, 1021, 2681, 5164, 6314, 7395, 8362]","[4941, 6265, 7144]",8761,9,8752,2,7,8751,1
5.5,HUMTCRBRA,[278],[278],[],[278],728,1,727,1,0,727,0
5.5,HUMTHROMA,"[159, 787, 1985, 2344, 2384, 2717, 4817, 5134, 5715]","[1985, 2344, 2717, 4817]","[159, 787, 2384, 5134, 5715]","[1985, 2344, 2717, 4817]",6155,9,6146,4,5,6146,0
5.5,HUMTNP2SS,[86],[],[86],[658],1774,1,1773,0,1,1772,1
5.5,HUMTPALBU,"[2741, 4587]",[2741],[4587],"[1094, 1621, 2741, 3425, 4361]",6164,2,6162,1,1,6158,4
5.5,HUMTRHYAL,"[201, 1645, 2232, 6019, 6556]",[1645],"[201, 2232, 6019, 6556]",[1645],9543,5,9538,1,4,9538,0
5.5,HUMTSHB2,"[187, 780]",[187],[780],[187],978,2,976,1,1,976,0
5.5,HUMV2R,"[261, 1366, 1507, 2128]","[261, 1507]","[1366, 2128]","[261, 1507]",2274,4,2270,2,2,2270,0
5.5,HYPSCGH,"[41, 806, 1624]","[41, 1624]",[806],"[41, 451, 1039, 1624]",2476,3,2473,2,1,2471,2
5.5,LAYEGLOBIN,"[238, 584, 1185]","[238, 584]",[1185],"[238, 584]",1694,3,1691,2,1,1691,0
5.5,LEBGLOB,"[94, 157, 1501, 1926]",[1926],"[94, 157, 1501]","[1577, 1926]",3638,4,3634,1,3,3633,1
5.5,LNOEGLOBIN,"[236, 587, 1185]","[236, 587]",[1185],"[236, 587]",1690,3,1687,2,1,1687,0
5.5,MACHBGA1,"[283, 495, 841]","[495, 841]",[283],"[495, 841]",2097,3,2094,2,1,2094,0
5.5,MACHBGA2,"[281, 493, 839]","[493, 839]",[281],"[493, 839]",2100,3,2097,2,1,2097,0
5.5,MAMGLUTRA,"[484, 2406, 3175, 4252, 5131]",[484],"[2406, 3175, 4252, 5131]","[484, 821, 1255, 1627, 1819, 2745, 2938]",6287,5,6282,1,4,6276,6
5.5,MAU09941,"[1031, 1166, 1830, 2427, 2667, 3134]",[1830],"[1031, 1166, 2427, 2667, 3134]",[1830],3798,6,3792,1,5,3792,0
5.5,MFAPOA2A,"[226, 379, 587, 785, 1422]","[379, 785]","[226, 587, 1422]","[379, 785]",1489,5,1484,2,3,1484,0
5.5,MFAPOC3A,"[1239, 2232]",[],"[1239, 2232]","[913, 1172]",3254,2,3252,0,2,3250,2
5.5,MMA2IXCOA,"[859, 878, 1757, 1812, 3132, 4386, 5665, 5682, 5831, 6355, 6930, 7102, 7250, 7371, 7658, 7684, 8064, 8539, 8882, 9322, 9467, 9609, 9626, 10270, 10304, 13033, 13111, 13447, 13726, 14575, 15021, 15597, 15933, 16114, 16240, 16522, 16811, 17275, 18283]","[3132, 4386, 5682, 5831, 7102, 7250, 7371, 7684, 8064, 8539, 8882, 9322, 9467, 9626, 13033, 13447, 13726, 14575, 15021, 15597, 15933, 16114, 16240, 16522, 16811, 17275]","[859, 878, 1757, 1812, 5665, 6355, 6930, 7658, 9609, 10270, 10304, 13111, 18283]","[3132, 4386, 5682, 5831, 7102, 7250, 7371, 7684, 8064, 8216, 8401, 8539, 8882, 9322, 9467, 9626, 13033, 13447, 13726, 14575, 15021, 15338, 15597, 15746, 15933, 16114, 16240, 16522, 16811, 17275, 17647]",19471,39,19432,26,13,19427,5
5.5,MMACLGNA,"[1458, 3107, 3178]",[3178],"[1458, 3107]","[474, 3178]",3873,3,3870,1,2,3869,1
5.5,MMAPOG,"[265, 536]",[536],[265],"[536, 806]",2168,2,2166,1,1,2165,1
5.5,MMASM1G,"[1088, 3245, 3367, 3599, 3745]","[1088, 3245, 3745]","[3367, 3599]","[1088, 2244, 2928, 3245, 3745]",4767,5,4762,3,2,4760,2
5.5,MMCASEIB,"[2857, 4901, 4916, 5615, 7023, 7160, 7964, 10443, 11758, 11838, 13000]","[7023, 7160]","[2857, 4901, 4916, 5615, 7964, 10443, 11758, 11838, 13000]","[6252, 7023, 7160, 8126, 8252, 9803]",13046,11,13035,2,9,13031,4
5.5,MMCD24A,"[233, 2486, 3805, 7063]",[2486],"[233, 3805, 7063]",[2486],7632,4,7628,1,3,7628,0
5.5,MMCFOS,"[844, 1850, 2363, 3414]","[844, 1850, 2363]",[3414],"[844, 1850, 2363]",3959,4,3955,3,1,3955,0
5.5,MMCOL10A,"[560, 1070, 1518, 1802, 1964, 5660, 6146, 6371, 6704, 7009, 9322]",[1802],"[560, 1070, 1518, 1964, 5660, 6146, 6371, 6704, 7009, 9322]",[1802],9323,11,9312,1,10,9312,0
5.5,MMCRPG,[],[],[],[375],2132,0,2132,0,0,2131,1
5.5,MMCYTOKNA,"[810, 1881]",[810],[1881],"[810, 1559]",2551,2,2549,1,1,2548,1
5.5,MMDM2RR,"[665, 854, 878, 1651, 1846, 2702, 3378, 3701, 3962, 4663, 4925, 6030]","[665, 854, 1651, 2702, 3701, 3962, 4925]","[878, 1846, 3378, 4663, 6030]","[665, 854, 1305, 1651, 2702, 3701, 3962, 4925, 5134]",6632,12,6620,7,5,6618,2
5.5,MMDNAASFA,"[542, 855, 1497, 1576, 2357]","[855, 1576, 2357]","[542, 1497]","[855, 1241, 1576, 1823, 2135, 2357, 2695]",4307,5,4302,3,2,4298,4
5.5,MMEZGL,"[1276, 1599]",[1599],[1276],"[589, 1599]",1945,2,1943,1,1,1942,1
5.5,MMG37,"[788, 2570, 2771]","[788, 2570]",[2771],"[332, 788, 1303, 2119, 2363, 2570]",3065,3,3062,2,1,3058,4
5.5,MMGBCRYA,"[671, 1003]","[671, 1003]",[],"[671, 1003]",2653,2,2651,2,0,2651,0
5.5,MMGCCRYA,"[721, 1056, 1790, 2488]","[721, 1056]","[1790, 2488]","[721, 1056]",2884,4,2880,2,2,2880,0
5.5,MMGFAPD,"[1901, 3473, 4335, 7253, 7902, 7907, 8227, 9788]","[1901, 4335, 7907]","[3473, 7253, 7902, 8227, 9788]","[713, 1624, 1901, 2995, 3906, 4335, 5452, 7907]",9963,8,9955,3,5,9950,5
5.5,MMGGLINE,"[204, 2076, 2288, 2634, 4813, 6374, 6955, 7167, 7513, 8852, 9179]","[7167, 7513]","[204, 2076, 2288, 2634, 4813, 6374, 6955, 8852, 9179]","[7167, 7513]",11278,11,11267,2,9,11267,0
5.5,MMGK5,"[2825, 3525]",[2825],[3525],"[695, 1805, 2595, 2825]",3602,2,3600,1,1,3597,3
5.5,MMH2D4Q5,"[159, 644]","[159, 644]",[],"[159, 644]",1100,2,1098,2,0,1098,0
5.5,MMHOX13,"[369, 1037, 1570]",[],"[369, 1037, 1570]",[800],2827,3,2824,0,3,2823,1
5.5,MMHOX24I,"[837, 1264]",[837],[1264],[837],1915,2,1913,1,1,1913,0
5.5,MMIL1BG,"[572, 1356, 1567, 1803, 1938, 4398, 5679]","[1356, 1938, 4398, 5679]","[572, 1567, 1803]","[1356, 1938, 3680, 4398, 5679]",7092,7,7085,4,3,7084,1
5.5,MMIL3G,"[129, 686, 1913, 2090, 2583]","[686, 1913, 2090]","[129, 2583]","[686, 824, 1913, 2090]",3482,5,3477,3,2,3476,1
5.5,MMIL5G,"[1593, 3597, 5303, 5441]","[1593, 3597]","[5303, 5441]","[731, 1593, 3597]",6719,4,6715,2,2,6714,1
5.5,MMKFGF,"[542, 1045, 1337, 1556, 2484, 2886]","[542, 1045]","[1337, 1556, 2484, 2886]","[542, 1045]",3981,6,3975,2,4,3975,0
5.5,MMLDHAG,"[105, 2774, 4377, 4577, 4824, 5333, 7171, 7208, 7338, 7668, 8206, 8315, 8402, 8597, 11532]","[4577, 7171, 7668, 8597]","[105, 2774, 4377, 4824, 5333, 7208, 7338, 8206, 8315, 8402, 11532]","[4577, 5919, 7171, 7668, 8597, 10704]",12843,15,12828,4,11,12826,2
5.5,MMMMP9A,"[1890, 2008, 2375, 2781, 3945, 4206, 4321, 4864, 5695, 6356, 6564, 7752]","[2008, 2375, 2781, 3945, 4206, 5695, 6356, 6564]","[1890, 4321, 4864, 7752]","[1341, 2008, 2375, 2781, 3064, 3418, 3945, 4206, 5695, 5936, 6356, 6564]",8182,12,8170,8,4,8166,4
5.5,MMMRPS24,"[404, 1460, 3137, 3934]","[404, 1460, 3137]",[3934],"[404, 1460, 1761, 3137]",5491,4,5487,3,1,5486,1
5.5,MMMTIX,[402],[402],[],"[402, 951]",1552,1,1551,1,0,1550,1
5.5,MMMUPBS6,"[731, 2045, 2425, 3236]","[731, 2045, 3236]",[2425],"[731, 1203, 2045, 2793, 3236]",4614,4,4610,3,1,4608,2
5.5,MMMYCL,"[919, 1787, 6752, 7565, 8161]",[1787],"[919, 6752, 7565, 8161]",[1787],8308,5,8303,1,4,8303,0
5.5,MMNFMG,"[1634, 4409, 4619, 4804]",[1634],"[4409, 4619, 4804]","[1634, 2540]",5463,4,5459,1,3,5458,1
5.5,MMNMYC,[1163],[1163],[],[1163],4799,1,4798,1,0,4798,0
5.5,MMNUCLEO,"[784, 863, 2042, 3040, 3141, 3984, 4071, 4293, 4879, 5198, 6230, 8122, 8928, 10436, 10506]","[2042, 3141, 4293, 4879, 5198, 6230, 8122, 10436]","[784, 863, 3040, 3984, 4071, 8928, 10506]","[2042, 3141, 4293, 4694, 4879, 5198, 6230, 7517, 8122, 8738, 9050, 9881, 10436]",11470,15,11455,8,7,11450,5
5.5,MMODC2,"[737, 1053, 1374, 2508, 2523, 2702, 2999, 3433]","[737, 1053, 1374, 2508, 2702, 2999]","[2523, 3433]","[331, 737, 1053, 1374, 1557, 1801, 2508, 2702, 2999]",4252,8,4244,6,2,4241,3
5.5,MMOESTEOP,"[510, 993, 1127, 2605, 2821, 4834]","[993, 1127, 2821]","[510, 2605, 4834]","[993, 1127, 2283, 2821, 4101]",5774,6,5768,3,3,5766,2
5.5,MMPO,"[324, 475, 561, 1709, 2446, 3054, 3728, 3749, 6901, 7167, 7842, 8043, 8109, 8907, 9903]","[2446, 3728, 7167, 8907, 9903]","[324, 475, 561, 1709, 3054, 3749, 6901, 7842, 8043, 8109]","[2193, 2446, 2948, 3503, 3728, 4018, 4769, 7167, 8440, 8907, 9903]",11905,15,11890,5,10,11884,6
5.5,MMPPSOMA,"[562, 722, 1034, 1208, 1248, 2049]",[1034],"[562, 722, 1208, 1248, 2049]",[1034],2556,6,2550,1,5,2550,0
5.5,MMPROP2,[],[],[],[289],712,0,712,0,0,711,1
5.5,MMPROT1,"[312, 759]",[759],[312],[759],1178,2,1176,1,1,1176,0
5.5,MMPROT2,"[508, 1218]",[1218],[508],[1218],1568,2,1566,1,1,1566,0
5.5,MMSAP,[441],[441],[],[441],1868,1,1867,1,0,1867,0
5.5,MMSCIMIP,"[415, 1017]","[415, 1017]",[],"[415, 1017]",1980,2,1978,2,0,1978,0
5.5,MMSYNDE1A,"[1345, 1483, 1992, 2151, 5772, 6256, 8442, 9076, 9867, 10903, 11397, 11583, 11858, 13851, 14080, 15172, 15299, 15845, 17647, 19009, 19542, 19726, 19767, 20385, 20735, 20942, 22120, 22802, 23203]","[1345, 19009, 20385, 20942]","[1483, 1992, 2151, 5772, 6256, 8442, 9076, 9867, 10903, 11397, 11583, 11858, 13851, 14080, 15172, 15299, 15845, 17647, 19542, 19726, 19767, 20735, 22120, 22802, 23203]","[1345, 19009, 20385, 20942]",23592,29,23563,4,25,23563,0
5.5,MMTHY1G,[1009],[1009],[],"[80, 1009]",2682,1,2681,1,0,2680,1
5.5,MMTLAC,"[299, 748, 1171, 4373]","[299, 748, 1171]",[4373],"[299, 748, 1171, 3092, 3338]",5239,4,5235,3,1,5233,2
5.5,MMTNFBG,"[1196, 1553, 1728]",[1728],"[1196, 1553]","[1728, 1911]",3211,3,3208,1,2,3207,1
5.5,MMTROPIB,"[183, 1749, 1832, 1932, 2033, 4580, 4604, 4748]","[1932, 4604]","[183, 1749, 1832, 2033, 4580, 4748]","[1697, 1932, 2185, 2656, 3037, 3564, 4604]",5683,8,5675,2,6,5670,5
5.5,MMTUM198,"[120, 2818, 3313, 3587, 3818, 4220]","[2818, 3313, 3587, 3818]","[120, 4220]","[1692, 2818, 3098, 3313, 3587, 3818, 4180]",4376,6,4370,4,2,4367,3
5.5,MMU01530,"[1357, 1589, 3231, 4904]",[3231],"[1357, 1589, 4904]","[3094, 3231]",6694,4,6690,1,3,6689,1
5.5,MMU02278,[],[],[],[1638],3973,0,3973,0,0,3972,1
5.5,MMU02298,"[1180, 2413, 2874, 3116, 3911, 4749, 4897]","[1180, 2413]","[2874, 3116, 3911, 4749, 4897]","[1180, 2413]",5851,7,5844,2,5,5844,0
5.5,MMU02884,"[814, 1630, 5244, 6836, 7567]","[1630, 5244, 6836]","[814, 7567]","[1630, 5244, 6836]",8757,5,8752,3,2,8752,0
5.5,MMU04056,"[186, 901, 1382, 1461, 2711, 2747, 2902, 3530, 4688, 6264, 7683, 8680, 10876, 14615, 15270, 15417, 15870, 16230, 16348, 16710, 18100, 20602, 21185]","[1382, 3530, 4688, 10876, 16230]","[186, 901, 1461, 2711, 2747, 2902, 6264, 7683, 8680, 14615, 15270, 15417, 15870, 16348, 16710, 18100, 20602, 21185]","[1382, 3530, 4688, 7979, 8895, 10317, 10876, 11259, 12211, 13491, 16230, 16561]",21710,23,21687,5,18,21680,7
5.5,MMU04827,"[105, 2280, 4281, 4301, 4969, 5675]","[4281, 4969]","[105, 2280, 4301, 5675]","[3684, 4281, 4969]",7600,6,7594,2,4,7593,1
5.5,MMU07568,"[84, 267, 482, 527]","[84, 267, 482]",[527],"[84, 267, 482]",743,4,739,3,1,739,0
5.5,MMU07808,"[61, 547, 673, 1697]","[673, 1697]","[61, 547]","[673, 1697]",2840,4,2836,2,2,2836,0
5.5,MMU09741,"[245, 1094, 1230]","[245, 1230]",[1094],"[245, 1230]",2844,3,2841,2,1,2841,0
5.5,MMU09964,"[375, 803, 1295, 1968, 2490, 2680, 3428, 4303, 5091, 5726, 5977, 6890, 7525, 7760, 7962, 8601, 9017, 9311, 11246]","[1968, 3428, 4303, 7962, 8601, 9017, 9311]","[375, 803, 1295, 2490, 2680, 5091, 5726, 5977, 6890, 7525, 7760, 11246]","[1968, 3428, 4303, 4607, 7962, 8162, 8601, 9017, 9311, 10875]",11454,19,11435,7,12,11432,3
5.5,MMU10098,"[593, 1173, 5292, 5695]",[1173],"[593, 5292, 5695]","[1173, 3509]",6117,4,6113,1,3,6112,1
5.5,MMU11054,"[204, 2250]",[],"[204, 2250]","[457, 1418, 1996]",2564,2,2562,0,2,2559,3
5.5,MMU11713,"[288, 634]","[288, 634]",[],"[288, 634]",1759,2,1757,2,0,1757,0
5.5,MMU12029,"[17, 342, 582, 1264]","[582, 1264]","[17, 342]","[582, 1264]",2255,4,2251,2,2,2251,0
5.5,MMU12273,"[38, 680, 1085, 1940]","[680, 1085]","[38, 1940]","[680, 1085, 1740]",2575,4,2571,2,2,2570,1
5.5,MMU12559,[247],[247],[],[247],918,1,917,1,0,917,0
5.5,MMU12560,[247],[247],[],[247],920,1,919,1,0,919,0
5.5,MMU12561,[247],[247],[],[247],916,1,915,1,0,915,0
5.5,MMU12562,[247],[247],[],[247],918,1,917,1,0,917,0
5.5,MMU12565,"[247, 396]",[247],[396],[247],1043,2,1041,1,1,1041,0
5.5,MMU13921,"[952, 1867, 2003, 2197, 2354, 3525, 3990]","[952, 2003, 2354, 3990]","[1867, 2197, 3525]","[952, 2003, 2354, 2693, 2930, 3241, 3990]",4670,7,4663,4,3,4660,3
5.5,MMU14421,[3848],[],[3848],"[3668, 4237, 4502, 4814]",6254,1,6253,0,1,6249,4
5.5,MMVITRO,"[2054, 2826, 3812, 3855, 4941, 4996]",[2054],"[2826, 3812, 3855, 4941, 4996]","[1845, 2054, 2474, 2693, 3017, 3279, 4355]",4996,6,4990,1,5,4984,6
5.5,MMVPREB2,"[172, 379]",[379],[172],[379],1045,2,1043,1,1,1043,0
5.5,MMVPREB3,"[172, 379]",[379],[172],[379],1045,2,1043,1,1,1043,0
5.5,MNKEGLOBIM,"[237, 583, 1184]","[237, 583]",[1184],"[237, 583]",1693,3,1690,2,1,1690,0
5.5,MNKEGLOBIN,"[237, 583, 1182]","[237, 583]",[1182],"[237, 583]",1691,3,1688,2,1,1688,0
5.5,MNKHGBGGAG,"[75, 92, 287, 633, 1338]","[287, 633]","[75, 92, 1338]","[287, 633]",1697,5,1692,2,3,1692,0
5.5,MNPROP2,[],[],[],[278],696,0,696,0,0,695,1
5.5,MUS8HS20,"[257, 271, 940, 1015, 2562]",[940],"[257, 271, 1015, 2562]",[940],2622,5,2617,1,4,2617,0
5.5,MUSAP,"[1012, 3574, 4740, 4971, 5230, 5547, 6013, 6406, 6709, 7890, 8019]","[3574, 4740, 4971, 6406, 6709]","[1012, 5230, 5547, 6013, 7890, 8019]","[3574, 3815, 4034, 4509, 4740, 4971, 5290, 5619, 5952, 6406, 6709]",8086,11,8075,5,6,8069,6
5.5,MUSAP5A,"[551, 697, 786, 1768, 2428, 2463, 2681, 2759, 4614, 6254, 6816]","[2428, 2759, 4614]","[551, 697, 786, 1768, 2463, 2681, 6254, 6816]","[2428, 2759, 4614]",6821,11,6810,3,8,6810,0
5.5,MUSAPEX,"[768, 1042, 1684, 2089, 2942]","[1684, 2089]","[768, 1042, 2942]","[1684, 2089, 2742]",4034,5,4029,2,3,4028,1
5.5,MUSAPOAII,"[723, 1155]","[723, 1155]",[],"[723, 1155]",2952,2,2950,2,0,2950,0
5.5,MUSAPOIVA,"[588, 975, 1385]","[588, 975]",[1385],"[588, 975]",3012,3,3009,2,1,3009,0
5.5,MUSBMP4,"[664, 768, 2149, 2473, 2683, 5497, 7179]",[7179],"[664, 768, 2149, 2473, 2683, 5497]",[7179],9660,7,9653,1,6,9653,0
5.5,MUSBNP,"[336, 488, 753, 1449]","[336, 753]","[488, 1449]","[336, 753]",1460,4,1456,2,2,1456,0
5.5,MUSCD14A,[176],[176],[],[176],1865,1,1864,1,0,1864,0
5.5,MUSCRKNB,"[1440, 2245, 2455, 3842, 3862]","[2245, 2455, 3842]","[1440, 3862]","[1904, 2245, 2455, 2796, 3505, 3842]",4513,5,4508,3,2,4505,3
5.5,MUSCYTCOVB,"[724, 1319, 2234]","[724, 1319]",[2234],"[724, 1319, 1585]",2532,3,2529,2,1,2528,1
5.5,MUSENDOBA,"[1507, 2117, 2130, 2743, 3115, 3618, 3892, 4049, 4430, 4898, 5090, 5589, 5696, 6980]","[2743, 3618, 4049, 5090, 5589]","[1507, 2117, 2130, 3115, 3892, 4430, 4898, 5696, 6980]","[2743, 3618, 4049, 4853, 5090, 5589]",7871,14,7857,5,9,7856,1
5.5,MUSFAUA,"[846, 1249, 1496, 2068, 2124]","[1249, 1496, 2124]","[846, 2068]","[1249, 1496, 2124]",2842,5,2837,3,2,2837,0
5.5,MUSFERHC,"[483, 1827, 2185]","[483, 1827, 2185]",[],"[483, 1827, 2185]",2782,3,2779,3,0,2779,0
5.5,MUSFKBP13X,"[321, 736]","[321, 736]",[],"[321, 736, 904, 1282]",1573,2,1571,2,0,1569,2
5.5,MUSGAD45,"[559, 935, 1126, 1458, 1595, 2647]","[935, 1126, 1458]","[559, 1595, 2647]","[935, 1126, 1458]",3092,6,3086,3,3,3086,0
5.5,MUSGFJE,[624],[624],[],"[624, 1489]",2403,1,2402,1,0,2401,1
5.5,MUSGPOAD,"[1044, 1737, 2306, 4403, 4816, 4916, 5400, 7929]","[1044, 2306, 4403, 4916]","[1737, 4816, 5400, 7929]","[1044, 2306, 4403, 4916]",8068,8,8060,4,4,8060,0
5.5,MUSHBBH0,"[163, 365, 914, 1112, 1265, 2081]","[365, 914]","[163, 1112, 1265, 2081]","[365, 914]",2127,6,2121,2,4,2121,0
5.5,MUSHBBH1,"[451, 780]","[451, 780]",[],"[451, 780]",1918,2,1916,2,0,1916,0
5.5,MUSHES1,"[556, 784, 1108, 1351, 1400]","[556, 784, 1108]","[1351, 1400]","[556, 784, 1108]",2817,5,2812,3,2,2812,0
5.5,MUSHOX35A,"[232, 612, 3519]",[],"[232, 612, 3519]",[1308],3847,3,3844,0,3,3843,1
5.5,MUSIL1RN,"[168, 512, 1676, 2186, 2289, 2483, 3549]","[512, 2483, 3549]","[168, 1676, 2186, 2289]","[512, 2483, 3549]",6342,7,6335,3,4,6335,0
5.5,MUSKE3A,"[21, 981, 1562, 1604, 1881, 2194, 3218, 3405]","[21, 3218]","[981, 1562, 1604, 1881, 2194, 3405]","[21, 544, 3218, 3400]",3612,8,3604,2,6,3602,2
5.5,MUSLMP7A,"[1318, 1354, 1407, 2454, 3029]","[1318, 2454, 3029]","[1354, 1407]","[1318, 2153, 2454, 3029, 3674]",4259,5,4254,3,2,4252,2
5.5,MUSLTA,"[1207, 1632, 1807]",[1807],"[1207, 1632]","[1807, 1990]",3286,3,3283,1,2,3282,1
5.5,MUSMC26,"[816, 843, 2419, 2475, 3190, 3666, 3682, 3716]","[2419, 3190]","[816, 843, 2475, 3666, 3682, 3716]","[2419, 3190, 4144]",5386,8,5378,2,6,5377,1
5.5,MUSOGC,"[113, 489]","[113, 489]",[],"[113, 290, 489]",941,2,939,2,0,938,1
5.5,MUSOGCA,"[214, 285, 866, 1242]","[866, 1242]","[214, 285]","[866, 1043, 1242]",1694,4,1690,2,2,1689,1
5.5,MUSOGCB,"[113, 490]","[113, 490]",[],"[113, 290, 490]",942,2,940,2,0,939,1
5.5,MUSPNMT,"[1665, 1881, 2135, 2450, 2755]",[1665],"[1881, 2135, 2450, 2755]","[1665, 2343]",3136,5,3131,1,4,3130,1
5.5,MUSPROTA,"[1945, 2585, 3663]","[1945, 2585, 3663]",[],"[1945, 2585, 3224, 3663]",4636,3,4633,3,0,4632,1
5.5,MUSPROTEB,"[337, 496, 594, 1024]","[337, 594]","[496, 1024]","[337, 594, 993, 1988]",2389,4,2385,2,2,2383,2
5.5,MUSPRPC2,"[801, 2740, 3019, 3833, 5493]",[801],"[2740, 3019, 3833, 5493]",[801],7298,5,7293,1,4,7293,0
5.5,MUSPRPMPB,"[801, 1480, 2974]",[801],"[1480, 2974]",[801],3566,3,3563,1,2,3563,0
5.5,MUSREGI,"[775, 1159, 2230, 2993]","[1159, 2230, 2993]",[775],"[1159, 1799, 2230, 2993]",3748,4,3744,3,1,3743,1
5.5,MUSREGII,"[530, 927, 1626, 2023]","[927, 1626]","[530, 2023]","[927, 1626, 1988, 3091]",3924,4,3920,2,2,3918,2
5.5,MUSROM1X,[1030],[],[1030],"[1242, 1848]",2779,1,2778,0,1,2776,2
5.5,MUSRPL30,"[500, 660, 1679, 2459, 3124, 3441]","[660, 2459]","[500, 1679, 3124, 3441]","[660, 1050, 2459]",3468,6,3462,2,4,3461,1
5.5,MUSRPS16,"[1868, 2005]","[1868, 2005]",[],"[450, 687, 1868, 2005]",2641,2,2639,2,0,2637,2
5.5,MUSS100B,"[342, 1721, 1778, 4920, 5219, 8612]",[4920],"[342, 1721, 1778, 5219, 8612]",[4920],8865,6,8859,1,5,8859,0
5.5,MUSSERPROA,"[1034, 1449, 2092, 3178]","[1449, 2092, 3178]",[1034],"[1449, 2092, 2739, 3178]",4449,4,4445,3,1,4444,1
5.5,MUSSSATGN,"[613, 840, 1825, 2165, 3039]","[840, 3039]","[613, 1825, 2165]","[840, 1162, 1346, 2905, 3039]",4058,5,4053,2,3,4050,3
5.5,MUSTCP,"[453, 470, 2496, 3642, 4019, 4278, 4687, 6098, 7230, 7512]","[453, 4278, 4687, 6098, 7230, 7512]","[470, 2496, 3642, 4019]","[453, 1705, 1993, 3270, 3746, 4278, 4687, 6098, 6552, 7230, 7512]",9253,10,9243,6,4,9238,5
5.5,MUSTHY1,[1009],[1009],[],"[80, 1009]",2682,1,2681,1,0,2680,1
5.5,MUSTLAG,"[261, 705, 1155, 1573, 4788]","[705, 1155, 1573]","[261, 4788]","[705, 1155, 1573, 3494, 3740]",5412,5,5407,3,2,5405,2
5.5,MUSTSHBA2,[464],[464],[],[464],1283,1,1282,1,0,1282,0
5.5,MUSY1GLOB,"[377, 690, 1224, 1249]","[377, 690]","[1224, 1249]","[377, 690]",1745,4,1741,2,2,1741,0
5.5,OABBGLOB,"[33, 525, 692, 958, 1309]","[958, 1309]","[33, 525, 692]","[958, 1309]",3241,5,3236,2,3,3236,0
5.5,OABCGLOB,"[33, 957, 1312]","[957, 1312]",[33],"[957, 1312]",3192,3,3189,2,1,3189,0
5.5,OAINIGFII1,"[740, 1165, 2106, 2199]",[740],"[1165, 2106, 2199]",[740],2385,4,2381,1,3,2381,0
5.5,OAINTL3,"[674, 813, 1909, 2072]","[674, 813, 1909, 2072]",[],"[674, 813, 1909, 2072]",2793,4,2789,4,0,2789,0
5.5,OAKRT213,"[1593, 3198, 3938, 4147, 4813, 5288, 5684, 6077, 6548, 8453, 9294]","[3198, 4147, 4813, 5288, 5684, 6077, 6548]","[1593, 3938, 8453, 9294]","[3198, 4147, 4813, 5288, 5684, 6077, 6548, 7393]",9521,11,9510,7,4,9509,1
5.5,OALGB,"[959, 2438, 2660, 3336, 3500, 4656]","[2660, 4656]","[959, 2438, 3336, 3500]","[938, 1742, 2660, 3883, 4656]",7371,6,7365,2,4,7362,3
5.5,OAMETIAG,[701],[701],[],"[701, 1479]",2792,1,2791,1,0,2790,1
5.5,OAMTIB,[],[],[],"[965, 1721]",3211,0,3211,0,0,3209,2
5.5,OAMTIC,"[381, 621]",[621],[381],"[621, 1295]",2375,2,2373,1,1,2372,1
5.5,OAMTII,"[799, 1023, 1378, 1976]","[1023, 1378]","[799, 1976]","[1023, 1378]",2047,4,2043,2,2,2043,0
5.5,OAPROTP1,[],[],[],[212],524,0,524,0,0,523,1
5.5,OATRICH,"[1183, 3157, 4772, 5825]",[3157],"[1183, 4772, 5825]",[3157],9336,4,9332,1,3,9332,0
5.5,OCAPOAIG,"[361, 1239, 1467]",[],"[361, 1239, 1467]","[553, 855]",1986,3,1983,0,3,1981,2
5.5,OCTNFBETA,"[68, 577]",[577],[68],"[577, 766]",1963,2,1961,1,1,1960,1
5.5,OCUTGLOB,"[3172, 3357, 3424, 3496, 4176, 5072]",[3357],"[3172, 3424, 3496, 4176, 5072]","[3357, 5831]",6560,6,6554,1,5,6553,1
5.5,OOGH,"[333, 1475]","[333, 1475]",[],"[333, 740, 1084, 1475]",2154,2,2152,2,0,2150,2
5.5,OPOP1,[],[],[],[249],616,0,616,0,0,615,1
5.5,ORAPROTP1A,[],[],[],[163],409,0,409,0,0,408,1
5.5,PAA1GL,"[204, 513]","[204, 513]",[],"[204, 513]",872,2,870,2,0,870,0
5.5,PAAFPG,[214],[214],[],[214],1087,1,1086,1,0,1086,0
5.5,PAU03674,"[1194, 3171, 4013]","[3171, 4013]",[1194],"[3171, 3574, 3773, 4013, 4294, 4611]",5437,3,5434,2,1,5430,4
5.5,PIGAPAI,"[62, 562, 794]",[794],"[62, 562]","[794, 1129]",3325,3,3322,1,2,3321,1
5.5,PIGAPCIII,"[45, 867, 944, 1711]",[1711],"[45, 867, 944]","[1432, 1711]",3268,4,3264,1,3,3263,1
5.5,PIGCNP,"[400, 528, 1150, 1622]",[400],"[528, 1150, 1622]",[400],1886,4,1882,1,3,1882,0
5.5,PIGFSB,"[1598, 1801, 1849]",[],"[1598, 1801, 1849]","[515, 1042]",2043,3,2040,0,3,2038,2
5.5,PIKEGLOBIN,"[237, 588, 1193]","[237, 588]",[1193],"[237, 588]",1701,3,1698,2,1,1698,0
5.5,PPGLTG,[662],[662],[],"[373, 662]",1064,1,1063,1,0,1062,1
5.5,PPPROP2,[],[],[],[319],739,0,739,0,0,738,1
5.5,PPYPROP2,[],[],[],[272],688,0,688,0,0,687,1
5.5,PTAZGLO,"[943, 1603, 1648, 1749, 2244]",[1603],"[943, 1648, 1749, 2244]","[1603, 3077]",3609,5,3604,1,4,3603,1
5.5,PTGGGLOG,"[200, 545, 641]","[200, 545]",[641],"[200, 545]",1814,3,1811,2,1,1811,0
5.5,PTPPINS,"[933, 1410]",[1410],[933],[1410],2475,2,2473,1,1,2473,0
5.5,PTPROP2,[],[],[],[330],750,0,750,0,0,749,1
5.5,PVU11715,"[288, 633]","[288, 633]",[],"[288, 633]",1781,2,1779,2,0,1779,0
5.5,QULNFLW,"[1222, 2169, 2405, 3794, 4656, 5192, 5849, 5873, 6808]","[3794, 4656]","[1222, 2169, 2405, 5192, 5849, 5873, 6808]","[3794, 4656, 5921]",7925,9,7916,2,7,7915,1
5.5,QULTROPIA,"[591, 2360, 3004, 3437, 3638, 4007, 4047]","[2360, 3004, 3437, 4047]","[591, 3638, 4007]","[2186, 2360, 3004, 3437, 4047, 4336]",4956,7,4949,4,3,4947,2
5.5,RABCRP,"[397, 990, 1221]",[397],"[990, 1221]",[397],1430,3,1427,1,2,1427,0
5.5,RABDNP3AA,"[370, 816, 906, 2156]",[2156],"[370, 816, 906]",[2156],3082,4,3078,1,3,3078,0
5.5,RABSURFA,"[471, 636, 3239, 4361, 5088, 5622, 6529, 7760]","[4361, 5088]","[471, 636, 3239, 5622, 6529, 7760]","[4033, 4361, 5088]",8089,8,8081,2,6,8080,1
5.5,RABTNF,"[261, 851]",[851],[261],"[851, 1355, 1563]",3192,2,3190,1,1,3188,2
5.5,RATCYC,"[362, 572, 1333]",[1333],"[362, 572]",[1333],2520,3,2517,1,2,2517,0
5.5,RATCYSS,"[1006, 4026]","[1006, 4026]",[],"[1006, 4026]",5555,2,5553,2,0,5553,0
5.5,RATDCCOVB,"[2267, 2864, 3716, 3782]","[2267, 2864]","[3716, 3782]","[2267, 2864, 3126]",5323,4,5319,2,2,5318,1
5.5,RATGRG,"[83, 286, 2187, 2319, 2392, 2616, 3290, 3552]","[83, 286, 2187, 2319, 2616, 3290]","[2392, 3552]","[83, 286, 1291, 1494, 1696, 1942, 2187, 2319, 2616, 2994, 3290]",3880,8,3872,6,2,3867,5
5.5,RATGROS,"[1178, 1390, 1587, 2131]","[1178, 1390, 1587]",[2131],"[1178, 1390, 1587]",2488,4,2484,3,1,2484,0
5.5,RATGSTY,"[659, 718, 2830, 3804, 4691]",[659],"[718, 2830, 3804, 4691]","[659, 996, 1495, 1862, 2060, 3180, 3376]",6286,5,6281,1,4,6275,6
5.5,RATIGFBA,"[850, 1788, 2034, 2203, 3002, 3828, 4512]","[2034, 3002]","[850, 1788, 2203, 3828, 4512]","[526, 2034, 3002]",4992,7,4985,2,5,4984,1
5.5,RATJE,"[1191, 1299, 2986]",[1191],"[1299, 2986]","[1191, 1989]",3097,3,3094,1,2,3093,1
5.5,RATKALA,"[3282, 4709, 4729]","[3282, 4709]",[4729],"[1275, 3282, 4476, 4709]",6249,3,6246,2,1,6244,2
5.5,RATLHB,"[784, 817, 1230]","[817, 1230]",[784],"[817, 1230]",1790,3,1787,2,1,1787,0
5.5,RATLITHOST,"[2013, 2464, 2496, 2847, 3471, 3902, 4652]","[2847, 3471, 3902, 4652]","[2013, 2464, 2496]","[2847, 3471, 3902, 4652]",5399,7,5392,4,3,5392,0
5.5,RATLYSOZYM,"[960, 1561, 3255, 5174, 5443]","[1561, 3255, 5174]","[960, 5443]","[1561, 3255, 5174]",6732,5,6727,3,2,6727,0
5.5,RATLYSZYM,"[6, 508, 574, 1007, 1099, 1667, 3840, 4290, 6230, 6499]","[574, 4290, 6230]","[6, 508, 1007, 1099, 1667, 3840, 6499]","[574, 4290, 6230]",7943,10,7933,3,7,7933,0
5.5,RATOSCAL,"[1192, 1586]","[1192, 1586]",[],"[1192, 1373, 1586]",2119,2,2117,2,0,2116,1
5.5,RATPAP,"[633, 1648, 2295, 3305]","[1648, 2295, 3305]",[633],"[1308, 1648, 2295, 2604, 3305]",4863,4,4859,3,1,4857,2
5.5,RATPAPIIB,"[1916, 2291, 2298, 3021, 3387, 3473, 4107]","[2298, 3473, 4107]","[1916, 2291, 3021, 3387]","[2298, 3140, 3473, 4107]",4717,7,4710,3,4,4709,1
5.5,RATPPP,"[1497, 1538, 2002, 2451, 2927, 4400]",[],"[1497, 1538, 2002, 2451, 2927, 4400]",[2261],4534,6,4528,0,6,4527,1
5.5,RATPTBZR02,"[669, 871, 909, 1927, 2066, 3232]",[2066],"[669, 871, 909, 1927, 3232]","[1306, 2066]",3426,6,3420,1,5,3419,1
5.5,RATRGPI,"[1879, 2329, 2361, 2712, 3339, 3770, 4521]","[2712, 3339, 3770, 4521]","[1879, 2329, 2361]","[2712, 3339, 3770, 4521]",5237,7,5230,4,3,5230,0
5.5,RATRPIII,"[1226, 1601, 1608, 2337, 2456, 2704, 2790, 2905, 3426]","[1608, 2456, 2790, 3426]","[1226, 1601, 2337, 2704, 2905]","[1608, 2456, 2790, 3426]",4133,9,4124,4,5,4124,0
5.5,RATSVSIV1,"[72, 244, 659, 892]",[244],"[72, 659, 892]",[244],972,4,968,1,3,968,0
5.5,RATTSHB,"[265, 2177, 4375]",[4375],"[265, 2177]",[4375],5159,3,5156,1,2,5156,0
5.5,RN0B2GLOB,"[558, 693, 1134]",[693],"[558, 1134]","[354, 693]",1789,3,1786,1,2,1785,1
5.5,RN2BGLOB,[764],[764],[],"[432, 764]",1876,1,1875,1,0,1874,1
5.5,RN3B2GLOB,"[325, 460]",[460],[325],"[122, 460]",1436,2,1434,1,1,1433,1
5.5,RN3B3GLOB,"[604, 739]",[739],[604],"[403, 739]",1738,2,1736,1,1,1735,1
5.5,RN3BGLOB,"[491, 626]",[626],[491],"[288, 626]",1526,2,1524,1,1,1523,1
5.5,RNAC01,"[127, 309, 1367, 1694, 2597, 2685, 2867, 3984]","[1367, 1694, 2597, 2867]","[127, 309, 2685, 3984]","[1367, 1694, 2597, 2867]",4083,8,4075,4,4,4075,0
5.5,RNAC02,"[251, 1787, 2138, 2180, 2561]","[1787, 2138]","[251, 2180, 2561]","[1368, 1787, 2138, 2429, 2743]",3192,5,3187,2,3,3184,3
5.5,RNANTANT,"[1524, 3119]",[1524],[3119],"[1524, 3263, 3883]",5117,2,5115,1,1,5113,2
5.5,RNAPOEG,"[459, 1293, 1955, 2863]","[1293, 1955]","[459, 2863]","[1293, 1955]",3229,4,3225,2,2,3225,0
5.5,RNCALBD9,"[373, 1041, 2736, 3508]",[2736],"[373, 1041, 3508]",[2736],4883,4,4879,1,3,4879,0
5.5,RNGAMT,"[799, 4003, 4704, 4715]",[4003],"[799, 4704, 4715]","[2173, 3141, 3319, 3760, 4003]",4956,4,4952,1,3,4948,4
5.5,RNGMTG,"[1011, 1682, 1818, 2067, 3918, 4463, 5252]","[1682, 3918, 4463]","[1011, 1818, 2067, 5252]","[1682, 3249, 3918, 4254, 4463]",5391,7,5384,3,4,5382,2
5.5,RNGROW3,"[216, 365, 471, 1652]","[471, 1652]","[216, 365]","[471, 817, 1652, 1973]",2549,4,2545,2,2,2543,2
5.5,RNHSC73,"[498, 1244, 1713, 1982, 3034, 3448]","[1244, 1713, 1982, 3034, 3448]",[498],"[1244, 1713, 1982, 2618, 3034, 3448, 3766]",4312,6,4306,5,1,4304,2
5.5,RNLALB01,"[1237, 1242, 1414, 1914, 2419]","[1414, 1914, 2419]","[1237, 1242]","[1414, 1914, 2419]",3812,5,3807,3,2,3807,0
5.5,RNLPKG,"[2183, 2847, 3195, 7818, 8078, 9121, 12937]","[7818, 8078]","[2183, 2847, 3195, 9121, 12937]","[3219, 3949, 6009, 6284, 6605, 7192, 7453, 7818, 8078, 9480]",13003,7,12996,2,5,12988,8
5.5,RNODC,"[1344, 3174, 3918, 4182, 4517, 4982, 5631, 5825, 6291, 6692]","[3918, 4182, 4517, 5631, 5825, 6291]","[1344, 3174, 4982, 6692]","[3525, 3918, 4182, 4517, 4698, 4953, 5631, 5825, 6291]",7768,10,7758,6,4,7755,3
5.5,RNP9KA,"[823, 1227, 2311]",[1227],"[823, 2311]",[1227],2332,3,2329,1,2,2329,0
5.5,RNPBPG,"[1117, 1155, 1180, 2638, 4056]",[1117],"[1155, 1180, 2638, 4056]","[1117, 2950]",6021,5,6016,1,4,6015,1
5.5,RNPGMUT,"[1216, 1515, 1912]",[],"[1216, 1515, 1912]","[1596, 1872]",2420,3,2417,0,3,2415,2
5.5,RNPROST22,"[733, 876, 4526, 7412]","[876, 4526]","[733, 7412]","[876, 3647, 4526]",7667,4,7663,2,2,7662,1
5.5,RNREVSV2A,"[12, 67, 1341]",[67],"[12, 1341]","[67, 1304]",1730,3,1727,1,2,1726,1
5.5,RNSDHG,"[379, 1993, 2205, 3480, 3554, 5691, 6052, 6253, 6984, 7081, 8014]","[5691, 6052, 6253, 6984]","[379, 1993, 2205, 3480, 3554, 7081, 8014]","[4640, 5691, 6052, 6253, 6984, 8671]",9570,11,9559,4,7,9557,2
5.5,RNSVFG,"[500, 636, 670, 1250, 1267, 1347]",[500],"[636, 670, 1250, 1267, 1347]",[500],1841,6,1835,1,5,1835,0
5.5,RNTHYCSG,"[318, 1071, 1906]",[1071],"[318, 1906]","[68, 1071]",2855,3,2852,1,2,2851,1
5.5,RNU03551,"[832, 2418]","[832, 2418]",[],"[832, 2418, 3083]",3590,2,3588,2,0,3587,1
5.5,RNU09193,"[1727, 2630, 2749, 3084, 3787, 3899]","[2749, 3084, 3787]","[1727, 2630, 3899]","[2084, 2749, 3084, 3787]",4187,6,4181,3,3,4180,1
5.5,RNU12250,"[293, 473]","[293, 473]",[],"[293, 473]",1863,2,1861,2,0,1861,0
5.5,RNUCPG,"[1881, 2812, 4187, 4896, 6121, 6983, 7395, 8157, 9172, 10198, 10292, 10603, 11061, 11481, 11722]",[8157],"[1881, 2812, 4187, 4896, 6121, 6983, 7395, 9172, 10198, 10292, 10603, 11061, 11481, 11722]","[4310, 5157, 7964, 8157, 9401]",12496,15,12481,1,14,12477,4
5.5,RNVEGP1,"[1043, 1834, 1994, 2076, 3032, 4037, 4140, 4452, 4844, 5195]","[1834, 3032, 4037]","[1043, 1994, 2076, 4140, 4452, 4844, 5195]","[1262, 1834, 3032, 4037, 4611]",5948,10,5938,3,7,5936,2
5.5,RNVEGP2C,"[1159, 1950, 2182, 4146, 4960, 5078]","[1950, 4146]","[1159, 2182, 4960, 5078]","[1378, 1950, 3128, 4146, 4723]",5742,6,5736,2,4,5733,3
5.5,RRU04320,"[2500, 3643]","[2500, 3643]",[],"[2500, 3643]",6798,2,6796,2,0,6796,0
5.5,S46763,"[1235, 1252, 3278, 4424, 4801, 5060, 5469, 6880, 8012, 8294]","[1235, 5060, 5469, 6880, 8012, 8294]","[1252, 3278, 4424, 4801]","[1235, 2487, 2775, 4052, 4528, 5060, 5469, 6880, 7334, 8012, 8294]",10035,10,10025,6,4,10020,5
5.5,S49651,[1652],[1652],[],"[1652, 2786, 3255, 4137]",5440,1,5439,1,0,5436,3
5.5,S57980,"[732, 875, 4524, 7410]","[875, 4524]","[732, 7410]","[875, 3645, 4524]",7665,4,7661,2,2,7660,1
5.5,S62287,"[190, 570]",[],"[190, 570]",[1266],3425,2,3423,0,2,3422,1
5.5,S63697,"[280, 829]","[280, 829]",[],"[280, 829]",1331,2,1329,2,0,1329,0
5.5,S66606,"[2506, 4598, 5644, 6167]","[2506, 4598]","[5644, 6167]","[2506, 2706, 3899, 4598]",6359,4,6355,2,2,6353,2
5.5,S67057,[840],[840],[],[840],1746,1,1745,1,0,1745,0
5.5,S69277,"[207, 3316, 3839, 4103]","[3316, 3839, 4103]",[207],"[3098, 3316, 3521, 3839, 4103]",5516,4,5512,3,1,5510,2
5.5,S69278,"[846, 861, 2826, 3347, 3561, 3832, 4236]","[2826, 3347, 3561]","[846, 861, 3832, 4236]","[2590, 2826, 3031, 3347, 3561]",5015,7,5008,3,4,5006,2
5.5,S69350,[235],[235],[],[235],2152,1,2151,1,0,2151,0
5.5,SAIEGLOBIM,"[237, 588, 983, 1317]","[237, 588]","[983, 1317]","[237, 588]",1826,4,1822,2,2,1822,0
5.5,SMIGCU,"[799, 1233, 1631, 1779, 1946, 2624]","[799, 1233, 1631]","[1779, 1946, 2624]","[799, 1233, 1631]",2833,6,2827,3,3,2827,0
5.5,SMNPRP1A,[],[],[],[215],623,0,623,0,0,622,1
5.5,SOEEGLOBIN,"[236, 586, 1183]","[236, 586]",[1183],"[236, 586]",1688,3,1685,2,1,1685,0
5.5,SSBAT1G,"[482, 1471, 2215, 2582, 2592, 2610, 2814, 2990, 4538, 6104, 6678, 6735, 8238, 9144, 9674]","[2215, 2582, 4538, 8238, 9144, 9674]","[482, 1471, 2592, 2610, 2814, 2990, 6104, 6678, 6735]","[1316, 2215, 2582, 4538, 5771, 8238, 9144, 9388, 9674]",10666,15,10651,6,9,10648,3
5.5,SSIKBAGE,"[788, 2469, 3151, 3713, 4091, 4470, 5251]","[2469, 3151, 3713, 4091, 4470]","[788, 5251]","[2469, 3151, 3713, 4091, 4470]",5756,7,5749,5,2,5749,0
5.5,SSPINT1B,"[2127, 2551, 4793, 6605, 6774, 8049, 8541, 8611]","[2551, 6605]","[2127, 4793, 6774, 8049, 8541, 8611]","[1971, 2551, 3903, 5245, 6605]",8743,8,8735,2,6,8732,3
5.5,TAPROTP1,[],[],[],[230],547,0,547,0,0,546,1
5.5,TARHBE,"[119, 465]","[119, 465]",[],"[119, 465]",1682,2,1680,2,0,1680,0
5.5,TARHBG,"[58, 265, 608]",[265],"[58, 608]","[265, 612]",2139,3,2136,1,2,2135,1
5.5,TFLPA2P1,"[596, 972, 1749, 2495]","[596, 972, 1749]",[2495],"[596, 972, 1749]",2708,4,2704,3,1,2704,0
5.5,TFLPA2P2,"[590, 966, 1783]","[590, 966, 1783]",[],"[590, 966, 1783]",2431,3,2428,3,0,2428,0
5.5,TFLPA2P3,"[596, 972, 1749, 2495]","[596, 972, 1749]",[2495],"[596, 972, 1749]",2708,4,2704,3,1,2704,0
5.5,TFLPA2P4,"[590, 966, 1783]","[590, 966, 1783]",[],"[590, 966, 1783]",2431,3,2428,3,0,2428,0
5.5,TGLHBB,"[519, 888, 1106, 1256, 2034]","[519, 888]","[1106, 1256, 2034]","[519, 888]",2300,5,2295,2,3,2295,0
5.5,TIOPRP1A,[],[],[],[212],556,0,556,0,0,555,1
5.5,U00432,"[237, 1101]","[237, 1101]",[],"[83, 237, 793, 1101, 1312]",1575,2,1573,2,0,1570,3
5.5,U00433,"[83, 267, 752, 1245]","[83, 267, 752]",[1245],"[83, 267, 752, 1062, 1270]",1545,4,1541,3,1,1539,2
5.5,U00454,"[772, 1031, 1598, 4179, 5820, 6800]",[1598],"[772, 1031, 4179, 5820, 6800]","[1598, 4862]",7192,6,7186,1,5,7185,1
5.5,U00938,"[247, 1169, 3079, 3311, 3617, 4070, 5155, 5202, 5261, 5809, 5962, 6482]","[1169, 4070, 5155]","[247, 3079, 3311, 3617, 5202, 5261, 5809, 5962, 6482]","[1169, 4070, 5155]",6780,12,6768,3,9,6768,0
5.5,U01026,"[1364, 1746, 2537]","[1364, 1746, 2537]",[],"[1364, 1746, 2537]",3216,3,3213,3,0,3213,0
5.5,U01027,"[571, 947, 1710, 2740]","[571, 947, 1710]",[2740],"[571, 947, 1710]",2761,4,2757,3,1,2757,0
5.5,U01844,"[64, 684, 1986, 2090, 2653, 3211]","[1986, 2653, 3211]","[64, 684, 2090]","[1986, 2141, 2474, 2653, 3211]",4219,6,4213,3,3,4211,2
5.5,XELCRPGA,"[842, 1096]",[1096],[842],[1096],3891,2,3889,1,1,3889,0
5.5,XELCRYB,"[592, 1326]",[1326],[592],"[706, 1326]",2049,2,2047,1,1,2046,1
5.5,XELHBBC,"[263, 715]",[263],[715],"[263, 678]",1981,2,1979,1,1,1978,1
5.5,XLACTA,"[553, 1260, 2591, 3422, 3868, 4138, 4845, 4946, 5338, 5898]","[2591, 3868, 4138, 4845]","[553, 1260, 3422, 4946, 5338, 5898]","[2591, 3868, 4138, 4845, 5128]",5946,10,5936,4,6,5935,1
5.5,XLACTCAG,"[831, 1600, 3128, 3614, 4931, 6279, 6461, 7511, 8347, 8892]","[3614, 4931, 6461]","[831, 1600, 3128, 6279, 7511, 8347, 8892]","[2473, 3614, 4931, 5562, 6461]",8900,10,8890,3,7,8888,2
5.5,XLBGL3,[1175],[1175],[],"[388, 1175]",2964,1,2963,1,0,2962,1
5.5,XLGLAA1,[502],[502],[],"[137, 502]",1192,1,1191,1,0,1190,1
5.5,XLGLAA2,"[519, 1163]",[519],[1163],"[138, 519]",1192,2,1190,1,1,1189,1
5.5,XLK81A1G,"[2734, 3240, 3531, 3849]","[2734, 3531, 3849]",[3240],"[1759, 2294, 2734, 3026, 3531, 3849, 4170]",5892,4,5888,3,1,5884,4
5.5,XLRPL14,"[912, 1292, 2140, 3085]",[912],"[1292, 2140, 3085]","[912, 1891, 2087, 4978, 5356, 7904]",9116,4,9112,1,3,9107,5
5.5,XLRPL1AG,"[308, 512, 634, 2121, 2638, 3735, 3831, 4573, 5179, 5303, 5757, 6451]","[512, 2121, 3831, 4573, 5179, 5757]","[308, 634, 2638, 3735, 5303, 6451]","[512, 2121, 2438, 2818, 3137, 3831, 4573, 5179, 5757]",6949,12,6937,6,6,6934,3
5.5,XLS8,"[164, 692, 1006, 3963, 4181, 5912, 6381, 7381, 8411, 12978]","[5912, 7381]","[164, 692, 1006, 3963, 4181, 6381, 8411, 12978]","[2032, 3938, 5912, 7381, 12177]",13512,10,13502,2,8,13499,3
5.5,XLTUBAG,"[595, 678, 1280, 1323, 4179, 5575, 6604, 6630]","[678, 5575]","[595, 1280, 1323, 4179, 6604, 6630]","[678, 4401, 5575]",6888,8,6880,2,6,6879,1
5.5,XLXANF1A,[2706],[2706],[],"[1460, 1960, 2706]",4878,1,4877,1,0,4875,2
5.5,XTGLA,"[235, 2838, 4344]",[2838],"[235, 4344]","[731, 2838]",4838,3,4835,1,2,4834,1
5.5,XTGLAA,"[416, 1411]",[1411],[416],"[1036, 1411]",1992,2,1990,1,1,1989,1
5.5,XTGLB,"[21, 1823]",[],"[21, 1823]","[2384, 2836]",4043,2,4041,0,2,4039,2
5.5,ZEFB2MICB,"[1187, 1345]",[1187],[1345],"[304, 1187]",2193,2,2191,1,1,2190,1
