Threshold,Locus,Predict Sites,Positive Sites,Negative Sites,Actual Donor Sites,Predict Num,Predict Positive Num,Predict Negative Num,TP,FP,TN,FN
4.5,ACU08131,"[463, 642, 845, 1024, 1255, 1363, 2029, 2245, 2350, 2803, 3336, 3798, 4512, 5313]","[642, 1363, 2029, 2803, 3798]","[463, 845, 1024, 1255, 2245, 2350, 3336, 4512, 5313]","[642, 1363, 2029, 2803, 3798]",5384,14,5370,5,9,5370,0
4.5,AGGGLINE,"[32, 70, 2325, 2658, 2946, 2963, 3120, 3158, 3504, 4035, 4309, 4685, 6262, 6387, 6421, 7054]","[3158, 3504]","[32, 70, 2325, 2658, 2946, 2963, 3120, 4035, 4309, 4685, 6262, 6387, 6421, 7054]","[3158, 3504]",7220,16,7204,2,14,7204,0
4.5,AGU04852,"[536, 653, 1464, 2073, 2302, 2972, 3877, 3956, 4566, 4863, 4906, 5517, 5912, 6224, 6740, 8301, 8354, 8817, 8961, 10812]","[3956, 5517, 5912, 6740]","[536, 653, 1464, 2073, 2302, 2972, 3877, 4566, 4863, 4906, 6224, 8301, 8354, 8817, 8961, 10812]","[3956, 5517, 5912, 6740]",10976,20,10956,4,16,10956,0
4.5,ALOEGLOBIM,"[221, 237, 583, 1170]","[237, 583]","[221, 1170]","[237, 583]",1683,4,1679,2,2,1679,0
4.5,ALOEGLOBIN,"[221, 237, 583, 1170, 1182]","[237, 583]","[221, 1170, 1182]","[237, 583]",1683,5,1678,2,3,1678,0
4.5,ALOPROTP1A,"[59, 166, 267]",[166],"[59, 267]",[166],410,3,407,1,2,407,0
4.5,AMU12024,"[257, 667, 1583, 1960, 2482, 2685]","[257, 667, 2482]","[1583, 1960, 2685]","[257, 667, 1864, 2126, 2482]",3644,6,3638,3,3,3636,2
4.5,AMU12025,"[1080, 1412, 1830, 2654, 2705, 2736, 3278, 3313, 3343]","[1412, 1830, 2654, 3278]","[1080, 2705, 2736, 3313, 3343]","[1412, 1830, 2654, 2902, 3278]",5375,9,5366,4,5,5365,1
4.5,AOIRHODOPS,"[255, 894, 1702, 1749, 1969, 2754, 4005, 4067, 4336, 4385, 4840, 4953, 5373, 6243, 7056, 7600, 7622, 7630, 7800, 8308, 9057, 9133]","[1702, 4067, 5373, 6243]","[255, 894, 1749, 1969, 2754, 4005, 4336, 4385, 4840, 4953, 7056, 7600, 7622, 7630, 7800, 8308, 9057, 9133]","[1702, 4067, 5373, 6243]",9915,22,9893,4,18,9893,0
4.5,ASPROP2,"[75, 589]",[],"[75, 589]",[325],664,2,662,0,2,661,1
4.5,ASYRVISP,"[625, 634, 656, 1042, 1335, 1419, 1585, 1916]","[625, 1042, 1335, 1585, 1916]","[634, 656, 1419]","[625, 1042, 1335, 1585, 1916]",2221,8,2213,5,3,2213,0
4.5,ATREGLOBIN,"[221, 237, 588, 604, 1187]","[237, 588]","[221, 604, 1187]","[237, 588]",1691,5,1686,2,3,1686,0
4.5,BABAPOE,"[33, 60, 198, 267, 481, 897, 1702, 2262, 2847, 3916, 3978, 3999]","[897, 2847]","[33, 60, 198, 267, 481, 1702, 2262, 3916, 3978, 3999]","[897, 2847]",4754,12,4742,2,10,4742,0
4.5,BATROX,"[341, 875, 2078, 2890, 3011, 3593, 3924, 3975, 4110, 4495, 4705, 4836, 5035, 5085, 6789, 6874, 6955, 7378, 7655]","[341, 3011, 5035, 6955]","[875, 2078, 2890, 3593, 3924, 3975, 4110, 4495, 4705, 4836, 5085, 6789, 6874, 7378, 7655]","[341, 3011, 5035, 6955]",8092,19,8073,4,15,8073,0
4.5,BCHEGLOBIN,"[221, 237, 583, 1184, 1196]","[237, 583]","[221, 1184, 1196]","[237, 583]",1697,5,1692,2,3,1692,0
4.5,BOVANPA,"[334, 433, 858]","[433, 858]",[334],"[433, 858]",1761,3,1758,2,1,1758,0
4.5,BOVCOX7AL,"[1540, 1826, 2470, 2630, 2867, 3328, 3721, 3969, 5049, 6167]","[1540, 5049]","[1826, 2470, 2630, 2867, 3328, 3721, 3969, 6167]","[1540, 2812, 5049]",6848,10,6838,2,8,6837,1
4.5,BOVGAS,"[192, 751]",[751],[192],[751],1058,2,1056,1,1,1056,0
4.5,BOVIAP,"[437, 457, 602, 926, 1116, 1318, 1568, 1764, 1994, 2159, 2354, 2756, 2793, 2864, 2999, 3392, 3440, 3535, 3667, 3782, 3996, 4024, 5262]","[1568, 1764, 1994, 2354, 2999, 3392, 3667, 3996]","[437, 457, 602, 926, 1116, 1318, 2159, 2756, 2793, 2864, 3440, 3535, 3782, 4024, 5262]","[1568, 1764, 1994, 2354, 2606, 2999, 3157, 3392, 3667, 3996]",5391,23,5368,8,15,5366,2
4.5,BOVIRBP,"[129, 552, 994, 2388, 2586, 2649, 2769, 3174, 3723, 3801, 4212, 4806, 4970, 5048, 5349, 5595, 5761, 6214, 6494, 6540, 7699, 7773, 8937, 9190, 9959, 10082, 10749, 11020]","[3174, 5595, 7699]","[129, 552, 994, 2388, 2586, 2649, 2769, 3723, 3801, 4212, 4806, 4970, 5048, 5349, 5761, 6214, 6494, 6540, 7773, 8937, 9190, 9959, 10082, 10749, 11020]","[3174, 5595, 7699]",11785,28,11757,3,25,11757,0
4.5,BOVLHB,"[244, 592, 761, 803, 944, 1062, 1272, 1401]","[803, 1272]","[244, 592, 761, 944, 1062, 1401]","[803, 1272]",1856,8,1848,2,6,1848,0
4.5,BOVLYSOZMA,"[322, 944, 2115, 2374, 3039, 3208, 3255, 4100, 4372, 5771, 6973, 7260, 8654, 9247, 9453]","[3039, 5771, 8654]","[322, 944, 2115, 2374, 3208, 3255, 4100, 4372, 6973, 7260, 9247, 9453]","[3039, 5771, 8654]",12214,15,12199,3,12,12199,0
4.5,BOVLYSOZMB,"[140, 461, 646, 1229, 1662, 1993, 2673, 2843, 3717, 3743, 4005, 4797, 5148, 5241, 5732, 6212, 6807, 6928, 7058, 10002]","[2673, 4005, 6212]","[140, 461, 646, 1229, 1662, 1993, 2843, 3717, 3743, 4797, 5148, 5241, 5732, 6807, 6928, 7058, 10002]","[2673, 4005, 6212]",10204,20,10184,3,17,10184,0
4.5,BOVLYSOZMC,"[905, 2107, 2323, 3388, 4194, 4964, 5325, 6235, 6245]","[905, 2323, 4194]","[2107, 3388, 4964, 5325, 6235, 6245]","[905, 2323, 4194]",8043,9,8034,3,6,8034,0
4.5,BOVMYF5A,"[273, 698, 1398, 1625, 1824, 2895, 3947, 4171, 4583, 4629]","[698, 1625]","[273, 1398, 1824, 2895, 3947, 4171, 4583, 4629]","[698, 1625]",5211,10,5201,2,8,5201,0
4.5,BRHOX22,"[843, 1431, 1815]",[1431],"[843, 1815]",[1431],3434,3,3431,1,2,3431,0
4.5,BRHOX34A,"[588, 981, 2313, 3491]",[981],"[588, 2313, 3491]",[981],3490,4,3486,1,3,3486,0
4.5,BRU12895,"[1135, 1986, 2341]",[1135],"[1986, 2341]",[1135],3232,3,3229,1,2,3229,0
4.5,BTATPAAA,"[296, 740, 826, 1146, 1200, 2314, 2377, 2501, 3383, 3707, 4106, 4188, 5345, 5556, 5729, 5953, 6472, 7770, 7885, 8023, 8311, 9129, 9733]","[740, 2314, 3707, 5729, 7770, 8023, 9129]","[296, 826, 1146, 1200, 2377, 2501, 3383, 4106, 4188, 5345, 5556, 5953, 6472, 7885, 8311, 9733]","[740, 2314, 3707, 5729, 5984, 6337, 6827, 7151, 7770, 8023, 9129]",9907,23,9884,7,16,9880,4
4.5,BTEBGL2,"[294, 310, 327, 658, 1171]","[310, 658]","[294, 327, 1171]","[310, 658]",1833,5,1828,2,3,1828,0
4.5,BTEBGL4,"[294, 310, 327, 658, 815]","[310, 658]","[294, 327, 815]","[310, 658]",1828,5,1823,2,3,1823,0
4.5,BTGL01,"[98, 349, 365, 873, 1008]","[365, 1008]","[98, 349, 873]","[365, 1008]",2040,5,2035,2,3,2035,0
4.5,BTHOR02,"[16, 169, 484, 1123]",[484],"[16, 169, 1123]","[484, 1920]",2419,4,2415,1,3,2414,1
4.5,BTKER6B,"[1008, 1678, 1820, 1925, 2346, 2559, 2913, 4056, 4335, 5608, 5686]","[1678, 2559, 4056]","[1008, 1820, 1925, 2346, 2913, 4335, 5608, 5686]","[1678, 2559, 3070, 3315, 3530, 4056, 4666]",5718,11,5707,3,8,5703,4
4.5,BTSPDNA,"[685, 960, 1054, 1546, 2123]",[],"[685, 960, 1054, 1546, 2123]",[1541],2148,5,2143,0,5,2142,1
4.5,BTSVSP109,"[52, 799, 1452, 1604, 2189, 2359, 2387, 2555, 2863, 5292, 5315, 5643, 6096, 6131, 6451]","[2359, 5292]","[52, 799, 1452, 1604, 2189, 2387, 2555, 2863, 5315, 5643, 6096, 6131, 6451]","[2359, 3984, 5292]",6948,15,6933,2,13,6932,1
4.5,BTTNP2G,"[24, 774, 847, 852, 1115, 1342]",[774],"[24, 847, 852, 1115, 1342]",[774],1841,6,1835,1,5,1835,0
4.5,BTU02285,"[21, 434, 1858, 2334, 2873, 3792, 4169, 4222, 4487, 4780, 5056, 5654]","[3792, 4222, 4487, 4780, 5056]","[21, 434, 1858, 2334, 2873, 4169, 5654]","[3792, 4222, 4487, 4780, 5056]",6388,12,6376,5,7,6376,0
4.5,CALEGLOBIM,"[220, 236, 345, 587, 603, 1185, 1197]","[236, 587]","[220, 345, 603, 1185, 1197]","[236, 587]",1690,7,1683,2,5,1683,0
4.5,CBUEGLOBIM,"[220, 236, 345, 587, 603, 874, 1185, 1197]","[236, 587]","[220, 345, 603, 874, 1185, 1197]","[236, 587]",1690,8,1682,2,6,1682,0
4.5,CCALAC,"[436, 1178, 1358, 1852, 2409, 3275]","[1358, 1852, 2409]","[436, 1178, 3275]","[1358, 1852, 2409]",3619,6,3613,3,3,3613,0
4.5,CCBEGLOBIM,"[221, 237, 587, 1191, 1203]","[237, 587]","[221, 1191, 1203]","[237, 587]",1695,5,1690,2,3,1690,0
4.5,CCBEGLOBIN,"[222, 238, 589, 1194, 1206]","[238, 589]","[222, 1194, 1206]","[238, 589]",1698,5,1693,2,3,1693,0
4.5,CCGHG,"[283, 863, 1051, 1389, 1778, 2305]","[283, 1051, 1778]","[863, 1389, 2305]","[283, 706, 1051, 1778]",2830,6,2824,3,3,2823,1
4.5,CCGONBS1,[1767],[1767],[],"[1767, 2072]",3463,1,3462,1,0,3461,1
4.5,CCGONBS2,[1785],[1785],[],"[1785, 2091]",3482,1,3481,1,0,3480,1
4.5,CCGTHA1,"[26, 166, 302]",[302],"[26, 166]","[302, 572]",1144,3,1141,1,2,1140,1
4.5,CCT64CLU,"[274, 563, 1644, 1664, 2757, 2761, 2766, 3005, 3496, 4518, 4572, 4577, 5272, 5528, 5659, 6121, 6277]","[1644, 2757, 3005, 3496, 5272, 5659]","[274, 563, 1664, 2761, 2766, 4518, 4572, 4577, 5528, 6121, 6277]","[1644, 2757, 3005, 3496, 4514, 5272, 5659]",6276,17,6259,6,11,6258,1
4.5,CEPPINS,"[490, 858, 1399, 1509, 1513, 1760]",[858],"[490, 1399, 1509, 1513, 1760]",[858],1901,6,1895,1,5,1895,0
4.5,CHBLG,"[698, 928, 2301, 2308, 2807, 3794, 4019, 4298, 4700, 4861, 5619, 5756, 6025, 6255, 6280]","[4019, 6025]","[698, 928, 2301, 2308, 2807, 3794, 4298, 4700, 4861, 5619, 5756, 6255, 6280]","[2285, 3090, 4019, 5246, 6025]",8080,15,8065,2,13,8062,3
4.5,CHEBGLI,"[909, 1213]",[909],[1213],"[570, 909]",2204,2,2202,1,1,2201,1
4.5,CHEBGLII,"[547, 563, 580, 912, 1049, 1426]","[563, 912]","[547, 580, 1049, 1426]","[563, 912]",2258,6,2252,2,4,2252,0
4.5,CHKALDB,"[606, 1452, 1506, 1927, 2460, 3115, 4004, 4388, 5731, 5748, 6172, 6664, 6955, 6960, 7504, 8186, 8617, 9185, 10577, 10705, 10844]","[6172, 6664, 6955, 8186, 9185]","[606, 1452, 1506, 1927, 2460, 3115, 4004, 4388, 5731, 5748, 6960, 7504, 8617, 10577, 10705, 10844]","[6172, 6664, 6955, 7265, 8186, 8842, 9185]",11643,21,11622,5,16,11620,2
4.5,CHKAPOII,"[282, 1839, 1891, 2131, 2798, 3317, 3381, 3820]","[3317, 3820]","[282, 1839, 1891, 2131, 2798, 3381]","[3317, 3820]",4953,8,4945,2,6,4945,0
4.5,CHKDPCP,"[347, 637, 1624, 1878]",[637],"[347, 1624, 1878]",[637],1902,4,1898,1,3,1898,0
4.5,CHKMAX,"[632, 727, 1236, 2127, 2291, 2882, 3172, 3400, 3928, 4295, 4931, 5173]","[2127, 2291, 3928, 4295]","[632, 727, 1236, 2882, 3172, 3400, 4931, 5173]","[2127, 2291, 3928, 4295]",5690,12,5678,4,8,5678,0
4.5,CHKMYOD,"[2106, 3379, 3468, 4849, 4941, 5517, 5592, 5660, 6150, 6456, 6527]","[4941, 6150]","[2106, 3379, 3468, 4849, 5517, 5592, 5660, 6456, 6527]","[4941, 6150]",7381,11,7370,2,9,7370,0
4.5,CHKOVAL,"[1390, 2449, 2657, 3164, 3466, 3812, 4176, 4694, 5144, 5170, 6282, 6975, 7079, 7148, 7691, 8334, 8791, 9028]","[3164, 3466, 4176, 4694, 6282]","[1390, 2449, 2657, 3812, 5144, 5170, 6975, 7079, 7148, 7691, 8334, 8791, 9028]","[3164, 3466, 4176, 4694, 5795, 6282]",9198,18,9180,5,13,9179,1
4.5,CHKRPL30,"[545, 571, 671, 749, 801, 916, 1471, 1684, 1872, 2158, 2753, 2816, 2850, 3799]","[801, 1872, 2753]","[545, 571, 671, 749, 916, 1471, 1684, 2158, 2816, 2850, 3799]","[801, 1872, 2753]",3884,14,3870,3,11,3870,0
4.5,CHKRPL37A,"[16, 201, 798, 996, 1265, 1376, 1558, 2125, 2255, 2386, 3052, 3376]","[798, 1376, 2386]","[16, 201, 996, 1265, 1558, 2125, 2255, 3052, 3376]","[798, 1376, 2386]",3465,12,3453,3,9,3453,0
4.5,CHKRPL5G,"[99, 153, 1419, 1632, 2138, 2397, 2618, 3157, 3433, 5165]","[1419, 1632, 3157, 5165]","[99, 153, 2138, 2397, 2618, 3433]","[498, 1419, 1632, 3157, 3955, 5165, 6897]",8313,10,8303,4,6,8300,3
4.5,CHKTUB4B,"[264, 437, 779, 949, 1188, 1469, 1573, 1895]","[437, 949, 1573]","[264, 779, 1188, 1469, 1895]","[437, 949, 1573]",3145,8,3137,3,5,3137,0
4.5,CHKY,"[319, 641, 794, 1650, 1664, 2725, 2858, 3082, 3603, 4199, 4683, 5186, 5213, 5648, 6012, 6249, 6473, 8361]","[3603, 4199, 4683, 5648, 6012, 6249]","[319, 641, 794, 1650, 1664, 2725, 2858, 3082, 5186, 5213, 6473, 8361]","[3603, 4199, 4683, 5648, 6012, 6249]",8364,18,8346,6,12,8346,0
4.5,CHPPHYGEN,"[22, 543, 555, 1818, 2214, 3764, 3786, 4096, 4561, 4599, 4945, 5459, 5471, 5521, 6609, 7000, 7138, 8472, 8746, 8823, 8862, 9395, 9894, 10818, 10833, 10849, 11193, 11828, 11903, 11936, 12603, 13493, 13548]","[4599, 4945]","[22, 543, 555, 1818, 2214, 3764, 3786, 4096, 4561, 5459, 5471, 5521, 6609, 7000, 7138, 8472, 8746, 8823, 8862, 9395, 9894, 10818, 10833, 10849, 11193, 11828, 11903, 11936, 12603, 13493, 13548]","[4599, 4945]",13689,33,13656,2,31,13656,0
4.5,CHPPROTP1A,"[58, 159]",[159],[58],[159],397,2,395,1,1,395,0
4.5,CHPPROTP1B,"[56, 160]",[160],[56],[160],396,2,394,1,1,394,0
4.5,CHWEGLOBIM,"[221, 237, 588, 1193]","[237, 588]","[221, 1193]","[237, 588]",1701,4,1697,2,2,1697,0
4.5,CIGH,"[457, 1281, 2029, 2130, 2536, 2889]","[1281, 2889]","[457, 2029, 2130, 2536]","[1281, 1691, 2280, 2889]",3967,6,3961,2,4,3959,2
4.5,CITEGLOBIM,"[220, 236, 345, 587, 603, 890, 1186, 1198]","[236, 587]","[220, 345, 603, 890, 1186, 1198]","[236, 587]",1691,8,1683,2,6,1683,0
4.5,CJAEGLOBIN,"[221, 237, 588, 1193]","[237, 588]","[221, 1193]","[237, 588]",1702,4,1698,2,2,1698,0
4.5,CJINTERFG,"[191, 2428, 2635, 3158, 3303, 4125, 4187, 4465, 4702, 4750, 5524, 6036, 7468, 8152]","[4187, 4465]","[191, 2428, 2635, 3158, 3303, 4125, 4702, 4750, 5524, 6036, 7468, 8152]","[2881, 4187, 4465]",8519,14,8505,2,12,8504,1
4.5,CL54K,"[183, 512, 535, 649, 706, 771, 959, 1177, 1294, 1538, 1926, 2581, 2696, 2715]",[512],"[183, 535, 649, 706, 771, 959, 1177, 1294, 1538, 1926, 2581, 2696, 2715]",[512],3407,14,3393,1,13,3393,0
4.5,CMBGA2B2,"[383, 718, 810, 989, 1597]","[383, 718]","[810, 989, 1597]","[383, 718]",2684,5,2679,2,3,2679,0
4.5,CMEGA2E2,"[416, 492, 753]","[416, 753]",[492],"[416, 753]",2046,3,2043,2,1,2043,0
4.5,CMU11711,"[15, 204, 790, 1685, 2031, 2627]","[1685, 2031]","[15, 204, 790, 2627]","[1685, 2031]",3163,6,3157,2,4,3157,0
4.5,CPPROT1GN,[164],[164],[],[164],390,1,389,1,0,389,0
4.5,CRASEQB,"[783, 1920, 2825, 3434, 3452, 3464, 3482, 3593, 3635, 3641, 3647, 4931]","[1920, 2825]","[783, 3434, 3452, 3464, 3482, 3593, 3635, 3641, 3647, 4931]","[1920, 2825]",5120,12,5108,2,10,5108,0
4.5,CRUCH7AHYD,"[1205, 1339, 1731, 2936, 2941, 3016, 3418, 3651, 3792, 4121, 5283, 7866, 9375, 9626, 10316]","[1731, 3651, 7866]","[1205, 1339, 2936, 2941, 3016, 3418, 3792, 4121, 5283, 9375, 9626, 10316]","[1731, 3651, 4938, 6076, 7866]",10606,15,10591,3,12,10589,2
4.5,CRUGAD45A,"[208, 859, 1811, 1877, 2063, 2417, 2553, 3555, 4003]","[1877, 2063, 2417]","[208, 859, 1811, 2553, 3555, 4003]","[1877, 2063, 2417]",4427,9,4418,3,6,4418,0
4.5,DMPROTP1,[],[],[],[249],616,0,616,0,0,615,1
4.5,DMU11712,"[16, 792, 1705, 2043]","[1705, 2043]","[16, 792]","[1705, 2043]",3019,4,3015,2,2,3015,0
4.5,DOGCOLIP,"[224, 249, 416, 789, 1108, 1343, 1411, 1747, 2378, 2508, 2694]","[1108, 2378]","[224, 249, 416, 789, 1343, 1411, 1747, 2508, 2694]","[1108, 2378]",3156,11,3145,2,9,3145,0
4.5,DOGIL8T,"[118, 671, 1206, 1406, 1769]","[118, 1406, 1769]","[671, 1206]","[118, 1406, 1769]",2229,5,2224,3,2,2224,0
4.5,ECGLOAP1,"[363, 657, 889, 962, 968]","[363, 657]","[889, 962, 968]","[363, 657]",1133,5,1128,2,3,1128,0
4.5,ECPZA2GL,"[954, 1560, 1585, 1600, 1623, 1728, 2613, 3576, 3650, 3945, 4059]","[3576, 4059]","[954, 1560, 1585, 1600, 1623, 1728, 2613, 3650, 3945]","[3576, 4059]",5081,11,5070,2,9,5070,0
4.5,ECZGL1,"[700, 725, 740, 763, 874, 1033, 1534]","[700, 1534]","[725, 740, 763, 874, 1033]","[700, 1534]",1993,7,1986,2,5,1986,0
4.5,ECZGL2,"[255, 280, 295, 318, 429, 588, 1084]","[255, 1084]","[280, 295, 318, 429, 588]","[255, 1084]",1555,7,1548,2,5,1548,0
4.5,ELMETL,"[1097, 1291]","[1097, 1291]",[],"[1097, 1291]",1865,2,1863,2,0,1863,0
4.5,FDFELDI2,"[276, 678, 1070, 1882, 2011]",[276],"[678, 1070, 1882, 2011]","[276, 970]",2417,5,2412,1,4,2411,1
4.5,FDTNFA,"[187, 291, 547, 790, 885, 972]","[187, 790, 972]","[291, 547, 885]","[187, 790, 972]",1714,6,1708,3,3,1708,0
4.5,GDMYF5G,"[138, 524, 639, 655, 1036, 1104]","[639, 1036]","[138, 524, 655, 1104]","[639, 1036]",1601,6,1595,2,4,1595,0
4.5,GGAC01,"[22, 273, 443, 634, 914, 970, 1119, 1343, 1586, 1666, 2226, 2261, 2602, 2782, 3189, 3495, 3677, 3831, 3857, 4055]","[1666, 2226, 3189, 3677]","[22, 273, 443, 634, 914, 970, 1119, 1343, 1586, 2261, 2602, 2782, 3495, 3831, 3857, 4055]","[1666, 2226, 3189, 3677]",5038,20,5018,4,16,5018,0
4.5,GGACTAC,"[339, 533, 970, 1815, 2127, 2277, 2914, 3032, 3218, 4216, 4398, 5278]","[970, 2127, 2914, 3218, 4398]","[339, 533, 1815, 2277, 3032, 4216, 5278]","[970, 2127, 2914, 3218, 4398]",5455,12,5443,5,7,5443,0
4.5,GGACTI,"[153, 525, 788, 841, 1368, 1554, 1659, 1841]","[841, 1554, 1841]","[153, 525, 788, 1368, 1659]","[404, 841, 1137, 1554, 1841]",2418,8,2410,3,5,2408,2
4.5,GGCALB,"[386, 416, 421, 589, 596, 1016, 1292, 1863, 2289, 3467, 3509, 3617, 3629, 3793, 4414, 5205, 5262, 5867, 5933, 6149, 6694, 6784, 7035, 7824, 8249, 8718, 9052, 10195, 10530]","[386, 1863, 2289, 3467, 3793, 5205, 5933, 6784, 7035, 7824, 8718, 9052, 10195]","[416, 421, 589, 596, 1016, 1292, 3509, 3617, 3629, 4414, 5262, 5867, 6149, 6694, 8249, 10530]","[386, 1863, 2289, 3467, 3793, 4235, 4894, 5205, 5933, 6784, 7035, 7824, 8718, 9052, 9685, 10195]",11060,29,11031,13,16,11028,3
4.5,GGCRYD1,"[267, 441, 910, 2077, 2742, 3516, 3944, 4297, 4332, 4907, 5234, 5498, 5899, 6138, 6395, 6734, 6829, 7213, 7373, 7529]","[441, 2742, 3516, 3944, 4332, 4907, 5234, 5899, 6138, 6395, 6734, 7213]","[267, 910, 2077, 4297, 5498, 6829, 7373, 7529]","[441, 1734, 2742, 3150, 3516, 3944, 4332, 4528, 4907, 5234, 5899, 6138, 6395, 6734, 7213]",8152,20,8132,12,8,8129,3
4.5,GGGL03,"[432, 768, 1160]","[432, 768]",[1160],"[432, 768]",1199,3,1196,2,1,1196,0
4.5,GGGNRHIA,"[338, 1684, 2822, 3048, 3627, 4392, 4544, 5575]","[3627, 4392]","[338, 1684, 2822, 3048, 4544, 5575]","[3627, 4392]",6274,8,6266,2,6,6266,0
4.5,GGNFM1D,"[874, 932, 1295, 1541, 2451, 3184, 3595, 4194, 4284, 4395, 4596, 4768, 5057]",[2451],"[874, 932, 1295, 1541, 3184, 3595, 4194, 4284, 4395, 4596, 4768, 5057]","[2132, 2451]",5630,13,5617,1,12,5616,1
4.5,GGPROP2,"[51, 564]",[],"[51, 564]",[307],640,2,638,0,2,637,1
4.5,GGRIHBGEN,"[202, 219, 254, 676, 981, 1038, 1973, 2863, 2982, 3219, 3317, 3394, 3454]","[2982, 3219, 3454]","[202, 219, 254, 676, 981, 1038, 1973, 2863, 3317, 3394]","[2982, 3219, 3454]",3878,13,3865,3,10,3865,0
4.5,GGVITIIG,"[54, 190, 442, 830, 1596, 2561, 2694, 2948, 2952, 3064, 3138, 3267, 3791, 4295, 4818, 5441, 5848, 6062, 6229, 6443, 7123, 8026, 8302, 8481, 9149, 9467, 10448, 10714, 10951, 10971, 11663, 11667, 12272, 12547, 12791, 13267, 13505, 14077, 14139, 14252, 14413, 15348, 15710, 15771, 15880, 17019, 17299, 17447, 17492, 17815, 17864, 17913, 18829, 18882, 19081, 19128, 19337, 19348, 20096, 20126]","[54, 190, 442, 2694, 2948, 3267, 3791, 4818, 5441, 6229, 6443, 8026, 8302, 9149, 9467, 10448, 10714, 12272, 13267, 13505, 15348, 15771, 17864, 19081]","[830, 1596, 2561, 2952, 3064, 3138, 4295, 5848, 6062, 7123, 8481, 10951, 10971, 11663, 11667, 12547, 12791, 14077, 14139, 14252, 14413, 15710, 15880, 17019, 17299, 17447, 17492, 17815, 17913, 18829, 18882, 19128, 19337, 19348, 20096, 20126]","[54, 190, 442, 2021, 2694, 2948, 3267, 3543, 3791, 4818, 5441, 6229, 6443, 7045, 7268, 8026, 8302, 9149, 9467, 10104, 10448, 10714, 11757, 12272, 12615, 13267, 13505, 14028, 14704, 15348, 15771, 16955, 17864, 19081]",20335,60,20275,24,36,20265,10
4.5,GIBPROTP1A,"[56, 160, 260]",[160],"[56, 260]",[160],393,3,390,1,2,390,0
4.5,GORAFPA,"[75, 999, 1860, 2871, 2955, 3434, 3684, 4151, 4192, 4363, 4369, 4564, 5457, 5602, 6976, 7046, 7766, 7795, 8836, 10041, 10422, 11145, 11629, 11823, 13421, 14087, 14707, 15952, 17195, 19231, 20297, 20427, 20474, 20718, 21186, 22550, 23229, 23233, 23613]","[999, 1860, 2955, 5457, 7766, 11629, 13421, 14087, 14707]","[75, 2871, 3434, 3684, 4151, 4192, 4363, 4369, 4564, 5602, 6976, 7046, 7795, 8836, 10041, 10422, 11145, 11823, 15952, 17195, 19231, 20297, 20427, 20474, 20718, 21186, 22550, 23229, 23233, 23613]","[999, 1860, 2955, 5457, 6760, 7766, 9445, 11629, 13421, 14087, 14707, 16581, 17834]",24599,39,24560,9,30,24556,4
4.5,GORPROTP1A,"[60, 164]",[164],[60],[164],404,2,402,1,1,402,0
4.5,GPIINS,[526],[526],[],[526],1464,1,1463,1,0,1463,0
4.5,HAMAMYLP,"[1394, 1473, 1794, 2308, 3934, 4561, 5045]",[2308],"[1394, 1473, 1794, 3934, 4561, 5045]",[2308],5947,7,5940,1,6,5940,0
4.5,HAMHG5,"[640, 1373, 1640, 2464, 2817, 3433, 3620, 4856, 5603, 6188, 6597, 7240, 7441, 7668, 8258, 8295, 8396, 9231]","[4856, 6188, 6597, 7441]","[640, 1373, 1640, 2464, 2817, 3433, 3620, 5603, 7240, 7668, 8258, 8295, 8396, 9231]","[4856, 5517, 6188, 6597, 7441]",9711,18,9693,4,14,9692,1
4.5,HROAMD1,"[237, 289, 1072, 1585, 2687, 3486, 3830, 4700, 4816, 5962, 6983]","[2687, 3486, 4700]","[237, 289, 1072, 1585, 3830, 4816, 5962, 6983]","[2687, 3486, 4700]",7091,11,7080,3,8,7080,0
4.5,HROMA2,"[427, 686, 739, 1174, 1285]","[739, 1174]","[427, 686, 1285]","[739, 1174]",1779,5,1774,2,3,1774,0
4.5,HROMA4A,"[1055, 1108, 1670, 1774]","[1108, 1670]","[1055, 1774]","[1108, 1670]",2331,4,2327,2,2,2327,0
4.5,HRSPRMI,"[416, 1605, 1880, 2047]",[],"[416, 1605, 1880, 2047]",[722],2198,4,2194,0,4,2193,1
4.5,HS1D3HLH,"[173, 757, 1039, 1231, 1634]",[1039],"[173, 757, 1231, 1634]",[1039],2473,5,2468,1,4,2468,0
4.5,HS2OXOC,"[116, 1162, 1421, 1694, 1719, 1825, 1894, 2227]","[116, 1162, 1421, 1694, 1825]","[1719, 1894, 2227]","[116, 871, 1162, 1421, 1694, 1825]",2510,8,2502,5,3,2501,1
4.5,HSABLGR1,"[371, 902, 1670, 1981, 2923, 2977, 3130, 3140, 3344, 4148, 4166, 4506, 4865, 5312, 5465, 5666, 6508, 6567, 6820, 6977, 8039, 8356, 8470, 8720, 9294, 9507, 10016, 10073, 10400, 10413, 10509, 10623, 11090, 11135, 11354, 11597, 11951, 11988, 11992, 12007, 12239, 12434, 13058, 13875, 15060, 15400, 15514, 15741, 16572, 17116, 17249, 17991, 18211, 20105, 20665, 21219, 23084, 23507, 23851, 24042, 24277, 24298, 24805, 24896, 25292, 25849, 25902, 25906, 26127, 26288, 27114, 29268, 29760, 30552, 31027, 31138, 32399, 32910, 33787, 33826, 34153, 34563, 35562, 35751, 35835]","[8720, 10400, 12434, 15741, 17116, 17991]","[371, 902, 1670, 1981, 2923, 2977, 3130, 3140, 3344, 4148, 4166, 4506, 4865, 5312, 5465, 5666, 6508, 6567, 6820, 6977, 8039, 8356, 8470, 9294, 9507, 10016, 10073, 10413, 10509, 10623, 11090, 11135, 11354, 11597, 11951, 11988, 11992, 12007, 12239, 13058, 13875, 15060, 15400, 15514, 16572, 17249, 18211, 20105, 20665, 21219, 23084, 23507, 23851, 24042, 24277, 24298, 24805, 24896, 25292, 25849, 25902, 25906, 26127, 26288, 27114, 29268, 29760, 30552, 31027, 31138, 32399, 32910, 33787, 33826, 34153, 34563, 35562, 35751, 35835]","[8720, 10400, 12434, 14200, 15741, 17116, 17991]",35954,85,35869,6,79,35868,1
4.5,HSALDCG,"[349, 555, 801, 1283, 2098, 2481, 2641, 2663, 3366, 3386, 3567, 3994, 4434]","[2641, 3366, 3567, 3994]","[349, 555, 801, 1283, 2098, 2481, 2663, 3386, 4434]","[2641, 2939, 3110, 3366, 3567, 3994, 4326]",5190,13,5177,4,9,5174,3
4.5,HSAPC3A,"[110, 226, 636, 919, 1246, 1829, 2140, 2325, 2515, 3409, 3492, 4222, 4662, 4679]",[919],"[110, 226, 636, 1246, 1829, 2140, 2325, 2515, 3409, 3492, 4222, 4662, 4679]","[919, 1178]",6039,14,6025,1,13,6024,1
4.5,HSAPOA2B,"[232, 245, 338, 490, 698, 916, 1554]","[490, 916]","[232, 245, 338, 698, 1554]","[490, 916]",1747,7,1740,2,5,1740,0
4.5,HSAPOAIA,"[57, 317, 661, 1397, 2090]","[317, 661]","[57, 1397, 2090]","[317, 661]",2183,5,2178,2,3,2178,0
4.5,HSAPOAIT,"[231, 491, 835, 1572, 2265]","[491, 835]","[231, 1572, 2265]","[491, 835]",2377,5,2372,2,3,2372,0
4.5,HSAPOC2G,"[231, 255, 606, 1276, 1494, 1553, 1971, 2021, 2346, 2479, 2714, 2943]",[2714],"[231, 255, 606, 1276, 1494, 1553, 1971, 2021, 2346, 2479, 2943]","[2714, 3041]",3832,12,3820,1,11,3819,1
4.5,HSAQUPN2,"[431, 632, 917]","[431, 632]",[917],"[431, 632, 746]",987,3,984,2,1,983,1
4.5,HSARYLA,"[275, 1238, 1571, 1906, 2141, 2252, 2470, 2528, 2666, 3040]","[1238, 1571, 2252, 2470]","[275, 1906, 2141, 2528, 2666, 3040]","[848, 1238, 1571, 1815, 2252, 2470, 2823]",3629,10,3619,4,6,3616,3
4.5,HSAT3,"[646, 655, 825, 2225, 2451, 2846, 3311, 4422, 4823, 4978, 5095, 5311, 5717, 6015, 6059, 6879, 6934, 7225, 7231, 8072, 8536, 9717, 10089, 10401, 10948, 11303, 11320, 12719, 13056, 13775]","[646, 3311, 6059, 10401]","[655, 825, 2225, 2451, 2846, 4422, 4823, 4978, 5095, 5311, 5717, 6015, 6879, 6934, 7225, 7231, 8072, 8536, 9717, 10089, 10948, 11303, 11320, 12719, 13056, 13775]","[646, 3311, 6059, 7102, 8303, 10401]",14198,30,14168,4,26,14166,2
4.5,HSATPCP1,"[496, 831, 1257, 4036, 4773, 4843, 5389, 5525, 5934, 6382, 6830, 6843, 6860, 6999, 7267, 7698, 7854, 8207, 8701, 8714, 9101]","[5389, 6382, 7267]","[496, 831, 1257, 4036, 4773, 4843, 5525, 5934, 6830, 6843, 6860, 6999, 7698, 7854, 8207, 8701, 8714, 9101]","[5389, 6382, 7267]",9449,21,9428,3,18,9428,0
4.5,HSATPCP2,"[107, 1546, 2996, 3624, 4013, 4738, 4743, 5367, 6152, 6916, 7310, 7490, 8252, 8957, 9194, 9637, 9689, 9752, 10918, 11516, 11602, 12497, 13435]","[7490, 10918]","[107, 1546, 2996, 3624, 4013, 4738, 4743, 5367, 6152, 6916, 7310, 8252, 8957, 9194, 9637, 9689, 9752, 11516, 11602, 12497, 13435]","[7490, 10195, 10918]",15008,23,14985,2,21,14984,1
4.5,HSB3A,"[580, 1843, 1940, 2085, 2623, 2640, 2670, 3203]",[1843],"[580, 1940, 2085, 2623, 2640, 2670, 3203]",[1843],3675,8,3667,1,7,3667,0
4.5,HSBGPG,"[151, 560, 817, 856, 1096, 1340, 1593, 1645]","[560, 1096]","[151, 817, 856, 1340, 1593, 1645]","[560, 850, 1096]",1667,8,1659,2,6,1658,1
4.5,HSBSF2,"[238, 477, 1242, 1621, 2450, 2930, 2956, 3601, 4317, 4427, 4505, 4715, 4943]","[1242, 3601]","[238, 477, 1621, 2450, 2930, 2956, 4317, 4427, 4505, 4715, 4943]","[1242, 1587, 2748, 3601]",5953,13,5940,2,11,5938,2
4.5,HSCBMYHC,"[297, 369, 649, 1577, 2258, 2583, 2868, 3193, 3218, 3592, 3819, 3932, 4595, 4921, 5041, 5485, 5644, 6160, 6694, 7246, 7567, 7735, 7912, 8354, 8647, 8898, 9174, 9885, 10877, 11339, 12155, 12229, 12303, 12427, 12825, 12829, 13037, 13342, 14042, 14210, 14394, 14571, 15416, 15784, 17120, 18228, 18590, 18734, 18777, 18896, 19262, 19970, 20057, 20604, 21839, 22088, 22474, 22643, 23209, 23454, 23701, 23830]","[4595, 5041, 5485, 5644, 6694, 7246, 7567, 8354, 8898, 9174, 10877, 11339, 12155, 12427, 12829, 13342, 14210, 14571, 17120, 18228, 18590, 18896, 19262, 19970, 20604, 21839, 22088, 22474, 23454, 23701]","[297, 369, 649, 1577, 2258, 2583, 2868, 3193, 3218, 3592, 3819, 3932, 4921, 6160, 7735, 7912, 8647, 9885, 12229, 12303, 12825, 13037, 14042, 14394, 15416, 15784, 18734, 18777, 20057, 22643, 23209, 23830]","[4595, 5041, 5485, 5644, 6354, 6529, 6694, 7246, 7567, 8354, 8898, 9174, 9626, 10530, 10877, 11339, 12155, 12427, 12829, 13342, 14210, 14571, 15900, 17120, 18228, 18590, 18896, 19262, 19970, 20319, 20604, 21466, 21839, 22088, 22474, 23454, 23701]",24992,62,24930,30,32,24923,7
4.5,HSCD14G,"[159, 763]",[159],[763],[159],1562,2,1560,1,1,1560,0
4.5,HSCKBG,"[876, 1075, 1341, 1619, 1824, 2124, 2380, 2570, 2638, 2643, 3521]","[1341, 1619, 1824, 2380, 3521]","[876, 1075, 2124, 2570, 2638, 2643]","[1341, 1619, 1824, 2380, 3174, 3521]",4192,11,4181,5,6,4180,1
4.5,HSCOMT2,"[589, 1075, 2378, 2897]",[2378],"[589, 1075, 2897]","[1630, 1959, 2378]",3643,4,3639,1,3,3637,2
4.5,HSCPH70,"[205, 297, 633, 773, 865, 2936, 3675, 3831, 4204, 4407, 4801]","[4204, 4407, 4801]","[205, 297, 633, 773, 865, 2936, 3675, 3831]","[1729, 4204, 4407, 4801]",6703,11,6692,3,8,6691,1
4.5,HSCSF1PO,"[359, 496, 779, 1965, 2385, 2816, 3283, 4479, 5647, 6579, 6651, 7061, 7314, 7572, 7831, 7943, 8115, 8250, 8287, 8486, 8680, 8694, 8699, 8843, 8847, 8876, 8943, 9217, 9575, 9882, 10227, 10249, 10517, 11059, 11063, 11092, 11515, 11707, 11723, 12975, 13021, 14683, 15036, 15733, 16061, 17882, 18046, 18156, 18208, 18350, 18465, 18756, 19403, 19724, 20123, 21307, 21311, 21444, 23668, 24072, 24260, 24806, 25690, 25817, 26044, 26605, 26732, 26837, 26963, 27465, 30172, 30823, 30890, 31040, 31663, 31739, 31942, 32108, 32301, 32402, 32862, 33816, 34006, 34015, 34038, 34399]","[1965, 7572, 8287, 10227, 11063, 15036, 17882, 18156, 18465, 20123, 26605, 26837, 27465, 30823, 31040, 32108, 32301, 34006]","[359, 496, 779, 2385, 2816, 3283, 4479, 5647, 6579, 6651, 7061, 7314, 7831, 7943, 8115, 8250, 8486, 8680, 8694, 8699, 8843, 8847, 8876, 8943, 9217, 9575, 9882, 10249, 10517, 11059, 11092, 11515, 11707, 11723, 12975, 13021, 14683, 15733, 16061, 18046, 18208, 18350, 18756, 19403, 19724, 21307, 21311, 21444, 23668, 24072, 24260, 24806, 25690, 25817, 26044, 26732, 26963, 30172, 30890, 31663, 31739, 31942, 32402, 32862, 33816, 34015, 34038, 34399]","[1965, 7572, 8287, 10227, 11063, 15036, 17882, 18156, 18465, 20123, 26605, 26837, 27465, 28627, 30823, 31040, 32108, 32301, 33091, 34006]",35092,86,35006,18,68,35004,2
4.5,HSCST3G,"[271, 1145, 1328, 2342, 3064, 3155, 3443, 3468, 3694, 3783, 3865, 3938, 4129, 5518, 6231, 6448, 7112]","[1328, 3694]","[271, 1145, 2342, 3064, 3155, 3443, 3468, 3783, 3865, 3938, 4129, 5518, 6231, 6448, 7112]","[1328, 3694]",7284,17,7267,2,15,7267,0
4.5,HSCYCLA,"[1029, 1422, 2406, 2954, 3668, 3731, 4168, 4520, 5338, 5389, 5911, 6070, 6323, 6667, 6982, 7956, 8113]","[2406, 3731, 4168, 5338, 5911, 6667]","[1029, 1422, 2954, 3668, 4520, 5389, 6070, 6323, 6982, 7956, 8113]","[1393, 2406, 3731, 4168, 5338, 5911, 6667]",8355,17,8338,6,11,8337,1
4.5,HSCYP216,"[255, 302, 879, 1278, 1466, 1475, 1836, 2215, 2402]","[255, 879, 1278, 1466, 1836, 2215, 2402]","[302, 1475]","[255, 442, 879, 1088, 1278, 1466, 1836, 2215, 2402]",2763,9,2754,7,2,2752,2
4.5,HSCYP45C,"[185, 731, 947, 1772, 2667, 4603, 4680, 4942, 4963, 5008, 5624, 5801, 6016, 6248, 6562, 6935]","[4942, 5624, 5801, 6016, 6248]","[185, 731, 947, 1772, 2667, 4603, 4680, 4963, 5008, 6562, 6935]","[4942, 5624, 5801, 6016, 6248]",7546,16,7530,5,11,7530,0
4.5,HSCYTOK17,"[396, 452, 488, 581, 1709, 2079, 2304, 2928, 2935, 3066, 3245, 3257, 3468, 4000, 4123, 4987]","[581, 1709, 2304, 3066, 4000, 4123]","[396, 452, 488, 2079, 2928, 2935, 3245, 3257, 3468, 4987]","[581, 1709, 2304, 3066, 3693, 4000, 4123]",5252,16,5236,6,10,5235,1
4.5,HSCYTOK20,"[1277, 1871, 3128, 3978, 4019, 5152, 5281, 5352, 8722, 9313, 9470, 9984, 10005, 10828, 11940, 12705, 12783, 16190, 16343, 16498, 16620, 16791]","[5281, 9470, 9984, 11940, 12705]","[1277, 1871, 3128, 3978, 4019, 5152, 5352, 8722, 9313, 10005, 10828, 12783, 16190, 16343, 16498, 16620, 16791]","[5281, 7512, 9470, 9984, 10271, 11940, 12705]",18053,22,18031,5,17,18029,2
4.5,HSDAO,"[588, 956, 1177, 1381, 1635, 1665, 1751, 2551, 3236, 3885, 5744, 6426, 6696, 7431, 7766, 8329, 8880, 9013]","[6426, 7431, 9013]","[588, 956, 1177, 1381, 1635, 1665, 1751, 2551, 3236, 3885, 5744, 6696, 7766, 8329, 8880]","[6426, 7431, 9013]",9895,18,9877,3,15,9877,0
4.5,HSERPG,"[628, 1340, 1683, 1774, 1943, 2474, 2768]","[628, 1340, 1683, 2474]","[1774, 1943, 2768]","[628, 1340, 1683, 2474]",3390,7,3383,4,3,3383,0
4.5,HSFAU1,"[335, 505, 655, 857, 1096, 1129, 1557, 1592, 1613]","[857, 1096, 1613]","[335, 505, 655, 1129, 1557, 1592]","[857, 1096, 1613]",2008,9,1999,3,6,1999,0
4.5,HSFESFPS,"[13, 1227, 1248, 1553, 1650, 3180, 3873, 4008, 4522, 4547, 5405, 5924, 6240, 6445, 6767, 7150, 7330, 7634, 7757, 7836, 8052, 8069, 8546, 8720, 8782, 9151, 9176, 9371, 10015, 11511, 11788, 12062, 12225]","[1227, 1553, 5405, 5924, 6240, 6445, 7150, 7634, 8069, 8782, 9151, 9371, 10015]","[13, 1248, 1650, 3180, 3873, 4008, 4522, 4547, 6767, 7330, 7757, 7836, 8052, 8546, 8720, 9176, 11511, 11788, 12062, 12225]","[1227, 1553, 3023, 3336, 5405, 5598, 5924, 6240, 6445, 7150, 7634, 8069, 8782, 9151, 9371, 9768, 10015]",12255,33,12222,13,20,12218,4
4.5,HSGCSFG,"[264, 404, 690, 735, 744, 748, 1230, 1521]","[404, 744, 1230, 1521]","[264, 690, 735, 748]","[404, 744, 1230, 1521]",2952,8,2944,4,4,2944,0
4.5,HSGEBCMA,"[334, 607, 700, 1294, 1496, 1545, 1648, 2292, 3234, 3273, 3292, 3607]","[607, 1496]","[334, 700, 1294, 1545, 1648, 2292, 3234, 3273, 3292, 3607]","[607, 1496]",3711,12,3699,2,10,3699,0
4.5,HSGGL2,"[164, 202, 547, 1055, 1067]","[202, 547]","[164, 1055, 1067]","[202, 547]",1620,5,1615,2,3,1615,0
4.5,HSGLA,"[852, 868, 885, 901, 955, 1822, 2011, 2148, 2472, 4062, 4149, 6958, 6983, 8378, 8413, 9335, 10329, 10359, 10369, 10708, 11761]","[8413, 10708]","[852, 868, 885, 901, 955, 1822, 2011, 2148, 2472, 4062, 4149, 6958, 6983, 8378, 9335, 10329, 10359, 10369, 11761]","[1374, 5269, 7447, 8413, 10293, 10708]",12428,21,12407,2,19,12403,4
4.5,HSGROW2,"[211, 345, 462, 1091]","[345, 1091]","[211, 462]","[345, 762, 1091, 1349]",1956,4,1952,2,2,1950,2
4.5,HSGSTM4,"[37, 522, 1262, 1357, 2098, 2142, 2232, 2469, 2670, 3516, 3953, 3984, 3991]","[37, 1262, 2469, 2670]","[522, 1357, 2098, 2142, 2232, 3516, 3953, 3984, 3991]","[37, 391, 874, 1262, 1458, 2469, 2670]",4834,13,4821,4,9,4818,3
4.5,HSGTRH,"[442, 515, 1193, 1847, 2111, 2205, 2322, 2809, 3141, 3816, 5548, 6275, 6449, 6552]","[2205, 3816]","[442, 515, 1193, 1847, 2111, 2322, 2809, 3141, 5548, 6275, 6449, 6552]","[2205, 3816]",7216,14,7202,2,12,7202,0
4.5,HSHMG17G,"[283, 1538, 1793, 2037, 2279, 2524, 2946, 3403, 3415, 3620, 4021, 4342, 4469, 5920, 7188]","[2524, 3415, 3620, 4021]","[283, 1538, 1793, 2037, 2279, 2946, 3403, 4342, 4469, 5920, 7188]","[2524, 3415, 3620, 4021, 4553]",7187,15,7172,4,11,7171,1
4.5,HSHNRNPA,"[49, 707, 814, 868, 1086, 1159, 1494, 1789, 1936, 2295, 2481, 2511, 2660, 2869, 3229, 3602, 3773, 3962, 4312]","[814, 1494, 1936, 2295, 2481, 2660, 2869, 3962]","[49, 707, 868, 1086, 1159, 1789, 2511, 3229, 3602, 3773, 4312]","[814, 1494, 1936, 2295, 2481, 2660, 2869, 3962]",5360,19,5341,8,11,5341,0
4.5,HSHOX51,"[760, 1278, 1425, 1651, 1791, 2052, 2201, 2393, 2415, 3022, 4023, 4748, 6206]",[2052],"[760, 1278, 1425, 1651, 1791, 2201, 2393, 2415, 3022, 4023, 4748, 6206]",[2052],6297,13,6284,1,12,6284,0
4.5,HSHSC70,"[27, 305, 777, 913, 1245, 1313, 1773, 2250, 2893, 3307, 3734, 3841, 4735, 4819, 5378]","[1245, 1773, 2250, 2893, 3307, 3734]","[27, 305, 777, 913, 1313, 3841, 4735, 4819, 5378]","[1245, 1773, 2250, 2893, 3307, 3734, 4114]",5400,15,5385,6,9,5384,1
4.5,HSIFNAR,"[329, 549, 583, 616, 631, 830, 869, 1356, 1404, 1540, 2696, 4612, 5386, 5843, 7976, 8182, 8594, 9219, 10423, 10677, 10800, 11325, 11655, 13828, 13884, 14172, 15464, 15482, 16062, 16944, 17681, 19188, 19442, 20036, 20346, 20795, 21132, 21239, 21261, 22130, 22538, 22586, 22719, 23136, 23783, 24341, 25061, 25777, 26285, 27236, 27880, 28142, 28272, 29018, 29554, 29885, 30214, 30452, 30489, 31769]","[830, 11325, 16944, 19188, 19442, 21132, 25061, 29554]","[329, 549, 583, 616, 631, 869, 1356, 1404, 1540, 2696, 4612, 5386, 5843, 7976, 8182, 8594, 9219, 10423, 10677, 10800, 11655, 13828, 13884, 14172, 15464, 15482, 16062, 17681, 20036, 20346, 20795, 21239, 21261, 22130, 22538, 22586, 22719, 23136, 23783, 24341, 25777, 26285, 27236, 27880, 28142, 28272, 29018, 29885, 30214, 30452, 30489, 31769]","[830, 11325, 16944, 19188, 19442, 21132, 25061, 25314, 28679, 29554]",32898,60,32838,8,52,32836,2
4.5,HSIFNG,"[136, 1897, 2175, 2413, 2446, 3213, 3631, 3690, 5167, 5305]","[1897, 2175]","[136, 2413, 2446, 3213, 3631, 3690, 5167, 5305]","[589, 1897, 2175]",5953,10,5943,2,8,5942,1
4.5,HSIL1AG,"[1617, 1987, 2208, 2641, 2949, 3215, 3631, 3939, 4118, 4326, 4847, 5019, 5343, 5580, 6433, 7384, 7940, 9436, 9875]","[2208, 3215, 4326, 6433, 7940]","[1617, 1987, 2641, 2949, 3631, 3939, 4118, 4847, 5019, 5343, 5580, 7384, 9436, 9875]","[2208, 3215, 4326, 6433, 7940]",11962,19,11943,5,14,11943,0
4.5,HSIL1B,"[1352, 1515, 1565, 2240, 2528, 3144, 6039, 7406, 9336]","[2528, 3144, 6039, 7406]","[1352, 1515, 1565, 2240, 9336]","[2528, 3144, 5327, 6039, 7406]",9703,9,9694,4,5,9693,1
4.5,HSINT2,"[439, 516, 1156, 2792, 3197, 3471, 3549, 8668, 8973, 9331, 9480, 10216, 10232, 10273, 10458, 10533, 10644, 10708]","[1156, 3549]","[439, 516, 2792, 3197, 3471, 8668, 8973, 9331, 9480, 10216, 10232, 10273, 10458, 10533, 10644, 10708]","[1156, 3549]",11600,18,11582,2,16,11582,0
4.5,HSL7A,"[1408, 2073, 2867, 3525, 4052, 4164, 4259, 4564, 4572, 4919]","[2073, 2867, 3525, 4164, 4572, 4919]","[1408, 4052, 4259, 4564]","[2073, 2867, 3525, 3881, 4164, 4572, 4919]",5498,10,5488,6,4,5487,1
4.5,HSLCATG,"[991, 1352, 1590, 1629, 1672, 1881, 2266, 2574, 2609, 4200, 4458, 5051, 5372, 5638, 5873, 6402, 6574]","[991, 1881, 2266, 2574]","[1352, 1590, 1629, 1672, 2609, 4200, 4458, 5051, 5372, 5638, 5873, 6402, 6574]","[991, 1881, 2076, 2266, 2574]",6893,17,6876,4,13,6875,1
4.5,HSMECDAG,"[230, 471, 716, 1393, 1456, 1805, 2149, 2517, 2584, 2588, 2593, 2601, 2776, 2870, 2966, 3072, 3170, 3202, 3353, 3544, 3673, 3852, 3939, 4095]","[1393, 2517, 2776, 2966, 3544, 3852]","[230, 471, 716, 1456, 1805, 2149, 2584, 2588, 2593, 2601, 2870, 3072, 3170, 3202, 3353, 3673, 3939, 4095]","[1393, 2517, 2776, 2966, 3544, 3852]",4362,24,4338,6,18,4338,0
4.5,HSMED,"[36, 52, 277, 636, 789, 967, 1354, 1506, 1774, 1943, 1998, 2186, 4833]","[1354, 1943]","[36, 52, 277, 636, 789, 967, 1506, 1774, 1998, 2186, 4833]","[1354, 1943, 2315, 4716]",5284,13,5271,2,11,5269,2
4.5,HSMT1H,"[20, 196, 396, 442, 816, 1475, 2125]","[816, 1475]","[20, 196, 396, 442, 2125]","[816, 1475]",2134,7,2127,2,5,2127,0
4.5,HSNCAMX1,"[280, 1256, 1550, 1609, 1794, 2245, 2381, 2470, 2486, 2537, 2808, 4142, 4157, 4190, 4778, 6582, 6983, 7569, 7640, 7795, 7852, 8529, 8552, 9068, 9248, 9373, 9522, 10015, 10317, 10722, 11249, 11509, 11667, 11710, 11726, 11870, 12072, 12467, 12550, 12786, 13049, 13357, 13684, 13893, 14002]","[1609, 4142, 4778, 6582, 6983, 7569, 7852, 8529, 9068, 9373, 10015, 10317, 10722, 11667, 12072, 12550, 12786, 13049, 13893, 14002]","[280, 1256, 1550, 1794, 2245, 2381, 2470, 2486, 2537, 2808, 4157, 4190, 7640, 7795, 8552, 9248, 9522, 11249, 11509, 11710, 11726, 11870, 12467, 13357, 13684]","[1609, 4142, 4778, 5218, 6315, 6582, 6983, 7316, 7569, 7852, 8529, 8809, 9068, 9373, 9571, 10015, 10317, 10722, 11667, 12072, 12283, 12550, 12786, 13049, 13487, 13893, 14002]",16280,45,16235,20,25,16228,7
4.5,HSNFM,"[417, 432, 1822, 2243, 2675, 3772, 3849, 4491, 5057, 5343]","[1822, 2675]","[417, 432, 2243, 3772, 3849, 4491, 5057, 5343]","[1822, 2675]",6228,10,6218,2,8,6218,0
4.5,HSODCG,"[362, 735, 1002, 1938, 2912, 3007, 3454, 3745, 3968, 4192, 4433, 4649, 5028, 5421, 5633, 7111, 7208, 7306, 7614, 8052, 8090, 8214, 8842, 8854]","[4192, 4649, 5028, 5421, 5633, 7111, 7306, 7614]","[362, 735, 1002, 1938, 2912, 3007, 3454, 3745, 3968, 4433, 7208, 8052, 8090, 8214, 8842, 8854]","[4192, 4649, 5028, 5421, 5633, 5893, 7111, 7306, 7614]",9035,24,9011,8,16,9010,1
4.5,HSODF2,"[4, 131, 158, 964, 993, 1375]",[],"[4, 131, 158, 964, 993, 1375]",[600],1422,6,1416,0,6,1415,1
4.5,HSPAT133,"[393, 654, 762, 794, 1126, 1173, 1447, 3711]",[1447],"[393, 654, 762, 794, 1126, 1173, 3711]",[1447],3712,8,3704,1,7,3704,0
4.5,HSPLAPL,"[403, 599, 808, 827, 1192, 1225]","[403, 599, 827]","[808, 1192, 1225]","[403, 599, 827]",1274,6,1268,3,3,1268,0
4.5,HSPRB3L,"[386, 566, 789, 896, 1103, 1412, 1537, 2934, 3083, 3376]","[566, 1537]","[386, 789, 896, 1103, 1412, 2934, 3083, 3376]","[566, 1537]",4508,10,4498,2,8,4498,0
4.5,HSPRB4S,"[97, 518, 693, 913, 1018, 1534, 1565, 1658, 2384, 2812, 2957, 3999]","[693, 1658]","[97, 518, 913, 1018, 1534, 1565, 2384, 2812, 2957, 3999]","[693, 1658]",5805,12,5793,2,10,5793,0
4.5,HSPSAG,"[46, 447, 872, 1848, 3544, 3611, 3866, 3987, 4044, 4080, 4493]","[447, 1848, 4044]","[46, 872, 3544, 3611, 3866, 3987, 4080, 4493]","[447, 1848, 3764, 4044]",5865,11,5854,3,8,5853,1
4.5,HSRPII145,"[449, 588, 908, 1071, 1097, 1102, 1181, 1233, 1378, 1535, 1688, 1729]","[449, 588, 908, 1071, 1233]","[1097, 1102, 1181, 1378, 1535, 1688, 1729]","[449, 588, 908, 1071, 1233]",2085,12,2073,5,7,2073,0
4.5,HSRPS7,"[115, 284, 404, 415, 516, 1599, 1831, 2166, 2369, 2530, 2551, 3329, 3383, 4254, 5088, 5100, 5409, 5736, 5912, 6064, 6068, 6325, 6429]","[2166, 2369, 4254]","[115, 284, 404, 415, 516, 1599, 1831, 2530, 2551, 3329, 3383, 5088, 5100, 5409, 5736, 5912, 6064, 6068, 6325, 6429]","[2166, 2369, 3108, 4254, 6734]",7505,23,7482,3,20,7480,2
4.5,HSSAA1B,"[862, 1009, 1543, 1831, 2345, 2367, 3845, 3876, 4013, 4697, 4712, 4744]","[1543, 3845]","[862, 1009, 1831, 2345, 2367, 3876, 4013, 4697, 4712, 4744]","[1543, 3845]",4815,12,4803,2,10,4803,0
4.5,HSSHBG,"[1016, 1058, 2672, 2810, 2867, 3148]","[1058, 3148]","[1016, 2672, 2810, 2867]","[472, 696, 1058, 1551, 1938, 2205, 3148]",3802,6,3796,2,4,3791,5
4.5,HSSSPN1AG,"[418, 589, 1434, 1635, 1809, 2330, 3028, 3360, 3491, 4053]","[1635, 1809, 3360, 3491]","[418, 589, 1434, 2330, 3028, 4053]","[1343, 1635, 1809, 3360, 3491]",4088,10,4078,4,6,4077,1
4.5,HSSURF3,"[284, 1033, 1692, 2048, 2160, 2209, 2321, 2415, 2721, 2729, 3074]","[284, 1033, 1692, 2048, 2321, 2729, 3074]","[2160, 2209, 2415, 2721]","[284, 1033, 1692, 2048, 2321, 2729, 3074]",3407,11,3396,7,4,3396,0
4.5,HSTNFB,"[836, 1375, 3015]",[1375],"[836, 3015]","[1375, 1567]",3029,3,3026,1,2,3025,1
4.5,HSTPI1G,"[746, 919, 972, 1558, 1685, 1817, 2035, 2231, 2821, 3181, 3249, 3760, 3846, 4376, 4651, 4849]","[746, 2035, 2231, 2821, 3181]","[919, 972, 1558, 1685, 1817, 3249, 3760, 3846, 4376, 4651, 4849]","[746, 2035, 2231, 2438, 2821, 3181]",4987,16,4971,5,11,4970,1
4.5,HSTUBAG,"[96, 536, 1912, 2065, 2287, 2310, 2584, 3623, 3733, 3759, 3777, 3843]","[536, 2287, 2584]","[96, 1912, 2065, 2310, 3623, 3733, 3759, 3777, 3843]","[536, 2287, 2584]",4079,12,4067,3,9,4067,0
4.5,HSU01102,"[222, 275, 668, 817, 1671, 2082, 2568, 4611]",[668],"[222, 275, 817, 1671, 2082, 2568, 4611]","[668, 3896]",4987,8,4979,1,7,4978,1
4.5,HSU04357,"[97, 1201, 1342, 1882, 1963]","[97, 1342]","[1201, 1882, 1963]","[97, 1342]",2074,5,2069,2,3,2069,0
4.5,HSU04636,"[103, 1018, 1449, 1935, 2199, 2996, 3426, 3608, 3965, 4424, 5359, 5723, 6008, 8301]","[1018, 1935, 2199, 2996, 3608, 4424, 5359, 6008]","[103, 1449, 3426, 3965, 5723, 8301]","[1018, 1935, 2199, 2996, 3608, 4424, 4790, 5359, 6008]",9445,14,9431,8,6,9430,1
4.5,HSU05259,"[164, 782, 814, 951, 2091, 2173, 2435, 2571, 2685, 2859, 3045, 3387, 4128, 5264]","[782, 2685, 3045, 4128]","[164, 814, 951, 2091, 2173, 2435, 2571, 2859, 3387, 5264]","[782, 2685, 3045, 4128]",5662,14,5648,4,10,5648,0
4.5,HSU07807,"[454, 459, 609, 614, 757, 1040, 1991, 2736, 2873, 3386, 4350]","[757, 3386]","[454, 459, 609, 614, 1040, 1991, 2736, 2873, 4350]","[757, 3386]",4831,11,4820,2,9,4820,0
4.5,HSU07983,"[390, 1286]",[390],[1286],[390],1418,2,1416,1,1,1416,0
4.5,HSU08198,"[311, 676, 707, 895, 1072, 1124, 1316, 1392, 1689, 1811, 1845, 1900]","[895, 1124, 1316, 1689, 1811]","[311, 676, 707, 1072, 1392, 1845, 1900]","[583, 895, 1124, 1316, 1689, 1811]",2336,12,2324,5,7,2323,1
4.5,HSU12421,"[227, 311, 1400, 1882, 1941, 2080, 2255, 2434, 2624, 3216, 3242, 3573, 3747, 3869]","[311, 2080]","[227, 1400, 1882, 1941, 2255, 2434, 2624, 3216, 3242, 3573, 3747, 3869]","[311, 2080]",4250,14,4236,2,12,4236,0
4.5,HSUBR,"[957, 1589, 2316, 2324]","[1589, 2324]","[957, 2316]","[1589, 2324]",3287,4,3283,2,2,3283,0
4.5,HSXBXVIII,"[473, 1059, 1189, 1193, 1199, 1213, 2137, 2596, 2723, 3019, 3061, 3123, 3248, 3333, 3339, 3371, 3859, 4456, 4586, 5486, 6115, 6240, 7675, 8302, 8850, 8934, 9475, 9633, 10107, 10425, 10687, 11253, 11405, 11714, 11843, 11870, 12085, 12693]","[11405, 11843, 12085]","[473, 1059, 1189, 1193, 1199, 1213, 2137, 2596, 2723, 3019, 3061, 3123, 3248, 3333, 3339, 3371, 3859, 4456, 4586, 5486, 6115, 6240, 7675, 8302, 8850, 8934, 9475, 9633, 10107, 10425, 10687, 11253, 11714, 11870, 12693]","[11405, 11589, 11843, 12085]",12630,38,12592,3,35,12591,1
4.5,HSZNGP1,"[445, 518, 565, 1142, 2672, 4718, 4777, 5752, 5805, 6347, 6402, 6435, 7275, 8597, 8986, 8991, 9067]","[518, 4718]","[445, 565, 1142, 2672, 4777, 5752, 5805, 6347, 6402, 6435, 7275, 8597, 8986, 8991, 9067]","[518, 4718, 8313]",9815,17,9798,2,15,9797,1
4.5,HUMADAG,"[710, 1241, 1309, 1355, 1609, 1677, 2050, 2405, 2418, 3343, 3737, 4064, 4501, 4549, 4817, 5267, 5278, 5341, 5657, 5773, 6192, 7938, 8160, 8421, 11190, 11568, 11763, 13187, 13416, 13458, 14450, 14833, 15069, 15661, 15857, 17025, 17161, 17205, 17401, 17850, 18465, 19292, 19529, 19940, 20245, 20776, 21006, 21114, 22735, 22747, 23112, 23808, 24224, 24752, 26467, 27206, 28038, 28083, 28362, 28712, 28722, 28987, 29052, 29419, 29939, 30766, 30860, 31115, 31304, 31342, 32470, 32497, 32675, 32916, 33952, 34484, 34578, 34742, 35203, 36268]","[4064, 19292, 26467, 29052, 29939, 31304, 32497, 32675, 32916, 34484, 35203]","[710, 1241, 1309, 1355, 1609, 1677, 2050, 2405, 2418, 3343, 3737, 4501, 4549, 4817, 5267, 5278, 5341, 5657, 5773, 6192, 7938, 8160, 8421, 11190, 11568, 11763, 13187, 13416, 13458, 14450, 14833, 15069, 15661, 15857, 17025, 17161, 17205, 17401, 17850, 18465, 19529, 19940, 20245, 20776, 21006, 21114, 22735, 22747, 23112, 23808, 24224, 24752, 27206, 28038, 28083, 28362, 28712, 28722, 28987, 29419, 30766, 30860, 31115, 31342, 32470, 33952, 34578, 34742, 36268]","[4064, 19292, 26467, 29052, 29939, 31304, 32497, 32675, 32916, 34484, 35203]",36733,80,36653,11,69,36653,0
4.5,HUMADPRF02,"[359, 638, 1308, 1650, 2953, 2972, 3035, 3392, 4213, 4253, 4732, 4870, 5150]","[359, 1308, 1650]","[638, 2953, 2972, 3035, 3392, 4213, 4253, 4732, 4870, 5150]","[359, 1308, 1650]",5159,13,5146,3,10,5146,0
4.5,HUMAPEXN,"[137, 349, 1190, 1364, 1465, 1535, 1863, 2233, 2622, 2850]","[1465, 1863, 2622]","[137, 349, 1190, 1364, 1535, 2233, 2850]","[1465, 1863, 2622]",3722,10,3712,3,7,3712,0
4.5,HUMAPOCII,"[184, 547, 571, 891, 1557, 1778, 1837, 2255, 2305, 2630, 2760, 2995, 3223]",[2995],"[184, 547, 571, 891, 1557, 1778, 1837, 2255, 2305, 2630, 2760, 3223]","[2995, 3321]",4332,13,4319,1,12,4318,1
4.5,HUMAPOE4,"[1064, 1091, 1225, 1294, 1773, 1914, 2365, 2611, 3200, 4032, 4292, 4313]","[1914, 3200]","[1064, 1091, 1225, 1294, 1773, 2365, 2611, 4032, 4292, 4313]","[1914, 3200]",5507,12,5495,2,10,5495,0
4.5,HUMATPGG,"[285, 1445, 1902, 2553, 2677, 4114, 4293, 4578, 5307, 5627, 5882, 6191, 6534, 6749, 7456, 7488, 7885, 8198, 9299, 9436, 9672, 10190, 10354, 10406, 11435, 12074, 14100, 14276, 14537]","[1445, 1902, 2677, 4293, 5307, 6534, 6749, 7456, 8198, 9436, 9672, 10190, 12074, 14100, 14276]","[285, 2553, 4114, 4578, 5627, 5882, 6191, 7488, 7885, 9299, 10354, 10406, 11435, 14537]","[1445, 1727, 1902, 2677, 4293, 4749, 5307, 6118, 6534, 6749, 7456, 8198, 9436, 9672, 9946, 10190, 11405, 12074, 13663, 14100, 14276]",15107,29,15078,15,14,15072,6
4.5,HUMBETGLOA,"[376, 601, 687, 942, 958, 1176, 1311, 2475, 2559]","[958, 1311]","[376, 601, 687, 942, 1176, 2475, 2559]","[958, 1311]",2994,9,2985,2,7,2985,0
4.5,HUMBETGLOB,"[374, 599, 685, 940, 956, 1174, 1309, 2473, 2557]","[956, 1309]","[374, 599, 685, 940, 1174, 2473, 2557]","[956, 1309]",2992,9,2983,2,7,2983,0
4.5,HUMBETGLOC,"[376, 601, 687, 942, 958, 1176, 1311, 2475, 2559]","[958, 1311]","[376, 601, 687, 942, 1176, 2475, 2559]","[958, 1311]",2994,9,2985,2,7,2985,0
4.5,HUMBETGLOD,"[376, 601, 687, 942, 958, 1176, 1311, 2475, 2559]","[958, 1311]","[376, 601, 687, 942, 1176, 2475, 2559]","[958, 1311]",2994,9,2985,2,7,2985,0
4.5,HUMBETGLOE,"[374, 599, 685, 940, 956, 1174, 1309, 2473, 2557]","[956, 1309]","[374, 599, 685, 940, 1174, 2473, 2557]","[956, 1309]",2992,9,2983,2,7,2983,0
4.5,HUMBETGLOF,"[376, 601, 687, 942, 958, 1176, 1311, 2475, 2559]","[958, 1311]","[376, 601, 687, 942, 1176, 2475, 2559]","[958, 1311]",2994,9,2985,2,7,2985,0
4.5,HUMBETGLOG,"[376, 601, 687, 942, 958, 1176, 1311, 2475, 2559]","[958, 1311]","[376, 601, 687, 942, 1176, 2475, 2559]","[958, 1311]",2994,9,2985,2,7,2985,0
4.5,HUMBETGLOH,"[376, 601, 687, 942, 958, 1176, 1311, 2475, 2559]","[958, 1311]","[376, 601, 687, 942, 1176, 2475, 2559]","[958, 1311]",2994,9,2985,2,7,2985,0
4.5,HUMBETGLOI,"[374, 599, 685, 940, 956, 1174, 1309, 2473, 2557]","[956, 1309]","[374, 599, 685, 940, 1174, 2473, 2557]","[956, 1309]",2992,9,2983,2,7,2983,0
4.5,HUMBETGLOJ,"[374, 599, 685, 940, 956, 1174, 1309, 2473, 2557]","[956, 1309]","[374, 599, 685, 940, 1174, 2473, 2557]","[956, 1309]",2992,9,2983,2,7,2983,0
4.5,HUMBETGLOK,"[374, 599, 685, 940, 956, 1174, 1309, 2473, 2557]","[956, 1309]","[374, 599, 685, 940, 1174, 2473, 2557]","[956, 1309]",2992,9,2983,2,7,2983,0
4.5,HUMBETGLOL,"[374, 599, 685, 940, 956, 1174, 1309, 2473, 2557]","[956, 1309]","[374, 599, 685, 940, 1174, 2473, 2557]","[956, 1309]",2992,9,2983,2,7,2983,0
4.5,HUMBETGLOM,"[373, 598, 684, 939, 955, 1173, 1308, 2472, 2556]","[955, 1308]","[373, 598, 684, 939, 1173, 2472, 2556]","[955, 1308]",2991,9,2982,2,7,2982,0
4.5,HUMBETGLON,"[374, 599, 685, 940, 956, 1174, 1309, 2473, 2557]","[956, 1309]","[374, 599, 685, 940, 1174, 2473, 2557]","[956, 1309]",2992,9,2983,2,7,2983,0
4.5,HUMBETGLOO,"[374, 599, 685, 940, 956, 1174, 1309, 2473, 2557]","[956, 1309]","[374, 599, 685, 940, 1174, 2473, 2557]","[956, 1309]",2992,9,2983,2,7,2983,0
4.5,HUMBETGLOP,"[374, 599, 685, 940, 956, 1174, 1309, 2473, 2557]","[956, 1309]","[374, 599, 685, 940, 1174, 2473, 2557]","[956, 1309]",2992,9,2983,2,7,2983,0
4.5,HUMBETGLOR,"[374, 599, 685, 940, 956, 1174, 1309, 2473, 2557]","[956, 1309]","[374, 599, 685, 940, 1174, 2473, 2557]","[956, 1309]",2992,9,2983,2,7,2983,0
4.5,HUMCBRG,"[704, 1220, 2897, 2901, 3041]",[1220],"[704, 2897, 2901, 3041]","[567, 1220]",3318,5,3313,1,4,3312,1
4.5,HUMCHYMASE,"[969, 1185, 1277, 1826, 3165, 3982, 4038, 5216, 5644, 5779, 6037, 7220, 7255, 7455, 7463, 8006, 8052]","[5216, 6037]","[969, 1185, 1277, 1826, 3165, 3982, 4038, 5644, 5779, 7220, 7255, 7455, 7463, 8006, 8052]","[5216, 6037, 6922, 7363]",8107,17,8090,2,15,8088,2
4.5,HUMCP21OH,"[92, 435, 463, 644, 947, 994, 1571, 1970, 2158, 2167, 2528, 2907, 3094, 3659]","[947, 1571, 1970, 2158, 2528, 2907, 3094]","[92, 435, 463, 644, 994, 2167, 3659]","[947, 1134, 1571, 1780, 1970, 2158, 2528, 2907, 3094]",4034,14,4020,7,7,4018,2
4.5,HUMCP21OHC,"[92, 435, 645, 948, 995, 1572, 1971, 2159, 2529, 2908, 3096, 3661]","[948, 1572, 1971, 2159, 2529, 2908, 3096]","[92, 435, 645, 995, 3661]","[948, 1135, 1572, 1781, 1971, 2159, 2529, 2908, 3096]",4036,12,4024,7,5,4022,2
4.5,HUMCS1,"[85, 148, 310, 429, 565, 669, 1334, 1591, 2210]","[565, 1334, 1591]","[85, 148, 310, 429, 669, 2210]","[565, 991, 1334, 1591]",2293,9,2284,3,6,2283,1
4.5,HUMCS3,"[87, 150, 312, 431, 566, 671, 1334, 1588, 2214, 2520]","[566, 1334, 1588]","[87, 150, 312, 431, 671, 2214, 2520]","[566, 991, 1334, 1588]",2732,10,2722,3,7,2721,1
4.5,HUMCSN2A,"[122, 591, 1451, 1845, 2228, 3194, 3776, 4104, 4855, 5391, 5620, 5747, 6682, 6747, 7474, 7789, 8522, 8683, 8805, 9482]","[4855, 5747, 6747, 8522]","[122, 591, 1451, 1845, 2228, 3194, 3776, 4104, 5391, 5620, 6682, 7474, 7789, 8683, 8805, 9482]","[4855, 5747, 6747, 6887, 8522]",10600,20,10580,4,16,10579,1
4.5,HUMCSPA,"[455, 982, 2276, 2929, 3200, 3691]","[982, 2276, 2929]","[455, 3200, 3691]","[982, 2276, 2929, 3392]",4783,6,4777,3,3,4776,1
4.5,HUMCTLA1,"[988, 1812, 2119, 2179, 2297, 2770, 3041, 3122, 3236, 3532, 3695]","[988, 2179, 2770, 3236]","[1812, 2119, 2297, 3041, 3122, 3532, 3695]","[988, 2179, 2770, 3236]",4520,11,4509,4,7,4509,0
4.5,HUMDEF5A,"[296, 500, 923, 1387, 1571, 2323, 2601]",[1571],"[296, 500, 923, 1387, 2323, 2601]",[1571],2872,7,2865,1,6,2865,0
4.5,HUMDZA2G,"[24, 296, 727, 829, 1982, 2003, 2928, 3711, 3942, 5316, 5389, 5436, 6013, 7542, 9590, 9649, 10624, 10677, 11212, 11267, 11300, 12139, 13467, 13857, 13862, 13938]","[5389, 9590]","[24, 296, 727, 829, 1982, 2003, 2928, 3711, 3942, 5316, 5436, 6013, 7542, 9649, 10624, 10677, 11212, 11267, 11300, 12139, 13467, 13857, 13862, 13938]","[5389, 9590, 13183]",14686,26,14660,2,24,14659,1
4.5,HUMELAFIN,"[326, 338, 557, 802, 1351, 1461, 1534]",[326],"[338, 557, 802, 1351, 1461, 1534]",[326],1870,7,1863,1,6,1863,0
4.5,HUMEPOHYDD,"[504, 1107, 1951, 2164, 2190, 2283, 2289, 2972, 3680, 5656, 5997, 6115, 6289, 6422, 6542, 8217, 8696, 9045, 9132, 10475, 11772, 11832, 12105, 12409, 12819, 12928, 13103, 13416, 13804, 13924, 14095, 15227, 15620, 15705, 16085, 16775, 17075, 17080, 17238, 17789, 17810, 17870, 18254, 18573, 18887, 18944, 19204, 19373, 20545, 20683, 20720, 20857, 20883, 20954, 20979, 20994, 21354, 21648, 21945, 22251, 22856, 22952, 23010, 23497, 24312, 24469]","[5656, 8696, 15620, 16085, 16775, 19204, 21354]","[504, 1107, 1951, 2164, 2190, 2283, 2289, 2972, 3680, 5997, 6115, 6289, 6422, 6542, 8217, 9045, 9132, 10475, 11772, 11832, 12105, 12409, 12819, 12928, 13103, 13416, 13804, 13924, 14095, 15227, 15705, 17075, 17080, 17238, 17789, 17810, 17870, 18254, 18573, 18887, 18944, 19373, 20545, 20683, 20720, 20857, 20883, 20954, 20979, 20994, 21648, 21945, 22251, 22856, 22952, 23010, 23497, 24312, 24469]","[5656, 8696, 15620, 16085, 16775, 19204, 21354]",24782,66,24716,7,59,24716,0
4.5,HUMG0S24B,[631],[631],[],[631],3127,1,3126,1,0,3126,0
4.5,HUMG0S8PP,"[91, 660, 784, 942, 1230, 2148, 2152, 2682, 3036, 3768, 3840, 3932, 4113, 4399, 4646, 5361]","[2682, 3768, 3932, 4646]","[91, 660, 784, 942, 1230, 2148, 2152, 3036, 3840, 4113, 4399, 5361]","[2682, 3768, 3932, 4646]",7337,16,7321,4,12,7321,0
4.5,HUMGAD45A,"[927, 1321, 1558, 2457, 2461, 2596, 2968, 3092, 3184, 3645, 3730, 3880, 4167, 4396, 4956]","[2596, 3184, 3645]","[927, 1321, 1558, 2457, 2461, 2968, 3092, 3730, 3880, 4167, 4396, 4956]","[2596, 3184, 3645]",5370,15,5355,3,12,5355,0
4.5,HUMGARE,"[71, 322, 590, 810, 1467, 2243, 2411, 2653, 2861, 3118, 3133, 3207, 3213, 3259, 4469]","[810, 2653, 3118]","[71, 322, 590, 1467, 2243, 2411, 2861, 3133, 3207, 3213, 3259, 4469]","[810, 2239, 2653, 3118]",4746,15,4731,3,12,4730,1
4.5,HUMGCK,"[1514, 1989, 2345, 3096, 3248, 3360, 3789, 3799, 3882, 4312, 4806, 5015, 5092, 5808, 5981, 6475]","[3360, 3882, 4312, 4806, 5015, 6475]","[1514, 1989, 2345, 3096, 3248, 3789, 3799, 5092, 5808, 5981]","[1188, 3360, 3882, 4312, 4806, 5015, 5452, 5964, 6475]",7519,16,7503,6,10,7500,3
4.5,HUMGFP40H,"[910, 1058, 1140, 1173, 1846, 1943, 2593, 2752, 2781, 3126, 4025, 4290]","[910, 1058, 1173, 2593]","[1140, 1846, 1943, 2752, 2781, 3126, 4025, 4290]","[910, 1058, 1173, 2593]",4371,12,4359,4,8,4359,0
4.5,HUMGHG,"[40, 689, 1983, 2636, 2907, 3398]","[689, 1983, 2636]","[40, 2907, 3398]","[689, 1983, 2636, 3099]",4444,6,4438,3,3,4437,1
4.5,HUMGHN,"[85, 148, 434, 569, 673, 1316, 1574, 2439]","[569, 1316, 1574]","[85, 148, 434, 673, 2439]","[569, 989, 1316, 1574]",2649,8,2641,3,5,2640,1
4.5,HUMGHV,"[86, 149, 432, 566, 1328, 1351, 1584, 2443, 2485]","[566, 1328, 1584]","[86, 149, 432, 1351, 2443, 2485]","[566, 998, 1328, 1584]",2652,9,2643,3,6,2642,1
4.5,HUMGSTM4A,"[777, 1272, 1844, 2024, 2098, 2124, 2880, 2925, 3023, 3262, 3463, 4311, 4760, 4791, 4798, 4913]","[777, 2024, 3262, 3463]","[1272, 1844, 2098, 2124, 2880, 2925, 3023, 4311, 4760, 4791, 4798, 4913]","[777, 1139, 1631, 2024, 2225, 3262, 3463]",6074,16,6058,4,12,6055,3
4.5,HUMHMGIY,"[720, 1075, 1472, 2136, 2388, 2558, 3280, 3749, 3875, 3983, 4529, 4627, 4660, 5150, 5496, 6422, 6544, 6687, 7102, 7133, 7166, 7270, 7420, 7962, 8043, 8361, 9286, 9390, 9424, 9791, 10022]","[4660, 6544, 7270]","[720, 1075, 1472, 2136, 2388, 2558, 3280, 3749, 3875, 3983, 4529, 4627, 5150, 5496, 6422, 6687, 7102, 7133, 7166, 7420, 7962, 8043, 8361, 9286, 9390, 9424, 9791, 10022]","[4660, 6544, 7270]",10098,31,10067,3,28,10067,0
4.5,HUMHOX13G,"[380, 503, 2576, 2796]",[],"[380, 503, 2576, 2796]",[811],3062,4,3058,0,4,3057,1
4.5,HUMHPARS1,"[1046, 1300, 1961, 2005, 2632, 3020, 3855, 4744, 5577, 6373, 7164, 7692, 8728, 9344, 9649, 9904, 10183, 10563, 10607, 11363, 11385]","[1046, 2632, 3020, 3855, 4744, 5577]","[1300, 1961, 2005, 6373, 7164, 7692, 8728, 9344, 9649, 9904, 10183, 10563, 10607, 11363, 11385]","[1046, 2632, 3020, 3855, 4744, 5577]",11543,21,11522,6,15,11522,0
4.5,HUMIBP3,"[1260, 1284, 1409, 1556, 1685, 2441, 2457, 2584, 2715, 2845, 2935, 3142, 3356, 3924, 3984, 4247, 4304, 4358, 4406, 4924, 5122, 6617, 7377, 7842, 8353, 8677]","[2441, 6617]","[1260, 1284, 1409, 1556, 1685, 2457, 2584, 2715, 2845, 2935, 3142, 3356, 3924, 3984, 4247, 4304, 4358, 4406, 4924, 5122, 7377, 7842, 8353, 8677]","[2441, 5953, 6617]",10876,26,10850,2,24,10849,1
4.5,HUMIDS,"[372, 636, 1972, 2038, 2248, 2376, 3243, 4119, 4174, 4684, 4778, 4865, 5244, 5385, 5446, 5850, 6178, 8086, 8266, 8364, 9161, 9282, 9391, 9526, 9965, 10120, 10170, 10734, 10877, 11158, 11397, 11928, 12302, 12329, 14418, 14645, 14655, 14702, 15210, 15879, 15901, 16844, 18130, 18552, 18689, 19747, 20044, 21250, 21311, 21624, 21930, 22369, 22809, 23494, 24724, 25810, 25819, 27785, 28773, 28973, 29070, 29338, 29400, 29441, 29555, 29710, 30410, 30535, 30554, 30602, 31004, 31147, 31515, 32027, 32099, 33900, 34645, 35761, 35777, 35958]","[2038, 5244, 8086, 15879]","[372, 636, 1972, 2248, 2376, 3243, 4119, 4174, 4684, 4778, 4865, 5385, 5446, 5850, 6178, 8266, 8364, 9161, 9282, 9391, 9526, 9965, 10120, 10170, 10734, 10877, 11158, 11397, 11928, 12302, 12329, 14418, 14645, 14655, 14702, 15210, 15901, 16844, 18130, 18552, 18689, 19747, 20044, 21250, 21311, 21624, 21930, 22369, 22809, 23494, 24724, 25810, 25819, 27785, 28773, 28973, 29070, 29338, 29400, 29441, 29555, 29710, 30410, 30535, 30554, 30602, 31004, 31147, 31515, 32027, 32099, 33900, 34645, 35761, 35777, 35958]","[1160, 2038, 2882, 5244, 8086, 9847, 15879, 19268]",36837,80,36757,4,76,36753,4
4.5,HUMIGERA,"[68, 1089, 1342, 1601, 1797, 2173, 2574, 3105, 3141, 3416, 4527, 4792, 5168, 6281, 6676, 7019]","[1342, 1797, 3105, 5168]","[68, 1089, 1601, 2173, 2574, 3141, 3416, 4527, 4792, 6281, 6676, 7019]","[1342, 1797, 3105, 5168]",7651,16,7635,4,12,7635,0
4.5,HUMIL2RGA,"[28, 231, 772, 817, 840, 1232, 1476, 1646, 1914, 1980, 2162, 2402, 2683, 3031, 3126, 3353, 4026]","[1476, 2402, 3031, 3353]","[28, 231, 772, 817, 840, 1232, 1646, 1914, 1980, 2162, 2683, 3126, 4026]","[203, 735, 1128, 1476, 2402, 3031, 3353]",4030,17,4013,4,13,4010,3
4.5,HUMIL4A,"[67, 189, 491, 1306, 1626, 2072, 3234, 3254, 4037, 6557, 7003, 7433, 7514, 7981, 8135, 8407, 8461, 8466, 8512, 9400, 9501, 9622]","[1306, 1626, 7003]","[67, 189, 491, 2072, 3234, 3254, 4037, 6557, 7433, 7514, 7981, 8135, 8407, 8461, 8466, 8512, 9400, 9501, 9622]","[1306, 1626, 7003]",9892,22,9870,3,19,9870,0
4.5,HUMIRBPG,"[786, 1819, 1823, 2428, 2776, 3181, 3221, 3550, 4612, 4672, 5069, 5157, 5340, 5556, 6592, 7160, 7261, 8440, 8766, 9262]","[3181, 5157, 7160]","[786, 1819, 1823, 2428, 2776, 3221, 3550, 4612, 4672, 5069, 5340, 5556, 6592, 7261, 8440, 8766, 9262]","[3181, 5157, 7160]",9703,20,9683,3,17,9683,0
4.5,HUMLHDC,"[166, 766, 791, 1727, 2138, 3070, 3735, 3820, 4925, 6016, 7415, 7475, 8890, 8992, 9773, 9823, 10512, 10795, 11183, 11221, 11774, 12252, 12354, 13017, 14169, 14605, 15584, 16409, 16774, 17363, 18253, 18382, 18464, 18855, 19312, 19921, 19951, 20075, 20118, 20143, 20300, 20482, 21661, 22046, 22090, 22140, 22928, 23463, 24666, 24767, 25563, 27104, 27699, 28067, 28493, 28499, 28671, 29151, 30408, 30438, 31819, 32156, 32346]","[7415, 9773, 14605, 15584, 18382, 19312, 20300, 20482, 24666]","[166, 766, 791, 1727, 2138, 3070, 3735, 3820, 4925, 6016, 7475, 8890, 8992, 9823, 10512, 10795, 11183, 11221, 11774, 12252, 12354, 13017, 14169, 16409, 16774, 17363, 18253, 18464, 18855, 19921, 19951, 20075, 20118, 20143, 21661, 22046, 22090, 22140, 22928, 23463, 24767, 25563, 27104, 27699, 28067, 28493, 28499, 28671, 29151, 30408, 30438, 31819, 32156, 32346]","[7415, 9773, 14605, 15584, 18382, 18782, 19312, 20300, 20482, 24666, 29773]",32343,63,32280,9,54,32278,2
4.5,HUMLUCT,"[108, 1550, 1877, 2861]","[1550, 2861]","[108, 1877]","[1550, 2505, 2861]",3288,4,3284,2,2,3283,1
4.5,HUMLYTOXBB,"[1235, 1357, 2157, 2202, 2657, 2734, 2934, 3207, 3330, 3376, 3631, 4333, 4477, 4665, 5291, 5345, 5349, 5530, 6032]","[2934, 3376, 3631]","[1235, 1357, 2157, 2202, 2657, 2734, 3207, 3330, 4333, 4477, 4665, 5291, 5345, 5349, 5530, 6032]","[2934, 3376, 3631]",6297,19,6278,3,16,6278,0
4.5,HUMMCHEMP,"[159, 674, 812, 984, 1077, 1590]","[674, 1590]","[159, 812, 984, 1077]","[674, 1590]",2756,6,2750,2,4,2750,0
4.5,HUMMET2,"[866, 1167, 1233]","[866, 1233]",[1167],"[866, 1233]",1695,3,1692,2,1,1692,0
4.5,HUMMGPA,"[845, 2484, 2515, 3516, 3748, 4493, 6334, 7617]","[3516, 6334]","[845, 2484, 2515, 3748, 4493, 7617]","[3516, 5093, 6334]",7726,8,7718,2,6,7717,1
4.5,HUMMIF,"[700, 753, 912, 1129, 1643]",[1643],"[700, 753, 912, 1129]","[1281, 1643]",2159,5,2154,1,4,2153,1
4.5,HUMMIS,"[623, 669, 778, 1358, 1489, 1639, 1887]","[623, 1358, 1639, 1887]","[669, 778, 1489]","[623, 1358, 1639, 1887]",3092,7,3085,4,3,3085,0
4.5,HUMMKXX,"[870, 1040, 1168, 1415, 1574, 1737, 2202, 2463, 2985, 3142, 3172]","[1415, 1737]","[870, 1040, 1168, 1574, 2202, 2463, 2985, 3142, 3172]","[1415, 1737, 2019]",3300,11,3289,2,9,3288,1
4.5,HUMNKG5PRO,"[843, 1055, 1505, 1644, 1865, 2262, 2639, 2715, 2788, 2915, 3215, 3283, 3580, 3848, 3982, 4048, 5468, 6599]","[2262, 3215, 3848, 5468]","[843, 1055, 1505, 1644, 1865, 2639, 2715, 2788, 2915, 3283, 3580, 3982, 4048, 6599]","[2262, 3215, 3848, 5468]",6738,18,6720,4,14,6720,0
4.5,HUMNTRI,"[1247, 1629, 2145, 2342, 2412, 2615, 2802, 3141, 3151]",[2802],"[1247, 1629, 2145, 2342, 2412, 2615, 3141, 3151]",[2802],3702,9,3693,1,8,3693,0
4.5,HUMNTRIII,"[1247, 1629, 2145, 2342, 2412, 2615, 2802, 3141, 3151]",[2802],"[1247, 1629, 2145, 2342, 2412, 2615, 3141, 3151]",[2802],3702,9,3693,1,8,3693,0
4.5,HUMOSTP,"[214, 970, 1581, 2162, 2358, 3054, 3509, 3657, 3909, 4738, 6004, 6327, 6420, 6480, 6986, 7813, 7897, 8035, 8349, 9372, 10776]","[3509, 3657, 6986, 8349]","[214, 970, 1581, 2162, 2358, 3054, 3909, 4738, 6004, 6327, 6420, 6480, 7813, 7897, 8035, 9372, 10776]","[3509, 3657, 6679, 6986, 8349]",10714,21,10693,4,17,10692,1
4.5,HUMPAP,"[167, 1012, 1410, 1490, 1495, 1970, 2089, 3167, 3342, 3477, 4164, 4478]","[1410, 2089, 3167]","[167, 1012, 1490, 1495, 1970, 3342, 3477, 4164, 4478]","[1410, 2089, 2414, 3167]",4489,12,4477,3,9,4476,1
4.5,HUMPCI,"[284, 312, 1538, 2078, 2124, 2226, 2298, 2586, 2784, 2812, 2930, 3129, 3307, 3575, 4332, 4672, 4697, 4859, 5210, 5543, 7199, 8054, 8384, 8568, 8725, 9209, 9603, 9964, 11275, 11483, 12792, 14117, 14121, 14247, 14982, 15064, 15146]","[8568, 11483]","[284, 312, 1538, 2078, 2124, 2226, 2298, 2586, 2784, 2812, 2930, 3129, 3307, 3575, 4332, 4672, 4697, 4859, 5210, 5543, 7199, 8054, 8384, 8725, 9209, 9603, 9964, 11275, 12792, 14117, 14121, 14247, 14982, 15064, 15146]","[8568, 10898, 11483]",15563,37,15526,2,35,15525,1
4.5,HUMPEM,"[693, 700, 789, 934, 948, 1033, 1537, 2266, 2421, 2614, 2707, 2973, 3203, 3297, 3590, 3745, 3904, 3921]","[934, 2266, 2421, 2707, 2973, 3203]","[693, 700, 789, 948, 1033, 1537, 2614, 3297, 3590, 3745, 3904, 3921]","[934, 2266, 2421, 2707, 2973, 3203]",4235,18,4217,6,12,4217,0
4.5,HUMPEPYYA,"[7, 647, 727, 1201, 1307, 1537, 1699, 1824, 2196, 2243, 2254]",[1201],"[7, 647, 727, 1307, 1537, 1699, 1824, 2196, 2243, 2254]","[1201, 1388]",2370,11,2359,1,10,2358,1
4.5,HUMPF4V1A,"[11, 199, 381, 826]","[381, 826]","[11, 199]","[381, 826]",1460,4,1456,2,2,1456,0
4.5,HUMPHOSA,"[233, 312, 425, 850, 1300, 1494, 1555, 1713, 1810, 2185, 3209, 3729, 4516, 4789]","[233, 850, 1494, 1810, 3209, 3729]","[312, 425, 1300, 1555, 1713, 2185, 4516, 4789]","[233, 850, 1494, 1810, 2323, 2988, 3209, 3729]",4884,14,4870,6,8,4868,2
4.5,HUMPRCA,"[130, 498, 684, 1048, 1687, 2201, 2304, 2309, 2354, 3181, 3438, 3703, 4175, 4778, 5118, 5348, 5452, 5512, 5585, 6604, 8396, 8524, 8580, 8584, 9620, 10055, 10977, 10987, 11461]","[2201, 5118, 5348, 5585, 8396]","[130, 498, 684, 1048, 1687, 2304, 2309, 2354, 3181, 3438, 3703, 4175, 4778, 5452, 5512, 6604, 8524, 8580, 8584, 9620, 10055, 10977, 10987, 11461]","[2201, 3631, 5118, 5348, 5585, 8396, 9387]",11717,29,11688,5,24,11686,2
4.5,HUMPREELAS,"[596, 608, 826, 1070, 1619, 1729, 1802]",[596],"[608, 826, 1070, 1619, 1729, 1802]",[596],2291,7,2284,1,6,2284,0
4.5,HUMPRPHX,"[71, 317, 1143, 1475, 1838, 2127, 2502, 2550, 2869, 3173, 3322, 3633, 3719, 4225]","[1838, 2127, 2869, 3173, 3322, 3633]","[71, 317, 1143, 1475, 2502, 2550, 3719, 4225]","[1346, 1838, 2127, 2652, 2869, 3173, 3322, 3633]",4524,14,4510,6,8,4508,2
4.5,HUMRCC1,"[108, 486, 638, 654, 2711, 4304, 4379, 4555, 4654, 4733, 4737, 5210, 5479, 5545, 5741, 6765, 7271, 10178, 11134, 11415, 12573, 12731, 13006, 13360, 13510, 13819, 14069, 14368, 14604, 14697, 14702, 15108, 15440, 15532, 16316, 16526, 16574, 17950, 18304, 19296, 19855, 20918, 21036, 22033, 22205, 23681, 24194, 24201, 26108, 26218, 26579, 26701, 26808, 26989, 27447, 28010, 28244, 28523, 28793, 28893, 29020, 29247, 29419, 29766, 30085, 30235, 30648, 31672, 33137, 33278, 34406, 34481]","[24201, 26218, 26579, 28010, 28244, 28893, 29247, 29766]","[108, 486, 638, 654, 2711, 4304, 4379, 4555, 4654, 4733, 4737, 5210, 5479, 5545, 5741, 6765, 7271, 10178, 11134, 11415, 12573, 12731, 13006, 13360, 13510, 13819, 14069, 14368, 14604, 14697, 14702, 15108, 15440, 15532, 16316, 16526, 16574, 17950, 18304, 19296, 19855, 20918, 21036, 22033, 22205, 23681, 24194, 26108, 26701, 26808, 26989, 27447, 28523, 28793, 29020, 29419, 30085, 30235, 30648, 31672, 33137, 33278, 34406, 34481]","[24201, 26218, 26579, 28010, 28244, 28893, 29247, 29766]",34633,72,34561,8,64,34561,0
4.5,HUMREGHOM,"[52, 274, 684, 1419, 1864, 1909, 2739, 2825]","[684, 1419, 1864, 2739]","[52, 274, 1909, 2825]","[684, 1419, 1864, 2739]",3403,8,3395,4,4,3395,0
4.5,HUMROD1X,"[1242, 1876, 2227, 2343, 2638, 2695, 2720]","[1242, 1876]","[2227, 2343, 2638, 2695, 2720]","[1242, 1876]",2833,7,2826,2,5,2826,0
4.5,HUMRPIB2,"[435, 472, 510, 899, 1121, 1531, 2268, 2713, 2758, 3588, 3674]","[1531, 2268, 2713, 3588]","[435, 472, 510, 899, 1121, 2758, 3674]","[1531, 2268, 2713, 3588]",4329,11,4318,4,7,4318,0
4.5,HUMRPS6B,"[359, 1059, 1168, 1838, 2178, 3072, 3893, 4051, 4432, 4655, 4838]","[359, 1059, 1838, 2178, 4051]","[1168, 3072, 3893, 4432, 4655, 4838]","[359, 1059, 1838, 2178, 4051]",4964,11,4953,5,6,4953,0
4.5,HUMSEMI,"[578, 793, 806, 975, 1583, 2394, 2547, 2682, 2979, 3074, 3496]",[793],"[578, 806, 975, 1583, 2394, 2547, 2682, 2979, 3074, 3496]",[793],4156,11,4145,1,10,4145,0
4.5,HUMSEMIIB,"[493, 1274, 1298, 1316, 1389, 1889, 1988, 2515, 2616, 3352, 3769, 4271, 4486, 4499, 4660, 4667, 5275, 5328, 5640, 5820, 6000, 6304, 6446, 7146, 7944]",[4486],"[493, 1274, 1298, 1316, 1389, 1889, 1988, 2515, 2616, 3352, 3769, 4271, 4499, 4660, 4667, 5275, 5328, 5640, 5820, 6000, 6304, 6446, 7146, 7944]",[4486],8216,25,8191,1,24,8191,0
4.5,HUMSTATH2,"[353, 1140, 1197, 1553, 1820, 2025, 2131, 2403, 2530, 2848]","[353, 1553]","[1140, 1197, 1820, 2025, 2131, 2403, 2530, 2848]","[353, 1553, 1675]",4715,10,4705,2,8,4704,1
4.5,HUMTBGA,"[854, 1021, 1646, 2681, 3355, 4941, 5164, 5231, 5475, 5530, 6296, 6314, 6841, 7144, 7395, 8219, 8362]","[4941, 7144]","[854, 1021, 1646, 2681, 3355, 5164, 5231, 5475, 5530, 6296, 6314, 6841, 7395, 8219, 8362]","[4941, 6265, 7144]",8761,17,8744,2,15,8743,1
4.5,HUMTCRBRA,[278],[278],[],[278],728,1,727,1,0,727,0
4.5,HUMTHROMA,"[159, 787, 800, 1277, 1605, 1985, 2344, 2384, 2717, 4222, 4394, 4817, 5134, 5715]","[1985, 2344, 2717, 4817]","[159, 787, 800, 1277, 1605, 2384, 4222, 4394, 5134, 5715]","[1985, 2344, 2717, 4817]",6155,14,6141,4,10,6141,0
4.5,HUMTNP2SS,"[80, 86, 177, 658, 673]",[658],"[80, 86, 177, 673]",[658],1774,5,1769,1,4,1769,0
4.5,HUMTPALBU,"[722, 1621, 1708, 2692, 2741, 4361, 4587, 4707, 4720, 5992, 6086]","[1621, 2741, 4361]","[722, 1708, 2692, 4587, 4707, 4720, 5992, 6086]","[1094, 1621, 2741, 3425, 4361]",6164,11,6153,3,8,6151,2
4.5,HUMTRHYAL,"[201, 562, 827, 1120, 1645, 2232, 2340, 2837, 6019, 6556, 8581]",[1645],"[201, 562, 827, 1120, 2232, 2340, 2837, 6019, 6556, 8581]",[1645],9543,11,9532,1,10,9532,0
4.5,HUMTSHB2,"[187, 780]",[187],[780],[187],978,2,976,1,1,976,0
4.5,HUMV2R,"[261, 1366, 1507, 2047, 2128]","[261, 1507]","[1366, 2047, 2128]","[261, 1507]",2274,5,2269,2,3,2269,0
4.5,HYPSCGH,"[41, 806, 889, 1039, 1252, 1624]","[41, 1039, 1624]","[806, 889, 1252]","[41, 451, 1039, 1624]",2476,6,2470,3,3,2469,1
4.5,LAYEGLOBIN,"[222, 238, 584, 1185, 1197, 1373]","[238, 584]","[222, 1185, 1197, 1373]","[238, 584]",1694,6,1688,2,4,1688,0
4.5,LEBGLOB,"[94, 142, 157, 1501, 1539, 1561, 1577, 1663, 1791, 1926, 2206, 3171, 3565]","[1577, 1926]","[94, 142, 157, 1501, 1539, 1561, 1663, 1791, 2206, 3171, 3565]","[1577, 1926]",3638,13,3625,2,11,3625,0
4.5,LNOEGLOBIN,"[236, 345, 587, 603, 1185, 1197]","[236, 587]","[345, 603, 1185, 1197]","[236, 587]",1690,6,1684,2,4,1684,0
4.5,MACHBGA1,"[283, 457, 495, 841, 1370]","[495, 841]","[283, 457, 1370]","[495, 841]",2097,5,2092,2,3,2092,0
4.5,MACHBGA2,"[281, 455, 493, 839, 1367]","[493, 839]","[281, 455, 1367]","[493, 839]",2100,5,2095,2,3,2095,0
4.5,MAMGLUTRA,"[484, 1627, 1718, 2152, 2406, 2745, 2938, 3175, 4252, 4967, 4974, 5131]","[484, 1627, 2745, 2938]","[1718, 2152, 2406, 3175, 4252, 4967, 4974, 5131]","[484, 821, 1255, 1627, 1819, 2745, 2938]",6287,12,6275,4,8,6272,3
4.5,MAU09941,"[613, 1031, 1166, 1803, 1830, 1846, 2427, 2667, 2932, 3134]",[1830],"[613, 1031, 1166, 1803, 1846, 2427, 2667, 2932, 3134]",[1830],3798,10,3788,1,9,3788,0
4.5,MFAPOA2A,"[133, 226, 379, 587, 785, 1422]","[379, 785]","[133, 226, 587, 1422]","[379, 785]",1489,6,1483,2,4,1483,0
4.5,MFAPOC3A,"[115, 232, 642, 1239, 1715, 2232, 2384]",[],"[115, 232, 642, 1239, 1715, 2232, 2384]","[913, 1172]",3254,7,3247,0,7,3245,2
4.5,MMA2IXCOA,"[599, 798, 859, 878, 1383, 1439, 1757, 1812, 1866, 1881, 2935, 3132, 4386, 5665, 5682, 5831, 6355, 6930, 7102, 7250, 7371, 7472, 7658, 7684, 8064, 8135, 8216, 8401, 8539, 8882, 9322, 9467, 9609, 9626, 10270, 10282, 10304, 10930, 11426, 11611, 12074, 12952, 13033, 13111, 13447, 13726, 14575, 15021, 15338, 15597, 15933, 16114, 16240, 16522, 16811, 17106, 17275, 17647, 18283]","[3132, 4386, 5682, 5831, 7102, 7250, 7371, 7684, 8064, 8216, 8401, 8539, 8882, 9322, 9467, 9626, 13033, 13447, 13726, 14575, 15021, 15338, 15597, 15933, 16114, 16240, 16522, 16811, 17275, 17647]","[599, 798, 859, 878, 1383, 1439, 1757, 1812, 1866, 1881, 2935, 5665, 6355, 6930, 7472, 7658, 8135, 9609, 10270, 10282, 10304, 10930, 11426, 11611, 12074, 12952, 13111, 17106, 18283]","[3132, 4386, 5682, 5831, 7102, 7250, 7371, 7684, 8064, 8216, 8401, 8539, 8882, 9322, 9467, 9626, 13033, 13447, 13726, 14575, 15021, 15338, 15597, 15746, 15933, 16114, 16240, 16522, 16811, 17275, 17647]",19471,59,19412,30,29,19411,1
4.5,MMACLGNA,"[474, 499, 553, 918, 1458, 1499, 2537, 2666, 2923, 3107, 3178]","[474, 3178]","[499, 553, 918, 1458, 1499, 2537, 2666, 2923, 3107]","[474, 3178]",3873,11,3862,2,9,3862,0
4.5,MMAPOG,"[143, 265, 536, 1186, 1456, 2056]",[536],"[143, 265, 1186, 1456, 2056]","[536, 806]",2168,6,2162,1,5,2161,1
4.5,MMASM1G,"[1088, 1141, 1492, 2928, 3245, 3367, 3599, 3619, 3745]","[1088, 2928, 3245, 3745]","[1141, 1492, 3367, 3599, 3619]","[1088, 2244, 2928, 3245, 3745]",4767,9,4758,4,5,4757,1
4.5,MMCASEIB,"[2857, 4901, 4916, 5615, 6252, 6603, 6611, 6932, 7023, 7160, 7964, 8222, 9803, 10443, 11712, 11758, 11838, 12928, 13000]","[6252, 7023, 7160, 9803]","[2857, 4901, 4916, 5615, 6603, 6611, 6932, 7964, 8222, 10443, 11712, 11758, 11838, 12928, 13000]","[6252, 7023, 7160, 8126, 8252, 9803]",13046,19,13027,4,15,13025,2
4.5,MMCD24A,"[233, 287, 477, 1126, 1660, 1969, 2486, 3805, 3949, 5478, 6430, 7063]",[2486],"[233, 287, 477, 1126, 1660, 1969, 3805, 3949, 5478, 6430, 7063]",[2486],7632,12,7620,1,11,7620,0
4.5,MMCFOS,"[99, 844, 1850, 2162, 2363, 3414]","[844, 1850, 2363]","[99, 2162, 3414]","[844, 1850, 2363]",3959,6,3953,3,3,3953,0
4.5,MMCOL10A,"[560, 1070, 1193, 1518, 1802, 1964, 2931, 3514, 3918, 4222, 4716, 4974, 5105, 5660, 5765, 6146, 6371, 6407, 6704, 7009, 7101, 7192, 7282, 7335, 9050, 9284, 9322]",[1802],"[560, 1070, 1193, 1518, 1964, 2931, 3514, 3918, 4222, 4716, 4974, 5105, 5660, 5765, 6146, 6371, 6407, 6704, 7009, 7101, 7192, 7282, 7335, 9050, 9284, 9322]",[1802],9323,27,9296,1,26,9296,0
4.5,MMCRPG,"[375, 929]",[375],[929],[375],2132,2,2130,1,1,2130,0
4.5,MMCYTOKNA,"[810, 1089, 1123, 1339, 1881]",[810],"[1089, 1123, 1339, 1881]","[810, 1559]",2551,5,2546,1,4,2545,1
4.5,MMDM2RR,"[104, 665, 854, 878, 1651, 1846, 2407, 2702, 3262, 3378, 3701, 3962, 4663, 4925, 5134, 6030]","[665, 854, 1651, 2702, 3701, 3962, 4925, 5134]","[104, 878, 1846, 2407, 3262, 3378, 4663, 6030]","[665, 854, 1305, 1651, 2702, 3701, 3962, 4925, 5134]",6632,16,6616,8,8,6615,1
4.5,MMDNAASFA,"[542, 855, 918, 1497, 1576, 1823, 2357, 3306, 3558]","[855, 1576, 1823, 2357]","[542, 918, 1497, 3306, 3558]","[855, 1241, 1576, 1823, 2135, 2357, 2695]",4307,9,4298,4,5,4295,3
4.5,MMEZGL,"[589, 637, 802, 910, 1167, 1276, 1599]","[589, 1599]","[637, 802, 910, 1167, 1276]","[589, 1599]",1945,7,1938,2,5,1938,0
4.5,MMG37,"[265, 348, 788, 2119, 2570, 2771, 2788]","[788, 2119, 2570]","[265, 348, 2771, 2788]","[332, 788, 1303, 2119, 2363, 2570]",3065,7,3058,3,4,3055,3
4.5,MMGBCRYA,"[332, 671, 1003, 1718, 2175, 2261, 2662]","[671, 1003]","[332, 1718, 2175, 2261, 2662]","[671, 1003]",2653,7,2646,2,5,2646,0
4.5,MMGCCRYA,"[721, 1056, 1716, 1790, 1807, 2488, 2655]","[721, 1056]","[1716, 1790, 1807, 2488, 2655]","[721, 1056]",2884,7,2877,2,5,2877,0
4.5,MMGFAPD,"[108, 1901, 2449, 2760, 2995, 3351, 3473, 3660, 4335, 4868, 5452, 7117, 7253, 7902, 7907, 8227, 9093, 9788]","[1901, 2995, 4335, 5452, 7907]","[108, 2449, 2760, 3351, 3473, 3660, 4868, 7117, 7253, 7902, 8227, 9093, 9788]","[713, 1624, 1901, 2995, 3906, 4335, 5452, 7907]",9963,18,9945,5,13,9942,3
4.5,MMGGLINE,"[204, 1787, 2076, 2250, 2288, 2634, 3162, 3948, 4417, 4813, 6374, 6664, 6955, 7129, 7167, 7513, 8041, 8852, 9096, 9179, 9641, 11052]","[7167, 7513]","[204, 1787, 2076, 2250, 2288, 2634, 3162, 3948, 4417, 4813, 6374, 6664, 6955, 7129, 8041, 8852, 9096, 9179, 9641, 11052]","[7167, 7513]",11278,22,11256,2,20,11256,0
4.5,MMGK5,"[244, 695, 1805, 1890, 2825, 2850, 3525]","[695, 1805, 2825]","[244, 1890, 2850, 3525]","[695, 1805, 2595, 2825]",3602,7,3595,3,4,3594,1
4.5,MMH2D4Q5,"[159, 644]","[159, 644]",[],"[159, 644]",1100,2,1098,2,0,1098,0
4.5,MMHOX13,"[369, 492, 800, 1037, 1570, 1647, 1651, 2407, 2583, 2798]",[800],"[369, 492, 1037, 1570, 1647, 1651, 2407, 2583, 2798]",[800],2827,10,2817,1,9,2817,0
4.5,MMHOX24I,"[837, 1160, 1264]",[837],"[1160, 1264]",[837],1915,3,1912,1,2,1912,0
4.5,MMIL1BG,"[572, 1356, 1567, 1803, 1938, 4398, 4988, 5080, 5679]","[1356, 1938, 4398, 5679]","[572, 1567, 1803, 4988, 5080]","[1356, 1938, 3680, 4398, 5679]",7092,9,7083,4,5,7082,1
4.5,MMIL3G,"[129, 469, 686, 824, 1913, 2090, 2583]","[686, 824, 1913, 2090]","[129, 469, 2583]","[686, 824, 1913, 2090]",3482,7,3475,4,3,3475,0
4.5,MMIL5G,"[731, 980, 1593, 1625, 2708, 3597, 4806, 5303, 5441]","[731, 1593, 3597]","[980, 1625, 2708, 4806, 5303, 5441]","[731, 1593, 3597]",6719,9,6710,3,6,6710,0
4.5,MMKFGF,"[542, 976, 1045, 1337, 1556, 1624, 2484, 2561, 2886]","[542, 1045]","[976, 1337, 1556, 1624, 2484, 2561, 2886]","[542, 1045]",3981,9,3972,2,7,3972,0
4.5,MMLDHAG,"[105, 1180, 1906, 2132, 2429, 2774, 4167, 4377, 4577, 4824, 5138, 5333, 7171, 7208, 7338, 7668, 7959, 8206, 8280, 8315, 8402, 8414, 8597, 8833, 8981, 9652, 9999, 10704, 11532]","[4577, 7171, 7668, 8597, 10704]","[105, 1180, 1906, 2132, 2429, 2774, 4167, 4377, 4824, 5138, 5333, 7208, 7338, 7959, 8206, 8280, 8315, 8402, 8414, 8833, 8981, 9652, 9999, 11532]","[4577, 5919, 7171, 7668, 8597, 10704]",12843,29,12814,5,24,12813,1
4.5,MMMMP9A,"[1476, 1890, 2008, 2375, 2781, 3064, 3945, 4206, 4321, 4851, 4864, 5695, 5716, 6356, 6564, 7752, 7954]","[2008, 2375, 2781, 3064, 3945, 4206, 5695, 6356, 6564]","[1476, 1890, 4321, 4851, 4864, 5716, 7752, 7954]","[1341, 2008, 2375, 2781, 3064, 3418, 3945, 4206, 5695, 5936, 6356, 6564]",8182,17,8165,9,8,8162,3
4.5,MMMRPS24,"[404, 645, 670, 1106, 1196, 1460, 2253, 2669, 2987, 3137, 3263, 3713, 3934, 5070, 5091]","[404, 1460, 3137]","[645, 670, 1106, 1196, 2253, 2669, 2987, 3263, 3713, 3934, 5070, 5091]","[404, 1460, 1761, 3137]",5491,15,5476,3,12,5475,1
4.5,MMMTIX,"[402, 706, 951, 1355]","[402, 951]","[706, 1355]","[402, 951]",1552,4,1548,2,2,1548,0
4.5,MMMUPBS6,"[731, 792, 1203, 1246, 1614, 2045, 2425, 3236, 3445]","[731, 1203, 2045, 3236]","[792, 1246, 1614, 2425, 3445]","[731, 1203, 2045, 2793, 3236]",4614,9,4605,4,5,4604,1
4.5,MMMYCL,"[580, 806, 919, 1615, 1787, 2042, 2419, 4161, 4673, 4744, 6468, 6484, 6619, 6752, 7477, 7565, 8161]",[1787],"[580, 806, 919, 1615, 2042, 2419, 4161, 4673, 4744, 6468, 6484, 6619, 6752, 7477, 7565, 8161]",[1787],8308,17,8291,1,16,8291,0
4.5,MMNFMG,"[97, 120, 638, 1634, 2540, 4409, 4448, 4619, 4798, 4804, 4855]","[1634, 2540]","[97, 120, 638, 4409, 4448, 4619, 4798, 4804, 4855]","[1634, 2540]",5463,11,5452,2,9,5452,0
4.5,MMNMYC,"[1163, 1210, 1355, 1609, 3549, 3661]",[1163],"[1210, 1355, 1609, 3549, 3661]",[1163],4799,6,4793,1,5,4793,0
4.5,MMNUCLEO,"[784, 863, 1033, 2042, 3040, 3141, 3984, 4071, 4293, 4464, 4694, 4879, 5198, 5879, 6230, 6530, 6879, 7215, 8122, 8304, 8614, 8928, 9050, 9881, 10179, 10436, 10506, 11016]","[2042, 3141, 4293, 4694, 4879, 5198, 6230, 8122, 9050, 9881, 10436]","[784, 863, 1033, 3040, 3984, 4071, 4464, 5879, 6530, 6879, 7215, 8304, 8614, 8928, 10179, 10506, 11016]","[2042, 3141, 4293, 4694, 4879, 5198, 6230, 7517, 8122, 8738, 9050, 9881, 10436]",11470,28,11442,11,17,11440,2
4.5,MMODC2,"[124, 331, 737, 1053, 1374, 1557, 2508, 2523, 2702, 2999, 3433, 4219]","[331, 737, 1053, 1374, 1557, 2508, 2702, 2999]","[124, 2523, 3433, 4219]","[331, 737, 1053, 1374, 1557, 1801, 2508, 2702, 2999]",4252,12,4240,8,4,4239,1
4.5,MMOESTEOP,"[510, 993, 1127, 1662, 1666, 2605, 2742, 2821, 4101, 4452, 4834, 5456, 5607]","[993, 1127, 2821, 4101]","[510, 1662, 1666, 2605, 2742, 4452, 4834, 5456, 5607]","[993, 1127, 2283, 2821, 4101]",5774,13,5761,4,9,5760,1
4.5,MMPO,"[324, 475, 561, 857, 1709, 2446, 2553, 2948, 3054, 3728, 3749, 4769, 5312, 5673, 6805, 6833, 6901, 7167, 7842, 8043, 8109, 8440, 8907, 9716, 9809, 9903, 10001, 10055, 10756, 10894, 11636]","[2446, 2948, 3728, 4769, 7167, 8440, 8907, 9903]","[324, 475, 561, 857, 1709, 2553, 3054, 3749, 5312, 5673, 6805, 6833, 6901, 7842, 8043, 8109, 9716, 9809, 10001, 10055, 10756, 10894, 11636]","[2193, 2446, 2948, 3503, 3728, 4018, 4769, 7167, 8440, 8907, 9903]",11905,31,11874,8,23,11871,3
4.5,MMPPSOMA,"[251, 411, 447, 562, 706, 722, 1034, 1208, 1248, 2049]",[1034],"[251, 411, 447, 562, 706, 722, 1208, 1248, 2049]",[1034],2556,10,2546,1,9,2546,0
4.5,MMPROP2,[631],[],[631],[289],712,1,711,0,1,710,1
4.5,MMPROT1,"[312, 759]",[759],[312],[759],1178,2,1176,1,1,1176,0
4.5,MMPROT2,"[361, 508, 615, 880, 915, 1218, 1469]",[1218],"[361, 508, 615, 880, 915, 1469]",[1218],1568,7,1561,1,6,1561,0
4.5,MMSAP,"[441, 1558]",[441],[1558],[441],1868,2,1866,1,1,1866,0
4.5,MMSCIMIP,"[415, 1017, 1054]","[415, 1017]",[1054],"[415, 1017]",1980,3,1977,2,1,1977,0
4.5,MMSYNDE1A,"[762, 816, 1054, 1345, 1483, 1992, 2151, 2623, 3132, 4826, 4867, 5018, 5772, 6256, 6622, 6741, 7683, 7733, 7828, 7931, 8043, 8442, 9076, 9320, 9867, 10122, 10903, 11397, 11495, 11583, 11858, 12132, 13426, 13599, 13723, 13851, 14080, 14113, 14254, 14623, 14634, 14843, 15172, 15203, 15299, 15845, 16639, 16744, 16770, 17647, 17701, 18837, 19009, 19057, 19424, 19542, 19726, 19767, 20385, 20460, 20515, 20735, 20942, 21888, 22120, 22488, 22707, 22802, 23203]","[1345, 19009, 20385, 20942]","[762, 816, 1054, 1483, 1992, 2151, 2623, 3132, 4826, 4867, 5018, 5772, 6256, 6622, 6741, 7683, 7733, 7828, 7931, 8043, 8442, 9076, 9320, 9867, 10122, 10903, 11397, 11495, 11583, 11858, 12132, 13426, 13599, 13723, 13851, 14080, 14113, 14254, 14623, 14634, 14843, 15172, 15203, 15299, 15845, 16639, 16744, 16770, 17647, 17701, 18837, 19057, 19424, 19542, 19726, 19767, 20460, 20515, 20735, 21888, 22120, 22488, 22707, 22802, 23203]","[1345, 19009, 20385, 20942]",23592,69,23523,4,65,23523,0
4.5,MMTHY1G,"[80, 183, 616, 696, 1009, 1833, 2181]","[80, 1009]","[183, 616, 696, 1833, 2181]","[80, 1009]",2682,7,2675,2,5,2675,0
4.5,MMTLAC,"[140, 299, 748, 912, 1171, 2858, 3092, 3338, 3509, 4297, 4373, 4783, 5339]","[299, 748, 1171, 3092, 3338]","[140, 912, 2858, 3509, 4297, 4373, 4783, 5339]","[299, 748, 1171, 3092, 3338]",5239,13,5226,5,8,5226,0
4.5,MMTNFBG,"[524, 1196, 1553, 1728]",[1728],"[524, 1196, 1553]","[1728, 1911]",3211,4,3207,1,3,3206,1
4.5,MMTROPIB,"[183, 1744, 1749, 1832, 1932, 2033, 2185, 2656, 3037, 3564, 3690, 4580, 4604, 4620, 4748]","[1932, 2185, 2656, 3037, 3564, 4604]","[183, 1744, 1749, 1832, 2033, 3690, 4580, 4620, 4748]","[1697, 1932, 2185, 2656, 3037, 3564, 4604]",5683,15,5668,6,9,5667,1
4.5,MMTUM198,"[120, 347, 1084, 1729, 2808, 2818, 3098, 3313, 3587, 3818, 4180, 4220]","[2818, 3098, 3313, 3587, 3818, 4180]","[120, 347, 1084, 1729, 2808, 4220]","[1692, 2818, 3098, 3313, 3587, 3818, 4180]",4376,12,4364,6,6,4363,1
4.5,MMU01530,"[358, 636, 891, 924, 1080, 1357, 1589, 2269, 3231, 3803, 4904, 5405, 6039, 6229]",[3231],"[358, 636, 891, 924, 1080, 1357, 1589, 2269, 3803, 4904, 5405, 6039, 6229]","[3094, 3231]",6694,14,6680,1,13,6679,1
4.5,MMU02278,"[342, 1041, 1638, 2312, 2344, 3368, 3669, 3873]",[1638],"[342, 1041, 2312, 2344, 3368, 3669, 3873]",[1638],3973,8,3965,1,7,3965,0
4.5,MMU02298,"[475, 603, 1180, 2413, 2874, 3047, 3116, 3911, 3920, 4749, 4794, 4897]","[1180, 2413]","[475, 603, 2874, 3047, 3116, 3911, 3920, 4749, 4794, 4897]","[1180, 2413]",5851,12,5839,2,10,5839,0
4.5,MMU02884,"[668, 814, 1630, 1761, 2107, 2382, 2484, 3386, 4798, 5244, 5291, 5517, 6022, 6642, 6836, 7567, 7973]","[1630, 5244, 6836]","[668, 814, 1761, 2107, 2382, 2484, 3386, 4798, 5291, 5517, 6022, 6642, 7567, 7973]","[1630, 5244, 6836]",8757,17,8740,3,14,8740,0
4.5,MMU04056,"[186, 321, 901, 1382, 1461, 1857, 1865, 2490, 2509, 2667, 2711, 2747, 2902, 3530, 4688, 6264, 6477, 7683, 7979, 8633, 8664, 8680, 8895, 10317, 10794, 10876, 10998, 11259, 11441, 11797, 12211, 13211, 13933, 14104, 14615, 15270, 15417, 15506, 15545, 15620, 15870, 16230, 16348, 16561, 16710, 16734, 16994, 17245, 18100, 19860, 20602, 21185]","[1382, 3530, 4688, 7979, 8895, 10317, 10876, 11259, 12211, 16230, 16561]","[186, 321, 901, 1461, 1857, 1865, 2490, 2509, 2667, 2711, 2747, 2902, 6264, 6477, 7683, 8633, 8664, 8680, 10794, 10998, 11441, 11797, 13211, 13933, 14104, 14615, 15270, 15417, 15506, 15545, 15620, 15870, 16348, 16710, 16734, 16994, 17245, 18100, 19860, 20602, 21185]","[1382, 3530, 4688, 7979, 8895, 10317, 10876, 11259, 12211, 13491, 16230, 16561]",21710,52,21658,11,41,21657,1
4.5,MMU04827,"[105, 2280, 2512, 2767, 3555, 3684, 4281, 4301, 4969, 5286, 5444, 5675, 7133, 7369, 7592]","[3684, 4281, 4969]","[105, 2280, 2512, 2767, 3555, 4301, 5286, 5444, 5675, 7133, 7369, 7592]","[3684, 4281, 4969]",7600,15,7585,3,12,7585,0
4.5,MMU07568,"[84, 267, 482, 527]","[84, 267, 482]",[527],"[84, 267, 482]",743,4,739,3,1,739,0
4.5,MMU07808,"[61, 183, 404, 542, 547, 673, 987, 1179, 1697, 1762, 2384]","[673, 1697]","[61, 183, 404, 542, 547, 987, 1179, 1762, 2384]","[673, 1697]",2840,11,2829,2,9,2829,0
4.5,MMU09741,"[245, 1076, 1094, 1230, 1655, 2034]","[245, 1230]","[1076, 1094, 1655, 2034]","[245, 1230]",2844,6,2838,2,4,2838,0
4.5,MMU09964,"[375, 510, 803, 857, 1295, 1299, 1968, 2490, 2680, 2697, 3428, 3448, 3796, 4303, 4607, 5091, 5726, 5730, 5793, 5977, 6890, 7525, 7760, 7962, 8162, 8460, 8601, 9017, 9311, 9980, 10372, 11246]","[1968, 3428, 4303, 4607, 7962, 8162, 8601, 9017, 9311]","[375, 510, 803, 857, 1295, 1299, 2490, 2680, 2697, 3448, 3796, 5091, 5726, 5730, 5793, 5977, 6890, 7525, 7760, 8460, 9980, 10372, 11246]","[1968, 3428, 4303, 4607, 7962, 8162, 8601, 9017, 9311, 10875]",11454,32,11422,9,23,11421,1
4.5,MMU10098,"[593, 1155, 1173, 1624, 3270, 3509, 3596, 5292, 5593, 5695, 5812]","[1173, 3509]","[593, 1155, 1624, 3270, 3596, 5292, 5593, 5695, 5812]","[1173, 3509]",6117,11,6106,2,9,6106,0
4.5,MMU11054,"[185, 204, 2250]",[],"[185, 204, 2250]","[457, 1418, 1996]",2564,3,2561,0,3,2558,3
4.5,MMU11713,"[250, 288, 634]","[288, 634]",[250],"[288, 634]",1759,3,1756,2,1,1756,0
4.5,MMU12029,"[17, 297, 342, 381, 582, 1264, 1385, 1410, 1897, 2082]","[582, 1264]","[17, 297, 342, 381, 1385, 1410, 1897, 2082]","[582, 1264]",2255,10,2245,2,8,2245,0
4.5,MMU12273,"[38, 389, 680, 1085, 1434, 1740, 1940]","[680, 1085, 1740]","[38, 389, 1434, 1940]","[680, 1085, 1740]",2575,7,2568,3,4,2568,0
4.5,MMU12559,"[62, 247, 822]",[247],"[62, 822]",[247],918,3,915,1,2,915,0
4.5,MMU12560,"[62, 247, 257]",[247],"[62, 257]",[247],920,3,917,1,2,917,0
4.5,MMU12561,"[62, 247, 420, 820]",[247],"[62, 420, 820]",[247],916,4,912,1,3,912,0
4.5,MMU12562,"[62, 247]",[247],[62],[247],918,2,916,1,1,916,0
4.5,MMU12565,"[62, 247, 396]",[247],"[62, 396]",[247],1043,3,1040,1,2,1040,0
4.5,MMU13921,"[10, 162, 820, 856, 952, 1867, 2003, 2197, 2354, 3036, 3401, 3525, 3990, 4034]","[952, 2003, 2354, 3990]","[10, 162, 820, 856, 1867, 2197, 3036, 3401, 3525, 4034]","[952, 2003, 2354, 2693, 2930, 3241, 3990]",4670,14,4656,4,10,4653,3
4.5,MMU14421,"[1322, 1867, 1887, 3681, 3799, 3848, 3867, 3920, 4195, 4470, 4560, 5864]",[],"[1322, 1867, 1887, 3681, 3799, 3848, 3867, 3920, 4195, 4470, 4560, 5864]","[3668, 4237, 4502, 4814]",6254,12,6242,0,12,6238,4
4.5,MMVITRO,"[8, 1025, 1425, 2054, 2071, 2693, 2718, 2783, 2826, 3279, 3755, 3812, 3820, 3855, 3863, 4941, 4985, 4996]","[2054, 2693, 3279]","[8, 1025, 1425, 2071, 2718, 2783, 2826, 3755, 3812, 3820, 3855, 3863, 4941, 4985, 4996]","[1845, 2054, 2474, 2693, 3017, 3279, 4355]",4996,18,4978,3,15,4974,4
4.5,MMVPREB2,"[172, 214, 379, 908, 930]",[379],"[172, 214, 908, 930]",[379],1045,5,1040,1,4,1040,0
4.5,MMVPREB3,"[172, 214, 379, 908]",[379],"[172, 214, 908]",[379],1045,4,1041,1,3,1041,0
4.5,MNKEGLOBIM,"[221, 237, 583, 1184, 1196]","[237, 583]","[221, 1184, 1196]","[237, 583]",1693,5,1688,2,3,1688,0
4.5,MNKEGLOBIN,"[221, 237, 583, 1182, 1194]","[237, 583]","[221, 1182, 1194]","[237, 583]",1691,5,1686,2,3,1686,0
4.5,MNKHGBGGAG,"[75, 92, 249, 287, 633, 1064, 1338]","[287, 633]","[75, 92, 249, 1064, 1338]","[287, 633]",1697,7,1690,2,5,1690,0
4.5,MNPROP2,[620],[],[620],[278],696,1,695,0,1,694,1
4.5,MUS8HS20,"[257, 271, 940, 962, 1015, 1360, 1625, 2562]",[940],"[257, 271, 962, 1015, 1360, 1625, 2562]",[940],2622,8,2614,1,7,2614,0
4.5,MUSAP,"[110, 499, 810, 931, 1012, 3574, 4509, 4539, 4740, 4971, 5230, 5290, 5529, 5547, 5619, 6013, 6067, 6406, 6709, 7890, 8019]","[3574, 4509, 4740, 4971, 5290, 5619, 6406, 6709]","[110, 499, 810, 931, 1012, 4539, 5230, 5529, 5547, 6013, 6067, 7890, 8019]","[3574, 3815, 4034, 4509, 4740, 4971, 5290, 5619, 5952, 6406, 6709]",8086,21,8065,8,13,8062,3
4.5,MUSAP5A,"[354, 551, 651, 697, 786, 1768, 2428, 2463, 2681, 2759, 3332, 3355, 4614, 6254, 6685, 6816]","[2428, 2759, 4614]","[354, 551, 651, 697, 786, 1768, 2463, 2681, 3332, 3355, 6254, 6685, 6816]","[2428, 2759, 4614]",6821,16,6805,3,13,6805,0
4.5,MUSAPEX,"[300, 768, 1042, 1394, 1684, 2089, 2436, 2742, 2942]","[1684, 2089, 2742]","[300, 768, 1042, 1394, 2436, 2942]","[1684, 2089, 2742]",4034,9,4025,3,6,4025,0
4.5,MUSAPOAII,"[112, 474, 723, 1155, 1543]","[723, 1155]","[112, 474, 1543]","[723, 1155]",2952,5,2947,2,3,2947,0
4.5,MUSAPOIVA,"[63, 588, 975, 1385, 2299, 2774, 2898, 2929]","[588, 975]","[63, 1385, 2299, 2774, 2898, 2929]","[588, 975]",3012,8,3004,2,6,3004,0
4.5,MUSBMP4,"[336, 510, 664, 768, 1064, 1068, 2095, 2149, 2473, 2683, 2888, 3967, 4135, 4495, 4806, 5497, 5725, 6380, 7179, 7951, 9626]",[7179],"[336, 510, 664, 768, 1064, 1068, 2095, 2149, 2473, 2683, 2888, 3967, 4135, 4495, 4806, 5497, 5725, 6380, 7951, 9626]",[7179],9660,21,9639,1,20,9639,0
4.5,MUSBNP,"[336, 412, 488, 753, 903, 1449]","[336, 753]","[412, 488, 903, 1449]","[336, 753]",1460,6,1454,2,4,1454,0
4.5,MUSCD14A,"[176, 543, 777, 1122]",[176],"[543, 777, 1122]",[176],1865,4,1861,1,3,1861,0
4.5,MUSCRKNB,"[96, 460, 1440, 1904, 2245, 2455, 2658, 2796, 2829, 2879, 3505, 3842, 3862]","[1904, 2245, 2455, 2796, 3505, 3842]","[96, 460, 1440, 2658, 2829, 2879, 3862]","[1904, 2245, 2455, 2796, 3505, 3842]",4513,13,4500,6,7,4500,0
4.5,MUSCYTCOVB,"[724, 1081, 1319, 1925, 1946, 2066, 2234]","[724, 1319]","[1081, 1925, 1946, 2066, 2234]","[724, 1319, 1585]",2532,7,2525,2,5,2524,1
4.5,MUSENDOBA,"[135, 807, 1066, 1507, 2117, 2130, 2614, 2743, 3027, 3115, 3350, 3618, 3892, 4049, 4342, 4371, 4430, 4898, 5090, 5527, 5589, 5616, 5696, 5700, 5817, 5969, 6358, 6980, 7007, 7151, 7585]","[2743, 3618, 4049, 5090, 5589]","[135, 807, 1066, 1507, 2117, 2130, 2614, 3027, 3115, 3350, 3892, 4342, 4371, 4430, 4898, 5527, 5616, 5696, 5700, 5817, 5969, 6358, 6980, 7007, 7151, 7585]","[2743, 3618, 4049, 4853, 5090, 5589]",7871,31,7840,5,26,7839,1
4.5,MUSFAUA,"[760, 846, 925, 1249, 1496, 2068, 2103, 2124]","[1249, 1496, 2124]","[760, 846, 925, 2068, 2103]","[1249, 1496, 2124]",2842,8,2834,3,5,2834,0
4.5,MUSFERHC,"[483, 526, 1103, 1827, 2185, 2319]","[483, 1827, 2185]","[526, 1103, 2319]","[483, 1827, 2185]",2782,6,2776,3,3,2776,0
4.5,MUSFKBP13X,"[321, 736, 904, 928, 1282, 1556]","[321, 736, 904, 1282]","[928, 1556]","[321, 736, 904, 1282]",1573,6,1567,4,2,1567,0
4.5,MUSGAD45,"[559, 935, 1126, 1458, 1542, 1595, 2647, 3023]","[935, 1126, 1458]","[559, 1542, 1595, 2647, 3023]","[935, 1126, 1458]",3092,8,3084,3,5,3084,0
4.5,MUSGFJE,"[624, 709, 1098, 1489]","[624, 1489]","[709, 1098]","[624, 1489]",2403,4,2399,2,2,2399,0
4.5,MUSGPOAD,"[1044, 1324, 1737, 2306, 2538, 2898, 4403, 4816, 4916, 5083, 5342, 5400, 7929]","[1044, 2306, 4403, 4916]","[1324, 1737, 2538, 2898, 4816, 5083, 5342, 5400, 7929]","[1044, 2306, 4403, 4916]",8068,13,8055,4,9,8055,0
4.5,MUSHBBH0,"[163, 365, 914, 1012, 1112, 1265, 1566, 2081]","[365, 914]","[163, 1012, 1112, 1265, 1566, 2081]","[365, 914]",2127,8,2119,2,6,2119,0
4.5,MUSHBBH1,"[249, 451, 780, 1417, 1493]","[451, 780]","[249, 1417, 1493]","[451, 780]",1918,5,1913,2,3,1913,0
4.5,MUSHES1,"[355, 556, 784, 1108, 1121, 1351, 1367, 1400, 1839, 2208]","[556, 784, 1108]","[355, 1121, 1351, 1367, 1400, 1839, 2208]","[556, 784, 1108]",2817,10,2807,3,7,2807,0
4.5,MUSHOX35A,"[232, 612, 1308, 1715, 2007, 2661, 3150, 3519]",[1308],"[232, 612, 1715, 2007, 2661, 3150, 3519]",[1308],3847,8,3839,1,7,3839,0
4.5,MUSIL1RN,"[168, 512, 886, 1676, 1922, 2186, 2289, 2483, 2789, 3549, 3938, 5269, 6210]","[512, 2483, 3549]","[168, 886, 1676, 1922, 2186, 2289, 2789, 3938, 5269, 6210]","[512, 2483, 3549]",6342,13,6329,3,10,6329,0
4.5,MUSKE3A,"[21, 340, 544, 981, 1088, 1328, 1562, 1604, 1881, 2052, 2194, 3218, 3339, 3400, 3405]","[21, 544, 3218, 3400]","[340, 981, 1088, 1328, 1562, 1604, 1881, 2052, 2194, 3339, 3405]","[21, 544, 3218, 3400]",3612,15,3597,4,11,3597,0
4.5,MUSLMP7A,"[429, 487, 535, 1318, 1354, 1407, 2293, 2454, 3029, 3046]","[1318, 2454, 3029]","[429, 487, 535, 1354, 1407, 2293, 3046]","[1318, 2153, 2454, 3029, 3674]",4259,10,4249,3,7,4247,2
4.5,MUSLTA,"[530, 1207, 1632, 1807]",[1807],"[530, 1207, 1632]","[1807, 1990]",3286,4,3282,1,3,3281,1
4.5,MUSMC26,"[816, 843, 1906, 2419, 2475, 3190, 3415, 3666, 3682, 3716, 4182]","[2419, 3190]","[816, 843, 1906, 2475, 3415, 3666, 3682, 3716, 4182]","[2419, 3190, 4144]",5386,11,5375,2,9,5374,1
4.5,MUSOGC,"[113, 489]","[113, 489]",[],"[113, 290, 489]",941,2,939,2,0,938,1
4.5,MUSOGCA,"[214, 285, 866, 1043, 1242]","[866, 1043, 1242]","[214, 285]","[866, 1043, 1242]",1694,5,1689,3,2,1689,0
4.5,MUSOGCB,"[113, 290, 490]","[113, 290, 490]",[],"[113, 290, 490]",942,3,939,3,0,939,0
4.5,MUSPNMT,"[955, 1076, 1665, 1881, 2135, 2343, 2450, 2755]","[1665, 2343]","[955, 1076, 1881, 2135, 2450, 2755]","[1665, 2343]",3136,8,3128,2,6,3128,0
4.5,MUSPROTA,"[585, 1945, 2033, 2585, 3224, 3663]","[1945, 2585, 3224, 3663]","[585, 2033]","[1945, 2585, 3224, 3663]",4636,6,4630,4,2,4630,0
4.5,MUSPROTEB,"[337, 496, 594, 647, 993, 1024, 1482, 1920, 1988, 2130]","[337, 594, 993, 1988]","[496, 647, 1024, 1482, 1920, 2130]","[337, 594, 993, 1988]",2389,10,2379,4,6,2379,0
4.5,MUSPRPC2,"[801, 2455, 2470, 2740, 3019, 3778, 3833, 4186, 5493, 6797]",[801],"[2455, 2470, 2740, 3019, 3778, 3833, 4186, 5493, 6797]",[801],7298,10,7288,1,9,7288,0
4.5,MUSPRPMPB,"[801, 1480, 2974]",[801],"[1480, 2974]",[801],3566,3,3563,1,2,3563,0
4.5,MUSREGI,"[775, 1159, 1258, 1965, 2230, 2450, 2993]","[1159, 2230, 2993]","[775, 1258, 1965, 2450]","[1159, 1799, 2230, 2993]",3748,7,3741,3,4,3740,1
4.5,MUSREGII,"[530, 927, 1626, 1988, 2023, 2927, 3233]","[927, 1626, 1988]","[530, 2023, 2927, 3233]","[927, 1626, 1988, 3091]",3924,7,3917,3,4,3916,1
4.5,MUSROM1X,"[219, 983, 1030, 1242, 1848, 2169, 2555, 2616, 2640]","[1242, 1848]","[219, 983, 1030, 2169, 2555, 2616, 2640]","[1242, 1848]",2779,9,2770,2,7,2770,0
4.5,MUSRPL30,"[500, 660, 960, 1050, 1331, 1679, 2459, 3124, 3243, 3441]","[660, 1050, 2459]","[500, 960, 1331, 1679, 3124, 3243, 3441]","[660, 1050, 2459]",3468,10,3458,3,7,3458,0
4.5,MUSRPS16,"[17, 475, 758, 1210, 1311, 1868, 2005]","[1868, 2005]","[17, 475, 758, 1210, 1311]","[450, 687, 1868, 2005]",2641,7,2634,2,5,2632,2
4.5,MUSS100B,"[213, 342, 1710, 1721, 1778, 4920, 5082, 5219, 5329, 6291, 6880, 7045, 8033, 8061, 8612, 8671, 8736]",[4920],"[213, 342, 1710, 1721, 1778, 5082, 5219, 5329, 6291, 6880, 7045, 8033, 8061, 8612, 8671, 8736]",[4920],8865,17,8848,1,16,8848,0
4.5,MUSSERPROA,"[217, 1034, 1449, 2092, 2739, 3178, 3371]","[1449, 2092, 2739, 3178]","[217, 1034, 3371]","[1449, 2092, 2739, 3178]",4449,7,4442,4,3,4442,0
4.5,MUSSSATGN,"[613, 840, 1162, 1346, 1825, 2165, 2516, 2905, 3039, 3233, 3612, 3706, 3892]","[840, 1162, 1346, 2905, 3039]","[613, 1825, 2165, 2516, 3233, 3612, 3706, 3892]","[840, 1162, 1346, 2905, 3039]",4058,13,4045,5,8,4045,0
4.5,MUSTCP,"[453, 470, 908, 1005, 1993, 2463, 2496, 2781, 3172, 3270, 3576, 3642, 4019, 4278, 4687, 6098, 6552, 7230, 7512, 7562]","[453, 1993, 3270, 4278, 4687, 6098, 6552, 7230, 7512]","[470, 908, 1005, 2463, 2496, 2781, 3172, 3576, 3642, 4019, 7562]","[453, 1705, 1993, 3270, 3746, 4278, 4687, 6098, 6552, 7230, 7512]",9253,20,9233,9,11,9231,2
4.5,MUSTHY1,"[80, 183, 616, 696, 1009, 1833, 2181]","[80, 1009]","[183, 616, 696, 1833, 2181]","[80, 1009]",2682,7,2675,2,5,2675,0
4.5,MUSTLAG,"[261, 269, 547, 705, 1155, 1314, 1573, 2128, 3260, 3494, 3740, 4788, 5201]","[705, 1155, 1573, 3494, 3740]","[261, 269, 547, 1314, 2128, 3260, 4788, 5201]","[705, 1155, 1573, 3494, 3740]",5412,13,5399,5,8,5399,0
4.5,MUSTSHBA2,"[388, 464, 830, 1045]",[464],"[388, 830, 1045]",[464],1283,4,1279,1,3,1279,0
4.5,MUSY1GLOB,"[377, 690, 1066, 1224, 1249]","[377, 690]","[1066, 1224, 1249]","[377, 690]",1745,5,1740,2,3,1740,0
4.5,OABBGLOB,"[33, 192, 525, 692, 958, 1174, 1309, 2701]","[958, 1309]","[33, 192, 525, 692, 1174, 2701]","[958, 1309]",3241,8,3233,2,6,3233,0
4.5,OABCGLOB,"[33, 193, 957, 1177, 1312, 2648]","[957, 1312]","[33, 193, 1177, 2648]","[957, 1312]",3192,6,3186,2,4,3186,0
4.5,OAINIGFII1,"[740, 1165, 1588, 2106, 2199]",[740],"[1165, 1588, 2106, 2199]",[740],2385,5,2380,1,4,2380,0
4.5,OAINTL3,"[115, 674, 813, 1909, 2072, 2099]","[674, 813, 1909, 2072]","[115, 2099]","[674, 813, 1909, 2072]",2793,6,2787,4,2,2787,0
4.5,OAKRT213,"[144, 1215, 1228, 1328, 1593, 1714, 1992, 2852, 3198, 3938, 4147, 4642, 4752, 4813, 5258, 5288, 5584, 5684, 6077, 6474, 6548, 7393, 8453, 8502, 8931, 9294, 9316, 9454]","[3198, 4147, 4813, 5288, 5684, 6077, 6548, 7393]","[144, 1215, 1228, 1328, 1593, 1714, 1992, 2852, 3938, 4642, 4752, 5258, 5584, 6474, 8453, 8502, 8931, 9294, 9316, 9454]","[3198, 4147, 4813, 5288, 5684, 6077, 6548, 7393]",9521,28,9493,8,20,9493,0
4.5,OALGB,"[374, 955, 959, 1459, 2438, 2660, 3336, 3500, 4250, 4387, 4656, 4886, 4911]","[2660, 4656]","[374, 955, 959, 1459, 2438, 3336, 3500, 4250, 4387, 4886, 4911]","[938, 1742, 2660, 3883, 4656]",7371,13,7358,2,11,7355,3
4.5,OAMETIAG,"[9, 701, 1136, 1479, 1674]","[701, 1479]","[9, 1136, 1674]","[701, 1479]",2792,5,2787,2,3,2787,0
4.5,OAMTIB,"[444, 1721, 2983, 3016]",[1721],"[444, 2983, 3016]","[965, 1721]",3211,4,3207,1,3,3206,1
4.5,OAMTIC,"[65, 381, 621, 707, 1295]","[621, 1295]","[65, 381, 707]","[621, 1295]",2375,5,2370,2,3,2370,0
4.5,OAMTII,"[799, 1023, 1312, 1378, 1976]","[1023, 1378]","[799, 1312, 1976]","[1023, 1378]",2047,5,2042,2,3,2042,0
4.5,OAPROTP1,[],[],[],[212],524,0,524,0,0,523,1
4.5,OATRICH,"[146, 152, 1183, 3157, 3309, 4055, 4062, 4772, 4947, 5721, 5825]",[3157],"[146, 152, 1183, 3309, 4055, 4062, 4772, 4947, 5721, 5825]",[3157],9336,11,9325,1,10,9325,0
4.5,OCAPOAIG,"[361, 553, 855, 1152, 1159, 1239, 1467]","[553, 855]","[361, 1152, 1159, 1239, 1467]","[553, 855]",1986,7,1979,2,5,1979,0
4.5,OCTNFBETA,"[68, 577]",[577],[68],"[577, 766]",1963,2,1961,1,1,1960,1
4.5,OCUTGLOB,"[2162, 3077, 3172, 3357, 3424, 3496, 4176, 4529, 4900, 4912, 5062, 5072, 5207]",[3357],"[2162, 3077, 3172, 3424, 3496, 4176, 4529, 4900, 4912, 5062, 5072, 5207]","[3357, 5831]",6560,13,6547,1,12,6546,1
4.5,OOGH,"[200, 333, 768, 849, 1084, 1475]","[333, 1084, 1475]","[200, 768, 849]","[333, 740, 1084, 1475]",2154,6,2148,3,3,2147,1
4.5,OPOP1,[],[],[],[249],616,0,616,0,0,615,1
4.5,ORAPROTP1A,"[59, 163, 276]",[163],"[59, 276]",[163],409,3,406,1,2,406,0
4.5,PAA1GL,"[155, 204, 513]","[204, 513]",[155],"[204, 513]",872,3,869,2,1,869,0
4.5,PAAFPG,[214],[214],[],[214],1087,1,1086,1,0,1086,0
4.5,PAU03674,"[361, 1194, 2100, 2414, 3171, 4013, 4611]","[3171, 4013, 4611]","[361, 1194, 2100, 2414]","[3171, 3574, 3773, 4013, 4294, 4611]",5437,7,5430,3,4,5427,3
4.5,PIGAPAI,"[35, 62, 107, 562, 794, 1129, 1156, 1823, 1918, 2693]","[794, 1129]","[35, 62, 107, 562, 1156, 1823, 1918, 2693]","[794, 1129]",3325,10,3315,2,8,3315,0
4.5,PIGAPCIII,"[27, 45, 148, 620, 736, 867, 944, 1141, 1432, 1711, 2083, 2639]","[1432, 1711]","[27, 45, 148, 620, 736, 867, 944, 1141, 2083, 2639]","[1432, 1711]",3268,12,3256,2,10,3256,0
4.5,PIGCNP,"[400, 528, 1150, 1416, 1622, 1662]",[400],"[528, 1150, 1416, 1622, 1662]",[400],1886,6,1880,1,5,1880,0
4.5,PIGFSB,"[1598, 1801, 1849]",[],"[1598, 1801, 1849]","[515, 1042]",2043,3,2040,0,3,2038,2
4.5,PIKEGLOBIN,"[221, 237, 588, 1011, 1193]","[237, 588]","[221, 1011, 1193]","[237, 588]",1701,5,1696,2,3,1696,0
4.5,PPGLTG,"[373, 662, 747]","[373, 662]",[747],"[373, 662]",1064,3,1061,2,1,1061,0
4.5,PPPROP2,"[63, 576, 661]",[],"[63, 576, 661]",[319],739,3,736,0,3,735,1
4.5,PPYPROP2,"[530, 615]",[],"[530, 615]",[272],688,2,686,0,2,685,1
4.5,PTAZGLO,"[441, 943, 974, 1062, 1603, 1648, 1749, 1791, 1947, 2244, 2253, 2987, 3077]","[1603, 3077]","[441, 943, 974, 1062, 1648, 1749, 1791, 1947, 2244, 2253, 2987]","[1603, 3077]",3609,13,3596,2,11,3596,0
4.5,PTGGGLOG,"[162, 200, 545, 641, 1064, 1076]","[200, 545]","[162, 641, 1064, 1076]","[200, 545]",1814,6,1808,2,4,1808,0
4.5,PTPPINS,"[688, 933, 1054, 1140, 1410, 1985]",[1410],"[688, 933, 1054, 1140, 1985]",[1410],2475,6,2469,1,5,2469,0
4.5,PTPROP2,"[74, 588, 673]",[],"[74, 588, 673]",[330],750,3,747,0,3,746,1
4.5,PVU11715,"[288, 633, 1021, 1340]","[288, 633]","[1021, 1340]","[288, 633]",1781,4,1777,2,2,1777,0
4.5,QULNFLW,"[15, 867, 961, 1222, 1548, 1667, 2169, 2301, 2405, 2425, 2461, 2703, 3329, 3794, 4139, 4443, 4656, 4817, 5192, 5612, 5849, 5873, 5894, 5972, 6211, 6672, 6808]","[3794, 4656]","[15, 867, 961, 1222, 1548, 1667, 2169, 2301, 2405, 2425, 2461, 2703, 3329, 4139, 4443, 4817, 5192, 5612, 5849, 5873, 5894, 5972, 6211, 6672, 6808]","[3794, 4656, 5921]",7925,27,7898,2,25,7897,1
4.5,QULTROPIA,"[67, 240, 469, 591, 689, 1858, 2186, 2360, 3004, 3437, 3638, 4007, 4020, 4047, 4225, 4229, 4336, 4544]","[2186, 2360, 3004, 3437, 4047, 4336]","[67, 240, 469, 591, 689, 1858, 3638, 4007, 4020, 4225, 4229, 4544]","[2186, 2360, 3004, 3437, 4047, 4336]",4956,18,4938,6,12,4938,0
4.5,RABCRP,"[397, 416, 990, 1221]",[397],"[416, 990, 1221]",[397],1430,4,1426,1,3,1426,0
4.5,RABDNP3AA,"[370, 742, 816, 906, 1030, 2156, 2435]",[2156],"[370, 742, 816, 906, 1030, 2435]",[2156],3082,7,3075,1,6,3075,0
4.5,RABSURFA,"[471, 636, 780, 1038, 3239, 3423, 3443, 3447, 3550, 4033, 4361, 4636, 5088, 5622, 5899, 6359, 6529, 7268, 7760]","[4033, 4361, 5088]","[471, 636, 780, 1038, 3239, 3423, 3443, 3447, 3550, 4636, 5622, 5899, 6359, 6529, 7268, 7760]","[4033, 4361, 5088]",8089,19,8070,3,16,8070,0
4.5,RABTNF,"[261, 851, 1355, 1563, 2139]","[851, 1355, 1563]","[261, 2139]","[851, 1355, 1563]",3192,5,3187,3,2,3187,0
4.5,RATCYC,"[70, 362, 572, 1333]",[1333],"[70, 362, 572]",[1333],2520,4,2516,1,3,2516,0
4.5,RATCYSS,"[1006, 1217, 1221, 1268, 1630, 1686, 4026, 4083, 4200, 4283]","[1006, 4026]","[1217, 1221, 1268, 1630, 1686, 4083, 4200, 4283]","[1006, 4026]",5555,10,5545,2,8,5545,0
4.5,RATDCCOVB,"[788, 880, 1559, 1599, 2267, 2292, 2864, 3126, 3498, 3716, 3782, 5129]","[2267, 2864, 3126]","[788, 880, 1559, 1599, 2292, 3498, 3716, 3782, 5129]","[2267, 2864, 3126]",5323,12,5311,3,9,5311,0
4.5,RATGRG,"[83, 204, 286, 1291, 1494, 1622, 1732, 1942, 2187, 2319, 2392, 2616, 3290, 3552]","[83, 286, 1291, 1494, 1942, 2187, 2319, 2616, 3290]","[204, 1622, 1732, 2392, 3552]","[83, 286, 1291, 1494, 1696, 1942, 2187, 2319, 2616, 2994, 3290]",3880,14,3866,9,5,3864,2
4.5,RATGROS,"[621, 746, 1178, 1349, 1390, 1587, 2131]","[1178, 1390, 1587]","[621, 746, 1349, 2131]","[1178, 1390, 1587]",2488,7,2481,3,4,2481,0
4.5,RATGSTY,"[659, 718, 1310, 1862, 1959, 2830, 3003, 3180, 3225, 3376, 3804, 4691]","[659, 1862, 3180, 3376]","[718, 1310, 1959, 2830, 3003, 3225, 3804, 4691]","[659, 996, 1495, 1862, 2060, 3180, 3376]",6286,12,6274,4,8,6271,3
4.5,RATIGFBA,"[850, 1242, 1455, 1788, 1948, 2034, 2203, 3002, 3105, 3828, 3873, 4512, 4546]","[2034, 3002]","[850, 1242, 1455, 1788, 1948, 2203, 3105, 3828, 3873, 4512, 4546]","[526, 2034, 3002]",4992,13,4979,2,11,4978,1
4.5,RATJE,"[1191, 1299, 1989, 2417, 2986]","[1191, 1989]","[1299, 2417, 2986]","[1191, 1989]",3097,5,3092,2,3,3092,0
4.5,RATKALA,"[945, 1062, 1275, 3282, 4061, 4424, 4709, 4729, 4734, 5689]","[1275, 3282, 4709]","[945, 1062, 4061, 4424, 4729, 4734, 5689]","[1275, 3282, 4476, 4709]",6249,10,6239,3,7,6238,1
4.5,RATLHB,"[784, 817, 837, 934, 1028, 1230, 1293, 1359, 1510]","[817, 1230]","[784, 837, 934, 1028, 1293, 1359, 1510]","[817, 1230]",1790,9,1781,2,7,1781,0
4.5,RATLITHOST,"[2013, 2464, 2496, 2847, 3471, 3475, 3902, 4652]","[2847, 3471, 3902, 4652]","[2013, 2464, 2496, 3475]","[2847, 3471, 3902, 4652]",5399,8,5391,4,4,5391,0
4.5,RATLYSOZYM,"[38, 960, 1561, 1736, 2210, 3255, 3588, 3999, 4558, 4907, 5174, 5339, 5443, 6270]","[1561, 3255, 5174]","[38, 960, 1736, 2210, 3588, 3999, 4558, 4907, 5339, 5443, 6270]","[1561, 3255, 5174]",6732,14,6718,3,11,6718,0
4.5,RATLYSZYM,"[6, 306, 508, 574, 749, 1007, 1099, 1392, 1667, 3840, 4290, 4624, 5036, 5614, 5963, 6230, 6395, 6499, 7325]","[574, 4290, 6230]","[6, 306, 508, 749, 1007, 1099, 1392, 1667, 3840, 4624, 5036, 5614, 5963, 6395, 6499, 7325]","[574, 4290, 6230]",7943,19,7924,3,16,7924,0
4.5,RATOSCAL,"[1192, 1373, 1586, 1828]","[1192, 1373, 1586]",[1828],"[1192, 1373, 1586]",2119,4,2115,3,1,2115,0
4.5,RATPAP,"[624, 633, 863, 921, 1048, 1308, 1648, 1737, 2295, 3305]","[1308, 1648, 2295, 3305]","[624, 633, 863, 921, 1048, 1737]","[1308, 1648, 2295, 2604, 3305]",4863,10,4853,4,6,4852,1
4.5,RATPAPIIB,"[1916, 2291, 2298, 2332, 2701, 2751, 3021, 3387, 3473, 3587, 3834, 4107]","[2298, 3473, 4107]","[1916, 2291, 2332, 2701, 2751, 3021, 3387, 3587, 3834]","[2298, 3140, 3473, 4107]",4717,12,4705,3,9,4704,1
4.5,RATPPP,"[118, 1497, 1538, 2002, 2451, 2521, 2927, 3500, 4400]",[],"[118, 1497, 1538, 2002, 2451, 2521, 2927, 3500, 4400]",[2261],4534,9,4525,0,9,4524,1
4.5,RATPTBZR02,"[224, 669, 727, 871, 909, 1206, 1222, 1306, 1535, 1927, 2066, 2123, 2200, 2988, 3232]","[1306, 2066]","[224, 669, 727, 871, 909, 1206, 1222, 1535, 1927, 2123, 2200, 2988, 3232]","[1306, 2066]",3426,15,3411,2,13,3411,0
4.5,RATRGPI,"[1879, 2329, 2361, 2712, 3339, 3343, 3770, 4521]","[2712, 3339, 3770, 4521]","[1879, 2329, 2361, 3343]","[2712, 3339, 3770, 4521]",5237,8,5229,4,4,5229,0
4.5,RATRPIII,"[1226, 1601, 1608, 1642, 2017, 2067, 2337, 2456, 2704, 2790, 2905, 3152, 3426, 4044]","[1608, 2456, 2790, 3426]","[1226, 1601, 1642, 2017, 2067, 2337, 2704, 2905, 3152, 4044]","[1608, 2456, 2790, 3426]",4133,14,4119,4,10,4119,0
4.5,RATSVSIV1,"[72, 244, 659, 814, 892]",[244],"[72, 659, 814, 892]",[244],972,5,967,1,4,967,0
4.5,RATTSHB,"[260, 265, 2177, 2183, 2711, 3999, 4299, 4375]",[4375],"[260, 265, 2177, 2183, 2711, 3999, 4299]",[4375],5159,8,5151,1,7,5151,0
4.5,RN0B2GLOB,"[9, 558, 693, 796, 1134]",[693],"[9, 558, 796, 1134]","[354, 693]",1789,5,1784,1,4,1783,1
4.5,RN2BGLOB,"[264, 432, 629, 764]","[432, 764]","[264, 629]","[432, 764]",1876,4,1872,2,2,1872,0
4.5,RN3B2GLOB,"[84, 122, 325, 460]","[122, 460]","[84, 325]","[122, 460]",1436,4,1432,2,2,1432,0
4.5,RN3B3GLOB,"[403, 604, 739]","[403, 739]",[604],"[403, 739]",1738,3,1735,2,1,1735,0
4.5,RN3BGLOB,"[250, 288, 491, 626]","[288, 626]","[250, 491]","[288, 626]",1526,4,1522,2,2,1522,0
4.5,RNAC01,"[127, 309, 513, 582, 844, 1367, 1463, 1694, 2190, 2597, 2631, 2685, 2867, 3335, 3767, 3984]","[1367, 1694, 2597, 2867]","[127, 309, 513, 582, 844, 1463, 2190, 2631, 2685, 3335, 3767, 3984]","[1367, 1694, 2597, 2867]",4083,16,4067,4,12,4067,0
4.5,RNAC02,"[251, 262, 480, 636, 1368, 1475, 1787, 2138, 2180, 2243, 2561, 2759]","[1368, 1787, 2138]","[251, 262, 480, 636, 1475, 2180, 2243, 2561, 2759]","[1368, 1787, 2138, 2429, 2743]",3192,12,3180,3,9,3178,2
4.5,RNANTANT,"[1524, 3119, 3263, 3609, 3883, 4213]","[1524, 3263, 3883]","[3119, 3609, 4213]","[1524, 3263, 3883]",5117,6,5111,3,3,5111,0
4.5,RNAPOEG,"[459, 499, 1152, 1293, 1955, 2863, 2867, 2884, 3203]","[1293, 1955]","[459, 499, 1152, 2863, 2867, 2884, 3203]","[1293, 1955]",3229,9,3220,2,7,3220,0
4.5,RNCALBD9,"[373, 469, 1041, 1399, 1532, 1739, 2285, 2736, 3508, 4062]",[2736],"[373, 469, 1041, 1399, 1532, 1739, 2285, 3508, 4062]",[2736],4883,10,4873,1,9,4873,0
4.5,RNGAMT,"[799, 3141, 3760, 3802, 4003, 4441, 4635, 4704, 4715]","[3141, 3760, 4003]","[799, 3802, 4441, 4635, 4704, 4715]","[2173, 3141, 3319, 3760, 4003]",4956,9,4947,3,6,4945,2
4.5,RNGMTG,"[92, 440, 1011, 1267, 1406, 1682, 1818, 2067, 2443, 2987, 3249, 3481, 3555, 3918, 4063, 4463, 4548, 5122, 5252]","[1682, 3249, 3918, 4463]","[92, 440, 1011, 1267, 1406, 1818, 2067, 2443, 2987, 3481, 3555, 4063, 4548, 5122, 5252]","[1682, 3249, 3918, 4254, 4463]",5391,19,5372,4,15,5371,1
4.5,RNGROW3,"[216, 365, 471, 817, 1652, 1973]","[471, 817, 1652, 1973]","[216, 365]","[471, 817, 1652, 1973]",2549,6,2543,4,2,2543,0
4.5,RNHSC73,"[498, 522, 954, 1244, 1713, 1982, 2506, 2618, 3034, 3448, 3766]","[1244, 1713, 1982, 2618, 3034, 3448, 3766]","[498, 522, 954, 2506]","[1244, 1713, 1982, 2618, 3034, 3448, 3766]",4312,11,4301,7,4,4301,0
4.5,RNLALB01,"[347, 1101, 1237, 1242, 1354, 1414, 1914, 2096, 2419, 2897, 3297]","[1414, 1914, 2419]","[347, 1101, 1237, 1242, 1354, 2096, 2897, 3297]","[1414, 1914, 2419]",3812,11,3801,3,8,3801,0
4.5,RNLPKG,"[2062, 2183, 2847, 3195, 3374, 3949, 4321, 6284, 6805, 7818, 8078, 8465, 9121, 9142, 9414, 9480, 12180, 12937]","[3949, 6284, 7818, 8078, 9480]","[2062, 2183, 2847, 3195, 3374, 4321, 6805, 8465, 9121, 9142, 9414, 12180, 12937]","[3219, 3949, 6009, 6284, 6605, 7192, 7453, 7818, 8078, 9480]",13003,18,12985,5,13,12980,5
4.5,RNODC,"[1097, 1344, 3174, 3305, 3525, 3918, 4182, 4517, 4698, 4982, 5631, 5650, 5825, 5851, 6291, 6582, 6692, 7326]","[3525, 3918, 4182, 4517, 4698, 5631, 5825, 6291]","[1097, 1344, 3174, 3305, 4982, 5650, 5851, 6582, 6692, 7326]","[3525, 3918, 4182, 4517, 4698, 4953, 5631, 5825, 6291]",7768,18,7750,8,10,7749,1
4.5,RNP9KA,"[22, 30, 207, 248, 723, 823, 910, 1227, 2311]",[1227],"[22, 30, 207, 248, 723, 823, 910, 2311]",[1227],2332,9,2323,1,8,2323,0
4.5,RNPBPG,"[1117, 1155, 1180, 2592, 2638, 2950, 4056]","[1117, 2950]","[1155, 1180, 2592, 2638, 4056]","[1117, 2950]",6021,7,6014,2,5,6014,0
4.5,RNPGMUT,"[32, 1216, 1515, 1596, 1912, 2242, 2291]",[1596],"[32, 1216, 1515, 1912, 2242, 2291]","[1596, 1872]",2420,7,2413,1,6,2412,1
4.5,RNPROST22,"[444, 733, 876, 2200, 2321, 3647, 3916, 4048, 4526, 4727, 5680, 7412]","[876, 3647, 4526]","[444, 733, 2200, 2321, 3916, 4048, 4727, 5680, 7412]","[876, 3647, 4526]",7667,12,7655,3,9,7655,0
4.5,RNREVSV2A,"[12, 67, 121, 290, 848, 1201, 1341]",[67],"[12, 121, 290, 848, 1201, 1341]","[67, 1304]",1730,7,1723,1,6,1722,1
4.5,RNSDHG,"[199, 285, 290, 379, 1536, 1993, 2205, 3480, 3554, 4077, 4179, 5079, 5590, 5691, 5866, 6052, 6095, 6253, 6576, 6877, 6984, 7081, 8014, 8314, 8671, 9541]","[5691, 6052, 6253, 6984, 8671]","[199, 285, 290, 379, 1536, 1993, 2205, 3480, 3554, 4077, 4179, 5079, 5590, 5866, 6095, 6576, 6877, 7081, 8014, 8314, 9541]","[4640, 5691, 6052, 6253, 6984, 8671]",9570,26,9544,5,21,9543,1
4.5,RNSVFG,"[213, 500, 636, 670, 1250, 1267, 1347]",[500],"[213, 636, 670, 1250, 1267, 1347]",[500],1841,7,1834,1,6,1834,0
4.5,RNTHYCSG,"[68, 318, 326, 355, 679, 1071, 1906]","[68, 1071]","[318, 326, 355, 679, 1906]","[68, 1071]",2855,7,2848,2,5,2848,0
4.5,RNU03551,"[715, 832, 1545, 2183, 2418, 3176, 3226]","[832, 2418]","[715, 1545, 2183, 3176, 3226]","[832, 2418, 3083]",3590,7,3583,2,5,3582,1
4.5,RNU09193,"[1727, 2084, 2630, 2749, 3084, 3612, 3787, 3899]","[2084, 2749, 3084, 3787]","[1727, 2630, 3612, 3899]","[2084, 2749, 3084, 3787]",4187,8,4179,4,4,4179,0
4.5,RNU12250,"[293, 473, 1704, 1708]","[293, 473]","[1704, 1708]","[293, 473]",1863,4,1859,2,2,1859,0
4.5,RNUCPG,"[112, 255, 1834, 1881, 2428, 2812, 3801, 4187, 4822, 4896, 4965, 5157, 5677, 5744, 6018, 6121, 6426, 6660, 6983, 7395, 8157, 8180, 9172, 9441, 10198, 10292, 10603, 11061, 11092, 11481, 11722]","[5157, 8157]","[112, 255, 1834, 1881, 2428, 2812, 3801, 4187, 4822, 4896, 4965, 5677, 5744, 6018, 6121, 6426, 6660, 6983, 7395, 8180, 9172, 9441, 10198, 10292, 10603, 11061, 11092, 11481, 11722]","[4310, 5157, 7964, 8157, 9401]",12496,31,12465,2,29,12462,3
4.5,RNVEGP1,"[305, 1043, 1286, 1629, 1834, 1994, 2076, 2108, 3032, 3940, 4037, 4140, 4452, 4844, 5195, 5948]","[1834, 3032, 4037]","[305, 1043, 1286, 1629, 1994, 2076, 2108, 3940, 4140, 4452, 4844, 5195, 5948]","[1262, 1834, 3032, 4037, 4611]",5948,16,5932,3,13,5930,2
4.5,RNVEGP2C,"[1159, 1402, 1745, 1950, 2105, 2182, 2213, 4146, 4960, 5078, 5566]","[1950, 4146]","[1159, 1402, 1745, 2105, 2182, 2213, 4960, 5078, 5566]","[1378, 1950, 3128, 4146, 4723]",5742,11,5731,2,9,5728,3
4.5,RRU04320,"[838, 1126, 2107, 2118, 2500, 2606, 3301, 3643, 5366]","[2500, 3643]","[838, 1126, 2107, 2118, 2606, 3301, 5366]","[2500, 3643]",6798,9,6789,2,7,6789,0
4.5,S46763,"[186, 535, 777, 1235, 1252, 1690, 1787, 2775, 3245, 3278, 3563, 3954, 4052, 4358, 4424, 4801, 5060, 5469, 6880, 7334, 8012, 8294, 8344]","[1235, 2775, 4052, 5060, 5469, 6880, 7334, 8012, 8294]","[186, 535, 777, 1252, 1690, 1787, 3245, 3278, 3563, 3954, 4358, 4424, 4801, 8344]","[1235, 2487, 2775, 4052, 4528, 5060, 5469, 6880, 7334, 8012, 8294]",10035,23,10012,9,14,10010,2
4.5,S49651,"[246, 1117, 1652, 3255, 3571, 3856, 4137]","[1652, 3255, 4137]","[246, 1117, 3571, 3856]","[1652, 2786, 3255, 4137]",5440,7,5433,3,4,5432,1
4.5,S57980,"[443, 732, 875, 2198, 2319, 3645, 3914, 4046, 4524, 4725, 5678, 7410]","[875, 3645, 4524]","[443, 732, 2198, 2319, 3914, 4046, 4725, 5678, 7410]","[875, 3645, 4524]",7665,12,7653,3,9,7653,0
4.5,S62287,"[190, 570, 1266, 1673, 1965, 2619, 3108]",[1266],"[190, 570, 1673, 1965, 2619, 3108]",[1266],3425,7,3418,1,6,3418,0
4.5,S63697,"[280, 829]","[280, 829]",[],"[280, 829]",1331,2,1329,2,0,1329,0
4.5,S66606,"[238, 340, 1076, 2506, 3899, 3982, 4598, 5644, 5958, 6167]","[2506, 3899, 4598]","[238, 340, 1076, 3982, 5644, 5958, 6167]","[2506, 2706, 3899, 4598]",6359,10,6349,3,7,6348,1
4.5,S67057,"[98, 840]",[840],[98],[840],1746,2,1744,1,1,1744,0
4.5,S69277,"[142, 207, 1967, 2058, 3098, 3316, 3521, 3723, 3839, 4103, 4385]","[3098, 3316, 3521, 3839, 4103]","[142, 207, 1967, 2058, 3723, 4385]","[3098, 3316, 3521, 3839, 4103]",5516,11,5505,5,6,5505,0
4.5,S69278,"[279, 323, 846, 861, 1402, 1529, 2590, 2826, 3031, 3231, 3347, 3561, 3832, 4236]","[2590, 2826, 3031, 3347, 3561]","[279, 323, 846, 861, 1402, 1529, 3231, 3832, 4236]","[2590, 2826, 3031, 3347, 3561]",5015,14,5001,5,9,5001,0
4.5,S69350,"[235, 1866]",[235],[1866],[235],2152,2,2150,1,1,2150,0
4.5,SAIEGLOBIM,"[221, 237, 346, 588, 604, 983, 1317, 1329]","[237, 588]","[221, 346, 604, 983, 1317, 1329]","[237, 588]",1826,8,1818,2,6,1818,0
4.5,SMIGCU,"[799, 911, 1233, 1631, 1779, 1946, 2139, 2624]","[799, 1233, 1631]","[911, 1779, 1946, 2139, 2624]","[799, 1233, 1631]",2833,8,2825,3,5,2825,0
4.5,SMNPRP1A,[],[],[],[215],623,0,623,0,0,622,1
4.5,SOEEGLOBIN,"[17, 220, 236, 344, 586, 602, 1183, 1195]","[236, 586]","[17, 220, 344, 602, 1183, 1195]","[236, 586]",1688,8,1680,2,6,1680,0
4.5,SSBAT1G,"[260, 482, 518, 1316, 1471, 1681, 1843, 2215, 2323, 2582, 2592, 2610, 2716, 2814, 2990, 3837, 4001, 4538, 5527, 6021, 6104, 6390, 6678, 6735, 6908, 7799, 8238, 9144, 9674]","[1316, 2215, 2582, 4538, 8238, 9144, 9674]","[260, 482, 518, 1471, 1681, 1843, 2323, 2592, 2610, 2716, 2814, 2990, 3837, 4001, 5527, 6021, 6104, 6390, 6678, 6735, 6908, 7799]","[1316, 2215, 2582, 4538, 5771, 8238, 9144, 9388, 9674]",10666,29,10637,7,22,10635,2
4.5,SSIKBAGE,"[60, 788, 956, 1247, 1729, 2469, 2528, 3151, 3334, 3713, 3766, 4091, 4470, 5251]","[2469, 3151, 3713, 4091, 4470]","[60, 788, 956, 1247, 1729, 2528, 3334, 3766, 5251]","[2469, 3151, 3713, 4091, 4470]",5756,14,5742,5,9,5742,0
4.5,SSPINT1B,"[88, 2127, 2551, 2759, 3399, 3407, 3903, 4793, 5245, 6247, 6605, 6609, 6774, 6790, 8049, 8541, 8611]","[2551, 3903, 5245, 6605]","[88, 2127, 2759, 3399, 3407, 4793, 6247, 6609, 6774, 6790, 8049, 8541, 8611]","[1971, 2551, 3903, 5245, 6605]",8743,17,8726,4,13,8725,1
4.5,TAPROTP1,[],[],[],[230],547,0,547,0,0,546,1
4.5,TARHBE,"[76, 103, 119, 400, 465]","[119, 465]","[76, 103, 400]","[119, 465]",1682,5,1677,2,3,1677,0
4.5,TARHBG,"[58, 227, 265, 608, 704, 1032, 2072]",[265],"[58, 227, 608, 704, 1032, 2072]","[265, 612]",2139,7,2132,1,6,2131,1
4.5,TFLPA2P1,"[266, 596, 972, 1311, 1749, 2495]","[596, 972, 1749]","[266, 1311, 2495]","[596, 972, 1749]",2708,6,2702,3,3,2702,0
4.5,TFLPA2P2,"[266, 590, 935, 966, 1304, 1783]","[590, 966, 1783]","[266, 935, 1304]","[590, 966, 1783]",2431,6,2425,3,3,2425,0
4.5,TFLPA2P3,"[266, 596, 972, 1311, 1749, 2495]","[596, 972, 1749]","[266, 1311, 2495]","[596, 972, 1749]",2708,6,2702,3,3,2702,0
4.5,TFLPA2P4,"[266, 590, 935, 966, 1304, 1783]","[590, 966, 1783]","[266, 935, 1304]","[590, 966, 1783]",2431,6,2425,3,3,2425,0
4.5,TGLHBB,"[155, 519, 888, 1106, 1256, 1742, 2034]","[519, 888]","[155, 1106, 1256, 1742, 2034]","[519, 888]",2300,7,2293,2,5,2293,0
4.5,TIOPRP1A,[233],[],[233],[212],556,1,555,0,1,554,1
4.5,U00432,"[237, 793, 1101, 1312]","[237, 793, 1101, 1312]",[],"[83, 237, 793, 1101, 1312]",1575,4,1571,4,0,1570,1
4.5,U00433,"[83, 267, 752, 1245, 1270]","[83, 267, 752, 1270]",[1245],"[83, 267, 752, 1062, 1270]",1545,5,1540,4,1,1539,1
4.5,U00454,"[772, 1031, 1062, 1090, 1263, 1598, 1631, 1967, 2071, 2781, 4179, 4328, 4529, 4824, 4862, 5303, 5625, 5820, 6800, 6887]","[1598, 4862]","[772, 1031, 1062, 1090, 1263, 1631, 1967, 2071, 2781, 4179, 4328, 4529, 4824, 5303, 5625, 5820, 6800, 6887]","[1598, 4862]",7192,20,7172,2,18,7172,0
4.5,U00938,"[60, 71, 247, 912, 1169, 1465, 2715, 3079, 3311, 3617, 4070, 5155, 5202, 5261, 5640, 5809, 5962, 6482]","[1169, 4070, 5155]","[60, 71, 247, 912, 1465, 2715, 3079, 3311, 3617, 5202, 5261, 5640, 5809, 5962, 6482]","[1169, 4070, 5155]",6780,18,6762,3,15,6762,0
4.5,U01026,"[492, 1364, 1419, 1746, 1927, 2537, 2636, 2760]","[1364, 1746, 2537]","[492, 1419, 1927, 2636, 2760]","[1364, 1746, 2537]",3216,8,3208,3,5,3208,0
4.5,U01027,"[248, 571, 625, 947, 1128, 1290, 1710, 1809, 2740]","[571, 947, 1710]","[248, 625, 1128, 1290, 1809, 2740]","[571, 947, 1710]",2761,9,2752,3,6,2752,0
4.5,U01844,"[64, 476, 623, 684, 1307, 1559, 1589, 1919, 1986, 2090, 2395, 2474, 2653, 3211, 3256, 3781, 3843]","[1986, 2474, 2653, 3211]","[64, 476, 623, 684, 1307, 1559, 1589, 1919, 2090, 2395, 3256, 3781, 3843]","[1986, 2141, 2474, 2653, 3211]",4219,17,4202,4,13,4201,1
4.5,XELCRPGA,"[842, 892, 1096, 2377, 2504]",[1096],"[842, 892, 2377, 2504]",[1096],3891,5,3886,1,4,3886,0
4.5,XELCRYB,"[592, 706, 1326, 1500]","[706, 1326]","[592, 1500]","[706, 1326]",2049,4,2045,2,2,2045,0
4.5,XELHBBC,"[263, 678, 715, 1418]","[263, 678]","[715, 1418]","[263, 678]",1981,4,1977,2,2,1977,0
4.5,XLACTA,"[553, 1260, 2591, 3422, 3815, 3868, 4138, 4845, 4946, 5128, 5338, 5509, 5898]","[2591, 3868, 4138, 4845, 5128]","[553, 1260, 3422, 3815, 4946, 5338, 5509, 5898]","[2591, 3868, 4138, 4845, 5128]",5946,13,5933,5,8,5933,0
4.5,XLACTCAG,"[831, 855, 1600, 1638, 2094, 3023, 3128, 3298, 3561, 3614, 4769, 4931, 5562, 6279, 6461, 7511, 8347, 8892]","[3614, 4931, 5562, 6461]","[831, 855, 1600, 1638, 2094, 3023, 3128, 3298, 3561, 4769, 6279, 7511, 8347, 8892]","[2473, 3614, 4931, 5562, 6461]",8900,18,8882,4,14,8881,1
4.5,XLBGL3,"[388, 1175, 2443]","[388, 1175]",[2443],"[388, 1175]",2964,3,2961,2,1,2961,0
4.5,XLGLAA1,"[137, 502]","[137, 502]",[],"[137, 502]",1192,2,1190,2,0,1190,0
4.5,XLGLAA2,"[138, 519, 586, 1163]","[138, 519]","[586, 1163]","[138, 519]",1192,4,1188,2,2,1188,0
4.5,XLK81A1G,"[1618, 1671, 2734, 2900, 3145, 3240, 3409, 3531, 3647, 3849, 4127, 4170, 4425, 5318]","[2734, 3531, 3849, 4170]","[1618, 1671, 2900, 3145, 3240, 3409, 3647, 4127, 4425, 5318]","[1759, 2294, 2734, 3026, 3531, 3849, 4170]",5892,14,5878,4,10,5875,3
4.5,XLRPL14,"[912, 1292, 1837, 2087, 2140, 2145, 2624, 3051, 3085, 3897, 5356, 6485, 6804, 7158, 7239, 7618, 8659, 9072]","[912, 2087, 5356]","[1292, 1837, 2140, 2145, 2624, 3051, 3085, 3897, 6485, 6804, 7158, 7239, 7618, 8659, 9072]","[912, 1891, 2087, 4978, 5356, 7904]",9116,18,9098,3,15,9095,3
4.5,XLRPL1AG,"[308, 512, 634, 2121, 2638, 2695, 2818, 3735, 3831, 3844, 4433, 4573, 5179, 5303, 5643, 5757, 6451]","[512, 2121, 2818, 3831, 4573, 5179, 5757]","[308, 634, 2638, 2695, 3735, 3844, 4433, 5303, 5643, 6451]","[512, 2121, 2438, 2818, 3137, 3831, 4573, 5179, 5757]",6949,17,6932,7,10,6930,2
4.5,XLS8,"[164, 692, 804, 1006, 2032, 2326, 2865, 2893, 3963, 4181, 5708, 5849, 5912, 6381, 7181, 7381, 8071, 8411, 8542, 9832, 12388, 12978]","[2032, 5912, 7381]","[164, 692, 804, 1006, 2326, 2865, 2893, 3963, 4181, 5708, 5849, 6381, 7181, 8071, 8411, 8542, 9832, 12388, 12978]","[2032, 3938, 5912, 7381, 12177]",13512,22,13490,3,19,13488,2
4.5,XLTUBAG,"[272, 595, 678, 1280, 1323, 2006, 2020, 2610, 3094, 4024, 4179, 4401, 4775, 5431, 5575, 6604, 6612, 6630]","[678, 4401, 5575]","[272, 595, 1280, 1323, 2006, 2020, 2610, 3094, 4024, 4179, 4775, 5431, 6604, 6612, 6630]","[678, 4401, 5575]",6888,18,6870,3,15,6870,0
4.5,XLXANF1A,"[1460, 1960, 2706]","[1460, 1960, 2706]",[],"[1460, 1960, 2706]",4878,3,4875,3,0,4875,0
4.5,XTGLA,"[235, 731, 1323, 2034, 2838, 3340, 4013, 4344]","[731, 2838]","[235, 1323, 2034, 3340, 4013, 4344]","[731, 2838]",4838,8,4830,2,6,4830,0
4.5,XTGLAA,"[416, 541, 1036, 1411]","[1036, 1411]","[416, 541]","[1036, 1411]",1992,4,1988,2,2,1988,0
4.5,XTGLB,"[21, 212, 389, 1823, 2384, 2836]","[2384, 2836]","[21, 212, 389, 1823]","[2384, 2836]",4043,6,4037,2,4,4037,0
4.5,ZEFB2MICB,"[304, 1187, 1345]","[304, 1187]",[1345],"[304, 1187]",2193,3,2190,2,1,2190,0
