Threshold,Locus,Predict Sites,Positive Sites,Negative Sites,Actual Donor Sites,Predict Num,Predict Positive Num,Predict Negative Num,TP,FP,TN,FN
6.0,ACU08131,"[2029, 2803, 3336]","[2029, 2803]",[3336],"[642, 1363, 2029, 2803, 3798]",5384,3,5381,2,1,5378,3
6.0,AGGGLINE,"[2946, 3504, 4309, 6387]",[3504],"[2946, 4309, 6387]","[3158, 3504]",7220,4,7216,1,3,7215,1
6.0,AGU04852,"[3877, 5912, 6740, 8817]","[5912, 6740]","[3877, 8817]","[3956, 5517, 5912, 6740]",10976,4,10972,2,2,10970,2
6.0,ALOEGLOBIM,"[237, 583]","[237, 583]",[],"[237, 583]",1683,2,1681,2,0,1681,0
6.0,ALOEGLOBIN,"[237, 583]","[237, 583]",[],"[237, 583]",1683,2,1681,2,0,1681,0
6.0,ALOPROTP1A,[],[],[],[166],410,0,410,0,0,409,1
6.0,AMU12024,"[257, 667, 2482]","[257, 667, 2482]",[],"[257, 667, 1864, 2126, 2482]",3644,3,3641,3,0,3639,2
6.0,AMU12025,"[1080, 1412, 1830, 2654, 3278]","[1412, 1830, 2654, 3278]",[1080],"[1412, 1830, 2654, 2902, 3278]",5375,5,5370,4,1,5369,1
6.0,AOIRHODOPS,"[1702, 1969, 4005, 4067, 5373]","[1702, 4067, 5373]","[1969, 4005]","[1702, 4067, 5373, 6243]",9915,5,9910,3,2,9909,1
6.0,ASPROP2,[],[],[],[325],664,0,664,0,0,663,1
6.0,ASYRVISP,"[625, 1042]","[625, 1042]",[],"[625, 1042, 1335, 1585, 1916]",2221,2,2219,2,0,2216,3
6.0,ATREGLOBIN,"[237, 588]","[237, 588]",[],"[237, 588]",1691,2,1689,2,0,1689,0
6.0,BABAPOE,"[60, 897, 2847]","[897, 2847]",[60],"[897, 2847]",4754,3,4751,2,1,4751,0
6.0,BATROX,"[341, 3011, 3975, 4110]","[341, 3011]","[3975, 4110]","[341, 3011, 5035, 6955]",8092,4,8088,2,2,8086,2
6.0,BCHEGLOBIN,"[237, 583]","[237, 583]",[],"[237, 583]",1697,2,1695,2,0,1695,0
6.0,BOVANPA,[858],[858],[],"[433, 858]",1761,1,1760,1,0,1759,1
6.0,BOVCOX7AL,"[3328, 3721, 5049]",[5049],"[3328, 3721]","[1540, 2812, 5049]",6848,3,6845,1,2,6843,2
6.0,BOVGAS,[],[],[],[751],1058,0,1058,0,0,1057,1
6.0,BOVIAP,"[1318, 1764, 1994, 3392, 3535, 3996]","[1764, 1994, 3392, 3996]","[1318, 3535]","[1568, 1764, 1994, 2354, 2606, 2999, 3157, 3392, 3667, 3996]",5391,6,5385,4,2,5379,6
6.0,BOVIRBP,"[3174, 3723, 3801, 4212, 7699, 9959, 10082, 11020]","[3174, 7699]","[3723, 3801, 4212, 9959, 10082, 11020]","[3174, 5595, 7699]",11785,8,11777,2,6,11776,1
6.0,BOVLHB,[803],[803],[],"[803, 1272]",1856,1,1855,1,0,1854,1
6.0,BOVLYSOZMA,[5771],[5771],[],"[3039, 5771, 8654]",12214,1,12213,1,0,12211,2
6.0,BOVLYSOZMB,"[1662, 3717, 4005, 5148, 6212, 6807, 7058]","[4005, 6212]","[1662, 3717, 5148, 6807, 7058]","[2673, 4005, 6212]",10204,7,10197,2,5,10196,1
6.0,BOVLYSOZMC,"[2323, 6245]",[2323],[6245],"[905, 2323, 4194]",8043,2,8041,1,1,8039,2
6.0,BOVMYF5A,[273],[],[273],"[698, 1625]",5211,1,5210,0,1,5208,2
6.0,BRHOX22,[1431],[1431],[],[1431],3434,1,3433,1,0,3433,0
6.0,BRHOX34A,[],[],[],[981],3490,0,3490,0,0,3489,1
6.0,BRU12895,"[1135, 1986]",[1135],[1986],[1135],3232,2,3230,1,1,3230,0
6.0,BTATPAAA,"[2314, 4106, 4188, 5729]","[2314, 5729]","[4106, 4188]","[740, 2314, 3707, 5729, 5984, 6337, 6827, 7151, 7770, 8023, 9129]",9907,4,9903,2,2,9894,9
6.0,BTEBGL2,"[294, 310, 658]","[310, 658]",[294],"[310, 658]",1833,3,1830,2,1,1830,0
6.0,BTEBGL4,"[294, 310, 658, 815]","[310, 658]","[294, 815]","[310, 658]",1828,4,1824,2,2,1824,0
6.0,BTGL01,"[365, 1008]","[365, 1008]",[],"[365, 1008]",2040,2,2038,2,0,2038,0
6.0,BTHOR02,[],[],[],"[484, 1920]",2419,0,2419,0,0,2417,2
6.0,BTKER6B,[1678],[1678],[],"[1678, 2559, 3070, 3315, 3530, 4056, 4666]",5718,1,5717,1,0,5711,6
6.0,BTSPDNA,[],[],[],[1541],2148,0,2148,0,0,2147,1
6.0,BTSVSP109,"[799, 2189, 2359, 2555, 5292, 5643, 6096]","[2359, 5292]","[799, 2189, 2555, 5643, 6096]","[2359, 3984, 5292]",6948,7,6941,2,5,6940,1
6.0,BTTNP2G,[847],[],[847],[774],1841,1,1840,0,1,1839,1
6.0,BTU02285,"[21, 1858, 4222, 4780, 5056]","[4222, 4780, 5056]","[21, 1858]","[3792, 4222, 4487, 4780, 5056]",6388,5,6383,3,2,6381,2
6.0,CALEGLOBIM,"[236, 587]","[236, 587]",[],"[236, 587]",1690,2,1688,2,0,1688,0
6.0,CBUEGLOBIM,"[236, 587]","[236, 587]",[],"[236, 587]",1690,2,1688,2,0,1688,0
6.0,CCALAC,[2409],[2409],[],"[1358, 1852, 2409]",3619,1,3618,1,0,3616,2
6.0,CCBEGLOBIM,"[237, 587]","[237, 587]",[],"[237, 587]",1695,2,1693,2,0,1693,0
6.0,CCBEGLOBIN,"[238, 589]","[238, 589]",[],"[238, 589]",1698,2,1696,2,0,1696,0
6.0,CCGHG,"[283, 1778]","[283, 1778]",[],"[283, 706, 1051, 1778]",2830,2,2828,2,0,2826,2
6.0,CCGONBS1,[1767],[1767],[],"[1767, 2072]",3463,1,3462,1,0,3461,1
6.0,CCGONBS2,[1785],[1785],[],"[1785, 2091]",3482,1,3481,1,0,3480,1
6.0,CCGTHA1,[],[],[],"[302, 572]",1144,0,1144,0,0,1142,2
6.0,CCT64CLU,"[1644, 3005, 5659]","[1644, 3005, 5659]",[],"[1644, 2757, 3005, 3496, 4514, 5272, 5659]",6276,3,6273,3,0,6269,4
6.0,CEPPINS,[],[],[],[858],1901,0,1901,0,0,1900,1
6.0,CHBLG,"[4019, 4298, 4861]",[4019],"[4298, 4861]","[2285, 3090, 4019, 5246, 6025]",8080,3,8077,1,2,8073,4
6.0,CHEBGLI,"[909, 1213]",[909],[1213],"[570, 909]",2204,2,2202,1,1,2201,1
6.0,CHEBGLII,"[547, 563, 912]","[563, 912]",[547],"[563, 912]",2258,3,2255,2,1,2255,0
6.0,CHKALDB,"[1452, 4004, 5748, 6172, 6664, 6955, 6960, 7504, 8186, 10844]","[6172, 6664, 6955, 8186]","[1452, 4004, 5748, 6960, 7504, 10844]","[6172, 6664, 6955, 7265, 8186, 8842, 9185]",11643,10,11633,4,6,11630,3
6.0,CHKAPOII,"[1839, 1891, 2131, 3317, 3820]","[3317, 3820]","[1839, 1891, 2131]","[3317, 3820]",4953,5,4948,2,3,4948,0
6.0,CHKDPCP,"[347, 637, 1624]",[637],"[347, 1624]",[637],1902,3,1899,1,2,1899,0
6.0,CHKMAX,"[1236, 2127, 2291, 3928, 4295]","[2127, 2291, 3928, 4295]",[1236],"[2127, 2291, 3928, 4295]",5690,5,5685,4,1,5685,0
6.0,CHKMYOD,"[3468, 4941, 6150]","[4941, 6150]",[3468],"[4941, 6150]",7381,3,7378,2,1,7378,0
6.0,CHKOVAL,"[1390, 3164, 4694, 6282]","[3164, 4694, 6282]",[1390],"[3164, 3466, 4176, 4694, 5795, 6282]",9198,4,9194,3,1,9191,3
6.0,CHKRPL30,"[671, 801, 1872, 2753]","[801, 1872, 2753]",[671],"[801, 1872, 2753]",3884,4,3880,3,1,3880,0
6.0,CHKRPL37A,"[1376, 2125, 2255]",[1376],"[2125, 2255]","[798, 1376, 2386]",3465,3,3462,1,2,3460,2
6.0,CHKRPL5G,"[1632, 2618]",[1632],[2618],"[498, 1419, 1632, 3157, 3955, 5165, 6897]",8313,2,8311,1,1,8305,6
6.0,CHKTUB4B,"[779, 1573]",[1573],[779],"[437, 949, 1573]",3145,2,3143,1,1,3141,2
6.0,CHKY,"[1664, 3603, 4683]","[3603, 4683]",[1664],"[3603, 4199, 4683, 5648, 6012, 6249]",8364,3,8361,2,1,8357,4
6.0,CHPPHYGEN,"[22, 3786, 4945, 7000, 10818, 10833, 10849, 11193, 12603]",[4945],"[22, 3786, 7000, 10818, 10833, 10849, 11193, 12603]","[4599, 4945]",13689,9,13680,1,8,13679,1
6.0,CHPPROTP1A,[],[],[],[159],397,0,397,0,0,396,1
6.0,CHPPROTP1B,[],[],[],[160],396,0,396,0,0,395,1
6.0,CHWEGLOBIM,"[237, 588]","[237, 588]",[],"[237, 588]",1701,2,1699,2,0,1699,0
6.0,CIGH,"[2029, 2889]",[2889],[2029],"[1281, 1691, 2280, 2889]",3967,2,3965,1,1,3962,3
6.0,CITEGLOBIM,"[236, 587]","[236, 587]",[],"[236, 587]",1691,2,1689,2,0,1689,0
6.0,CJAEGLOBIN,"[237, 588]","[237, 588]",[],"[237, 588]",1702,2,1700,2,0,1700,0
6.0,CJINTERFG,"[4187, 4465]","[4187, 4465]",[],"[2881, 4187, 4465]",8519,2,8517,2,0,8516,1
6.0,CL54K,"[512, 959, 1177, 1294, 1538, 2581, 2696]",[512],"[959, 1177, 1294, 1538, 2581, 2696]",[512],3407,7,3400,1,6,3400,0
6.0,CMBGA2B2,"[383, 989, 1597]",[383],"[989, 1597]","[383, 718]",2684,3,2681,1,2,2680,1
6.0,CMEGA2E2,[416],[416],[],"[416, 753]",2046,1,2045,1,0,2044,1
6.0,CMU11711,"[1685, 2031]","[1685, 2031]",[],"[1685, 2031]",3163,2,3161,2,0,3161,0
6.0,CPPROT1GN,[],[],[],[164],390,0,390,0,0,389,1
6.0,CRASEQB,"[2825, 3464]",[2825],[3464],"[1920, 2825]",5120,2,5118,1,1,5117,1
6.0,CRUCH7AHYD,"[1731, 2941, 3016, 5283, 7866]","[1731, 7866]","[2941, 3016, 5283]","[1731, 3651, 4938, 6076, 7866]",10606,5,10601,2,3,10598,3
6.0,CRUGAD45A,"[1877, 2417]","[1877, 2417]",[],"[1877, 2063, 2417]",4427,2,4425,2,0,4424,1
6.0,DMPROTP1,[],[],[],[249],616,0,616,0,0,615,1
6.0,DMU11712,"[1705, 2043]","[1705, 2043]",[],"[1705, 2043]",3019,2,3017,2,0,3017,0
6.0,DOGCOLIP,"[224, 249, 416, 1411, 2378]",[2378],"[224, 249, 416, 1411]","[1108, 2378]",3156,5,3151,1,4,3150,1
6.0,DOGIL8T,"[118, 1206, 1406]","[118, 1406]",[1206],"[118, 1406, 1769]",2229,3,2226,2,1,2225,1
6.0,ECGLOAP1,[657],[657],[],"[363, 657]",1133,1,1132,1,0,1131,1
6.0,ECPZA2GL,"[1560, 1623, 3576, 4059]","[3576, 4059]","[1560, 1623]","[3576, 4059]",5081,4,5077,2,2,5077,0
6.0,ECZGL1,"[700, 763]",[700],[763],"[700, 1534]",1993,2,1991,1,1,1990,1
6.0,ECZGL2,"[255, 318]",[255],[318],"[255, 1084]",1555,2,1553,1,1,1552,1
6.0,ELMETL,[1097],[1097],[],"[1097, 1291]",1865,1,1864,1,0,1863,1
6.0,FDFELDI2,"[678, 1070, 1882, 2011]",[],"[678, 1070, 1882, 2011]","[276, 970]",2417,4,2413,0,4,2411,2
6.0,FDTNFA,[187],[187],[],"[187, 790, 972]",1714,1,1713,1,0,1711,2
6.0,GDMYF5G,"[1036, 1104]",[1036],[1104],"[639, 1036]",1601,2,1599,1,1,1598,1
6.0,GGAC01,"[273, 634, 1586, 1666, 3189, 3495, 3831]","[1666, 3189]","[273, 634, 1586, 3495, 3831]","[1666, 2226, 3189, 3677]",5038,7,5031,2,5,5029,2
6.0,GGACTAC,"[339, 3218, 4398]","[3218, 4398]",[339],"[970, 2127, 2914, 3218, 4398]",5455,3,5452,2,1,5449,3
6.0,GGACTI,"[153, 841, 1659, 1841]","[841, 1841]","[153, 1659]","[404, 841, 1137, 1554, 1841]",2418,4,2414,2,2,2411,3
6.0,GGCALB,"[386, 1292, 1863, 2289, 6149, 6784, 7824, 8718, 9052]","[386, 1863, 2289, 6784, 7824, 8718, 9052]","[1292, 6149]","[386, 1863, 2289, 3467, 3793, 4235, 4894, 5205, 5933, 6784, 7035, 7824, 8718, 9052, 9685, 10195]",11060,9,11051,7,2,11042,9
6.0,GGCRYD1,"[267, 441, 3516, 5234, 5899, 6395]","[441, 3516, 5234, 5899, 6395]",[267],"[441, 1734, 2742, 3150, 3516, 3944, 4332, 4528, 4907, 5234, 5899, 6138, 6395, 6734, 7213]",8152,6,8146,5,1,8136,10
6.0,GGGL03,"[432, 1160]",[432],[1160],"[432, 768]",1199,2,1197,1,1,1196,1
6.0,GGGNRHIA,"[1684, 3627, 4392, 4544]","[3627, 4392]","[1684, 4544]","[3627, 4392]",6274,4,6270,2,2,6270,0
6.0,GGNFM1D,"[1541, 5057]",[],"[1541, 5057]","[2132, 2451]",5630,2,5628,0,2,5626,2
6.0,GGPROP2,[],[],[],[307],640,0,640,0,0,639,1
6.0,GGRIHBGEN,"[1038, 1973, 2982, 3454]","[2982, 3454]","[1038, 1973]","[2982, 3219, 3454]",3878,4,3874,2,2,3873,1
6.0,GGVITIIG,"[190, 2561, 2948, 3138, 4818, 5848, 6229, 6443, 8481, 9149, 10714, 10971, 12272, 12791, 15771, 15880, 17492, 19081, 20126]","[190, 2948, 4818, 6229, 6443, 9149, 10714, 12272, 15771, 19081]","[2561, 3138, 5848, 8481, 10971, 12791, 15880, 17492, 20126]","[54, 190, 442, 2021, 2694, 2948, 3267, 3543, 3791, 4818, 5441, 6229, 6443, 7045, 7268, 8026, 8302, 9149, 9467, 10104, 10448, 10714, 11757, 12272, 12615, 13267, 13505, 14028, 14704, 15348, 15771, 16955, 17864, 19081]",20335,19,20316,10,9,20292,24
6.0,GIBPROTP1A,[],[],[],[160],393,0,393,0,0,392,1
6.0,GORAFPA,"[75, 2955, 4192, 7766, 11145, 14707, 15952, 17195]","[2955, 7766, 14707]","[75, 4192, 11145, 15952, 17195]","[999, 1860, 2955, 5457, 6760, 7766, 9445, 11629, 13421, 14087, 14707, 16581, 17834]",24599,8,24591,3,5,24581,10
6.0,GORPROTP1A,[],[],[],[164],404,0,404,0,0,403,1
6.0,GPIINS,[],[],[],[526],1464,0,1464,0,0,1463,1
6.0,HAMAMYLP,"[1394, 1473, 2308, 4561, 5045]",[2308],"[1394, 1473, 4561, 5045]",[2308],5947,5,5942,1,4,5942,0
6.0,HAMHG5,"[640, 1373, 2817, 4856, 6597, 7441]","[4856, 6597, 7441]","[640, 1373, 2817]","[4856, 5517, 6188, 6597, 7441]",9711,6,9705,3,3,9703,2
6.0,HROAMD1,"[289, 1072, 2687, 3486, 4700, 4816, 5962]","[2687, 3486, 4700]","[289, 1072, 4816, 5962]","[2687, 3486, 4700]",7091,7,7084,3,4,7084,0
6.0,HROMA2,"[739, 1174, 1285]","[739, 1174]",[1285],"[739, 1174]",1779,3,1776,2,1,1776,0
6.0,HROMA4A,"[1108, 1670, 1774]","[1108, 1670]",[1774],"[1108, 1670]",2331,3,2328,2,1,2328,0
6.0,HRSPRMI,[1880],[],[1880],[722],2198,1,2197,0,1,2196,1
6.0,HS1D3HLH,"[1039, 1231]",[1039],[1231],[1039],2473,2,2471,1,1,2471,0
6.0,HS2OXOC,"[116, 1162, 1421, 1694]","[116, 1162, 1421, 1694]",[],"[116, 871, 1162, 1421, 1694, 1825]",2510,4,2506,4,0,2504,2
6.0,HSABLGR1,"[3140, 3344, 5666, 6508, 6820, 8720, 10400, 11951, 12239, 15514, 15741, 17116, 17249, 24896, 25906, 26127, 29268, 32399, 33787, 35562]","[8720, 10400, 15741, 17116]","[3140, 3344, 5666, 6508, 6820, 11951, 12239, 15514, 17249, 24896, 25906, 26127, 29268, 32399, 33787, 35562]","[8720, 10400, 12434, 14200, 15741, 17116, 17991]",35954,20,35934,4,16,35931,3
6.0,HSALDCG,"[1283, 2641, 3567]","[2641, 3567]",[1283],"[2641, 2939, 3110, 3366, 3567, 3994, 4326]",5190,3,5187,2,1,5182,5
6.0,HSAPC3A,[],[],[],"[919, 1178]",6039,0,6039,0,0,6037,2
6.0,HSAPOA2B,"[245, 490, 916]","[490, 916]",[245],"[490, 916]",1747,3,1744,2,1,1744,0
6.0,HSAPOAIA,[57],[],[57],"[317, 661]",2183,1,2182,0,1,2180,2
6.0,HSAPOAIT,[231],[],[231],"[491, 835]",2377,1,2376,0,1,2374,2
6.0,HSAPOC2G,"[1276, 1494, 2714]",[2714],"[1276, 1494]","[2714, 3041]",3832,3,3829,1,2,3828,1
6.0,HSAQUPN2,[],[],[],"[431, 632, 746]",987,0,987,0,0,984,3
6.0,HSARYLA,"[1571, 2528, 2666]",[1571],"[2528, 2666]","[848, 1238, 1571, 1815, 2252, 2470, 2823]",3629,3,3626,1,2,3620,6
6.0,HSAT3,"[646, 4823, 4978, 6059, 6934, 10401, 11303, 11320, 13056]","[646, 6059, 10401]","[4823, 4978, 6934, 11303, 11320, 13056]","[646, 3311, 6059, 7102, 8303, 10401]",14198,9,14189,3,6,14186,3
6.0,HSATPCP1,"[831, 4773, 6382, 6830, 6999, 7267]","[6382, 7267]","[831, 4773, 6830, 6999]","[5389, 6382, 7267]",9449,6,9443,2,4,9442,1
6.0,HSATPCP2,"[4013, 6152, 7490, 8957, 9752, 10918, 13435]","[7490, 10918]","[4013, 6152, 8957, 9752, 13435]","[7490, 10195, 10918]",15008,7,15001,2,5,15000,1
6.0,HSB3A,[2623],[],[2623],[1843],3675,1,3674,0,1,3673,1
6.0,HSBGPG,[560],[560],[],"[560, 850, 1096]",1667,1,1666,1,0,1664,2
6.0,HSBSF2,"[238, 1242, 2450, 2930, 3601, 4715]","[1242, 3601]","[238, 2450, 2930, 4715]","[1242, 1587, 2748, 3601]",5953,6,5947,2,4,5945,2
6.0,HSCBMYHC,"[369, 1577, 3932, 4595, 5485, 5644, 7246, 7735, 7912, 8898, 10877, 11339, 12427, 13342, 14210, 17120, 18777, 18896, 19262, 21839, 23454, 23701]","[4595, 5485, 5644, 7246, 8898, 10877, 11339, 12427, 13342, 14210, 17120, 18896, 19262, 21839, 23454, 23701]","[369, 1577, 3932, 7735, 7912, 18777]","[4595, 5041, 5485, 5644, 6354, 6529, 6694, 7246, 7567, 8354, 8898, 9174, 9626, 10530, 10877, 11339, 12155, 12427, 12829, 13342, 14210, 14571, 15900, 17120, 18228, 18590, 18896, 19262, 19970, 20319, 20604, 21466, 21839, 22088, 22474, 23454, 23701]",24992,22,24970,16,6,24949,21
6.0,HSCD14G,[159],[159],[],[159],1562,1,1561,1,0,1561,0
6.0,HSCKBG,"[876, 2570, 3521]",[3521],"[876, 2570]","[1341, 1619, 1824, 2380, 3174, 3521]",4192,3,4189,1,2,4184,5
6.0,HSCOMT2,"[1075, 2378]",[2378],[1075],"[1630, 1959, 2378]",3643,2,3641,1,1,3639,2
6.0,HSCPH70,"[865, 2936, 4407]",[4407],"[865, 2936]","[1729, 4204, 4407, 4801]",6703,3,6700,1,2,6697,3
6.0,HSCSF1PO,"[2816, 7572, 8287, 9217, 9575, 10517, 11515, 12975, 15733, 18046, 18156, 18465, 20123, 21444, 24260, 26732, 27465, 30823, 32862, 34006, 34399]","[7572, 8287, 18156, 18465, 20123, 27465, 30823, 34006]","[2816, 9217, 9575, 10517, 11515, 12975, 15733, 18046, 21444, 24260, 26732, 32862, 34399]","[1965, 7572, 8287, 10227, 11063, 15036, 17882, 18156, 18465, 20123, 26605, 26837, 27465, 28627, 30823, 31040, 32108, 32301, 33091, 34006]",35092,21,35071,8,13,35059,12
6.0,HSCST3G,"[1328, 3783, 3865, 4129]",[1328],"[3783, 3865, 4129]","[1328, 3694]",7284,4,7280,1,3,7279,1
6.0,HSCYCLA,"[2406, 5338, 6323]","[2406, 5338]",[6323],"[1393, 2406, 3731, 4168, 5338, 5911, 6667]",8355,3,8352,2,1,8347,5
6.0,HSCYP216,"[255, 879, 1836]","[255, 879, 1836]",[],"[255, 442, 879, 1088, 1278, 1466, 1836, 2215, 2402]",2763,3,2760,3,0,2754,6
6.0,HSCYP45C,"[185, 1772, 4680, 4963, 5008, 6016, 6562]",[6016],"[185, 1772, 4680, 4963, 5008, 6562]","[4942, 5624, 5801, 6016, 6248]",7546,7,7539,1,6,7535,4
6.0,HSCYTOK17,"[396, 452, 1709, 2079, 2304, 2928, 4123, 4987]","[1709, 2304, 4123]","[396, 452, 2079, 2928, 4987]","[581, 1709, 2304, 3066, 3693, 4000, 4123]",5252,8,5244,3,5,5240,4
6.0,HSCYTOK20,"[3128, 5281, 8722, 9470, 12705, 16620]","[5281, 9470, 12705]","[3128, 8722, 16620]","[5281, 7512, 9470, 9984, 10271, 11940, 12705]",18053,6,18047,3,3,18043,4
6.0,HSDAO,"[588, 956, 2551, 7431]",[7431],"[588, 956, 2551]","[6426, 7431, 9013]",9895,4,9891,1,3,9889,2
6.0,HSERPG,"[628, 1340, 1683, 2474]","[628, 1340, 1683, 2474]",[],"[628, 1340, 1683, 2474]",3390,4,3386,4,0,3386,0
6.0,HSFAU1,"[505, 857, 1096, 1129, 1613]","[857, 1096, 1613]","[505, 1129]","[857, 1096, 1613]",2008,5,2003,3,2,2003,0
6.0,HSFESFPS,"[1227, 1553, 4522, 5924, 6240, 6445, 7634, 8069, 9371, 11511]","[1227, 1553, 5924, 6240, 6445, 7634, 8069, 9371]","[4522, 11511]","[1227, 1553, 3023, 3336, 5405, 5598, 5924, 6240, 6445, 7150, 7634, 8069, 8782, 9151, 9371, 9768, 10015]",12255,10,12245,8,2,12236,9
6.0,HSGCSFG,"[404, 735, 1230, 1521]","[404, 1230, 1521]",[735],"[404, 744, 1230, 1521]",2952,4,2948,3,1,2947,1
6.0,HSGEBCMA,"[607, 700, 1648, 3234]",[607],"[700, 1648, 3234]","[607, 1496]",3711,4,3707,1,3,3706,1
6.0,HSGGL2,[547],[547],[],"[202, 547]",1620,1,1619,1,0,1618,1
6.0,HSGLA,"[2148, 8413, 11761]",[8413],"[2148, 11761]","[1374, 5269, 7447, 8413, 10293, 10708]",12428,3,12425,1,2,12420,5
6.0,HSGROW2,[345],[345],[],"[345, 762, 1091, 1349]",1956,1,1955,1,0,1952,3
6.0,HSGSTM4,[37],[37],[],"[37, 391, 874, 1262, 1458, 2469, 2670]",4834,1,4833,1,0,4827,6
6.0,HSGTRH,"[515, 2205, 2322, 3816, 5548, 6275]","[2205, 3816]","[515, 2322, 5548, 6275]","[2205, 3816]",7216,6,7210,2,4,7210,0
6.0,HSHMG17G,"[1793, 2279, 2524, 4021, 5920]","[2524, 4021]","[1793, 2279, 5920]","[2524, 3415, 3620, 4021, 4553]",7187,5,7182,2,3,7179,3
6.0,HSHNRNPA,"[814, 868, 2869, 3602, 4312]","[814, 2869]","[868, 3602, 4312]","[814, 1494, 1936, 2295, 2481, 2660, 2869, 3962]",5360,5,5355,2,3,5349,6
6.0,HSHOX51,"[1278, 1791, 2052, 4023]",[2052],"[1278, 1791, 4023]",[2052],6297,4,6293,1,3,6293,0
6.0,HSHSC70,"[27, 1245, 1773, 2250, 3307]","[1245, 1773, 2250, 3307]",[27],"[1245, 1773, 2250, 2893, 3307, 3734, 4114]",5400,5,5395,4,1,5392,3
6.0,HSIFNAR,"[631, 830, 2696, 5386, 8594, 15482, 16062, 16944, 19442, 20346, 24341, 25061, 28142, 29554, 30489]","[830, 16944, 19442, 25061, 29554]","[631, 2696, 5386, 8594, 15482, 16062, 20346, 24341, 28142, 30489]","[830, 11325, 16944, 19188, 19442, 21132, 25061, 25314, 28679, 29554]",32898,15,32883,5,10,32878,5
6.0,HSIFNG,"[1897, 2175, 2413]","[1897, 2175]",[2413],"[589, 1897, 2175]",5953,3,5950,2,1,5949,1
6.0,HSIL1AG,"[2208, 3215, 3939, 4326]","[2208, 3215, 4326]",[3939],"[2208, 3215, 4326, 6433, 7940]",11962,4,11958,3,1,11956,2
6.0,HSIL1B,"[3144, 7406]","[3144, 7406]",[],"[2528, 3144, 5327, 6039, 7406]",9703,2,9701,2,0,9698,3
6.0,HSINT2,"[3549, 10216, 10533, 10644, 10708]",[3549],"[10216, 10533, 10644, 10708]","[1156, 3549]",11600,5,11595,1,4,11594,1
6.0,HSL7A,"[2073, 2867, 3525, 4164, 4919]","[2073, 2867, 3525, 4164, 4919]",[],"[2073, 2867, 3525, 3881, 4164, 4572, 4919]",5498,5,5493,5,0,5491,2
6.0,HSLCATG,"[991, 1352, 1590, 2266, 2574, 5372, 5638, 6574]","[991, 2266, 2574]","[1352, 1590, 5372, 5638, 6574]","[991, 1881, 2076, 2266, 2574]",6893,8,6885,3,5,6883,2
6.0,HSMECDAG,"[716, 2584, 2776, 3170, 3852]","[2776, 3852]","[716, 2584, 3170]","[1393, 2517, 2776, 2966, 3544, 3852]",4362,5,4357,2,3,4353,4
6.0,HSMED,"[636, 789, 1354]",[1354],"[636, 789]","[1354, 1943, 2315, 4716]",5284,3,5281,1,2,5278,3
6.0,HSMT1H,[],[],[],"[816, 1475]",2134,0,2134,0,0,2132,2
6.0,HSNCAMX1,"[1550, 2245, 4142, 8529, 8552, 9373, 10015, 10317, 12072, 12786, 13049, 13893, 14002]","[4142, 8529, 9373, 10015, 10317, 12072, 12786, 13049, 13893, 14002]","[1550, 2245, 8552]","[1609, 4142, 4778, 5218, 6315, 6582, 6983, 7316, 7569, 7852, 8529, 8809, 9068, 9373, 9571, 10015, 10317, 10722, 11667, 12072, 12283, 12550, 12786, 13049, 13487, 13893, 14002]",16280,13,16267,10,3,16250,17
6.0,HSNFM,"[417, 432, 2675, 4491]",[2675],"[417, 432, 4491]","[1822, 2675]",6228,4,6224,1,3,6223,1
6.0,HSODCG,"[1002, 1938, 2912, 3968, 4649, 5421, 5633, 7614, 8052, 8090, 8854]","[4649, 5421, 5633, 7614]","[1002, 1938, 2912, 3968, 8052, 8090, 8854]","[4192, 4649, 5028, 5421, 5633, 5893, 7111, 7306, 7614]",9035,11,9024,4,7,9019,5
6.0,HSODF2,"[4, 158, 964, 993]",[],"[4, 158, 964, 993]",[600],1422,4,1418,0,4,1417,1
6.0,HSPAT133,"[393, 654, 794, 1173, 1447]",[1447],"[393, 654, 794, 1173]",[1447],3712,5,3707,1,4,3707,0
6.0,HSPLAPL,"[599, 827]","[599, 827]",[],"[403, 599, 827]",1274,2,1272,2,0,1271,1
6.0,HSPRB3L,"[566, 789]",[566],[789],"[566, 1537]",4508,2,4506,1,1,4505,1
6.0,HSPRB4S,[913],[],[913],"[693, 1658]",5805,1,5804,0,1,5802,2
6.0,HSPSAG,"[4044, 4080]",[4044],[4080],"[447, 1848, 3764, 4044]",5865,2,5863,1,1,5860,3
6.0,HSRPII145,"[588, 1233, 1688, 1729]","[588, 1233]","[1688, 1729]","[449, 588, 908, 1071, 1233]",2085,4,2081,2,2,2078,3
6.0,HSRPS7,"[404, 516, 1831, 2166, 2369, 4254, 5100, 6064, 6325]","[2166, 2369, 4254]","[404, 516, 1831, 5100, 6064, 6325]","[2166, 2369, 3108, 4254, 6734]",7505,9,7496,3,6,7494,2
6.0,HSSAA1B,"[862, 1009, 1543, 2345, 2367]",[1543],"[862, 1009, 2345, 2367]","[1543, 3845]",4815,5,4810,1,4,4809,1
6.0,HSSHBG,"[1058, 2672, 3148]","[1058, 3148]",[2672],"[472, 696, 1058, 1551, 1938, 2205, 3148]",3802,3,3799,2,1,3794,5
6.0,HSSSPN1AG,"[2330, 3491]",[3491],[2330],"[1343, 1635, 1809, 3360, 3491]",4088,2,4086,1,1,4082,4
6.0,HSSURF3,"[284, 1033, 1692, 2048, 2321, 3074]","[284, 1033, 1692, 2048, 2321, 3074]",[],"[284, 1033, 1692, 2048, 2321, 2729, 3074]",3407,6,3401,6,0,3400,1
6.0,HSTNFB,"[836, 1375, 3015]",[1375],"[836, 3015]","[1375, 1567]",3029,3,3026,1,2,3025,1
6.0,HSTPI1G,"[746, 972, 1558, 2035, 3181, 4651]","[746, 2035, 3181]","[972, 1558, 4651]","[746, 2035, 2231, 2438, 2821, 3181]",4987,6,4981,3,3,4978,3
6.0,HSTUBAG,"[536, 2065, 2287, 3733, 3759]","[536, 2287]","[2065, 3733, 3759]","[536, 2287, 2584]",4079,5,4074,2,3,4073,1
6.0,HSU01102,[668],[668],[],"[668, 3896]",4987,1,4986,1,0,4985,1
6.0,HSU04357,"[97, 1201, 1342, 1963]","[97, 1342]","[1201, 1963]","[97, 1342]",2074,4,2070,2,2,2070,0
6.0,HSU04636,"[103, 1018, 1935, 2199, 2996, 4424, 6008]","[1018, 1935, 2199, 2996, 4424, 6008]",[103],"[1018, 1935, 2199, 2996, 3608, 4424, 4790, 5359, 6008]",9445,7,9438,6,1,9435,3
6.0,HSU05259,"[2091, 2173]",[],"[2091, 2173]","[782, 2685, 3045, 4128]",5662,2,5660,0,2,5656,4
6.0,HSU07807,"[454, 757]",[757],[454],"[757, 3386]",4831,2,4829,1,1,4828,1
6.0,HSU07983,"[390, 1286]",[390],[1286],[390],1418,2,1416,1,1,1416,0
6.0,HSU08198,"[707, 1124, 1316, 1689, 1811, 1900]","[1124, 1316, 1689, 1811]","[707, 1900]","[583, 895, 1124, 1316, 1689, 1811]",2336,6,2330,4,2,2328,2
6.0,HSU12421,"[1941, 2080, 2255, 3573, 3747]",[2080],"[1941, 2255, 3573, 3747]","[311, 2080]",4250,5,4245,1,4,4244,1
6.0,HSUBR,"[1589, 2324]","[1589, 2324]",[],"[1589, 2324]",3287,2,3285,2,0,3285,0
6.0,HSXBXVIII,"[473, 1189, 2137, 2596, 3859, 4586, 5486, 6115, 7675, 9475, 11843, 12085]","[11843, 12085]","[473, 1189, 2137, 2596, 3859, 4586, 5486, 6115, 7675, 9475]","[11405, 11589, 11843, 12085]",12630,12,12618,2,10,12616,2
6.0,HSZNGP1,"[518, 565, 6347, 8597]",[518],"[565, 6347, 8597]","[518, 4718, 8313]",9815,4,9811,1,3,9809,2
6.0,HUMADAG,"[1355, 1677, 3737, 4817, 5267, 5657, 11568, 14450, 19292, 19529, 20776, 21114, 26467, 30860, 31304, 32497, 32675, 32916, 34484, 35203]","[19292, 26467, 31304, 32497, 32675, 32916, 34484, 35203]","[1355, 1677, 3737, 4817, 5267, 5657, 11568, 14450, 19529, 20776, 21114, 30860]","[4064, 19292, 26467, 29052, 29939, 31304, 32497, 32675, 32916, 34484, 35203]",36733,20,36713,8,12,36710,3
6.0,HUMADPRF02,"[1650, 3035, 3392]",[1650],"[3035, 3392]","[359, 1308, 1650]",5159,3,5156,1,2,5154,2
6.0,HUMAPEXN,"[349, 1465, 1535]",[1465],"[349, 1535]","[1465, 1863, 2622]",3722,3,3719,1,2,3717,2
6.0,HUMAPOCII,"[1557, 1778, 2995]",[2995],"[1557, 1778]","[2995, 3321]",4332,3,4329,1,2,4328,1
6.0,HUMAPOE4,"[1091, 1914, 3200]","[1914, 3200]",[1091],"[1914, 3200]",5507,3,5504,2,1,5504,0
6.0,HUMATPGG,"[1902, 4293, 6534, 7456, 14100]","[1902, 4293, 6534, 7456, 14100]",[],"[1445, 1727, 1902, 2677, 4293, 4749, 5307, 6118, 6534, 6749, 7456, 8198, 9436, 9672, 9946, 10190, 11405, 12074, 13663, 14100, 14276]",15107,5,15102,5,0,15086,16
6.0,HUMBETGLOA,"[687, 1311, 2559]",[1311],"[687, 2559]","[958, 1311]",2994,3,2991,1,2,2990,1
6.0,HUMBETGLOB,"[685, 1309, 2557]",[1309],"[685, 2557]","[956, 1309]",2992,3,2989,1,2,2988,1
6.0,HUMBETGLOC,"[687, 1311, 2559]",[1311],"[687, 2559]","[958, 1311]",2994,3,2991,1,2,2990,1
6.0,HUMBETGLOD,"[687, 1311, 2559]",[1311],"[687, 2559]","[958, 1311]",2994,3,2991,1,2,2990,1
6.0,HUMBETGLOE,"[685, 1309, 2557]",[1309],"[685, 2557]","[956, 1309]",2992,3,2989,1,2,2988,1
6.0,HUMBETGLOF,"[687, 1311, 2559]",[1311],"[687, 2559]","[958, 1311]",2994,3,2991,1,2,2990,1
6.0,HUMBETGLOG,"[687, 1311, 2559]",[1311],"[687, 2559]","[958, 1311]",2994,3,2991,1,2,2990,1
6.0,HUMBETGLOH,"[687, 1311, 2559]",[1311],"[687, 2559]","[958, 1311]",2994,3,2991,1,2,2990,1
6.0,HUMBETGLOI,"[685, 1309, 2557]",[1309],"[685, 2557]","[956, 1309]",2992,3,2989,1,2,2988,1
6.0,HUMBETGLOJ,"[685, 1309, 2557]",[1309],"[685, 2557]","[956, 1309]",2992,3,2989,1,2,2988,1
6.0,HUMBETGLOK,"[685, 1309, 2557]",[1309],"[685, 2557]","[956, 1309]",2992,3,2989,1,2,2988,1
6.0,HUMBETGLOL,"[685, 1309, 2557]",[1309],"[685, 2557]","[956, 1309]",2992,3,2989,1,2,2988,1
6.0,HUMBETGLOM,"[684, 1308, 2556]",[1308],"[684, 2556]","[955, 1308]",2991,3,2988,1,2,2987,1
6.0,HUMBETGLON,"[685, 1309, 2557]",[1309],"[685, 2557]","[956, 1309]",2992,3,2989,1,2,2988,1
6.0,HUMBETGLOO,"[685, 1309, 2557]",[1309],"[685, 2557]","[956, 1309]",2992,3,2989,1,2,2988,1
6.0,HUMBETGLOP,"[685, 1309, 2557]",[1309],"[685, 2557]","[956, 1309]",2992,3,2989,1,2,2988,1
6.0,HUMBETGLOR,"[685, 1309, 2557]",[1309],"[685, 2557]","[956, 1309]",2992,3,2989,1,2,2988,1
6.0,HUMCBRG,[1220],[1220],[],"[567, 1220]",3318,1,3317,1,0,3316,1
6.0,HUMCHYMASE,"[969, 5216, 6037]","[5216, 6037]",[969],"[5216, 6037, 6922, 7363]",8107,3,8104,2,1,8102,2
6.0,HUMCP21OH,"[947, 1571, 2528]","[947, 1571, 2528]",[],"[947, 1134, 1571, 1780, 1970, 2158, 2528, 2907, 3094]",4034,3,4031,3,0,4025,6
6.0,HUMCP21OHC,"[948, 1572, 2529]","[948, 1572, 2529]",[],"[948, 1135, 1572, 1781, 1971, 2159, 2529, 2908, 3096]",4036,3,4033,3,0,4027,6
6.0,HUMCS1,[565],[565],[],"[565, 991, 1334, 1591]",2293,1,2292,1,0,2289,3
6.0,HUMCS3,"[566, 2520]",[566],[2520],"[566, 991, 1334, 1588]",2732,2,2730,1,1,2727,3
6.0,HUMCSN2A,"[122, 3194, 4855, 5620, 5747, 9482]","[4855, 5747]","[122, 3194, 5620, 9482]","[4855, 5747, 6747, 6887, 8522]",10600,6,10594,2,4,10591,3
6.0,HUMCSPA,"[982, 2276, 2929, 3691]","[982, 2276, 2929]",[3691],"[982, 2276, 2929, 3392]",4783,4,4779,3,1,4778,1
6.0,HUMCTLA1,"[988, 1812, 2179, 2770, 3236]","[988, 2179, 2770, 3236]",[1812],"[988, 2179, 2770, 3236]",4520,5,4515,4,1,4515,0
6.0,HUMDEF5A,[],[],[],[1571],2872,0,2872,0,0,2871,1
6.0,HUMDZA2G,"[5389, 5436, 11212, 13467]",[5389],"[5436, 11212, 13467]","[5389, 9590, 13183]",14686,4,14682,1,3,14680,2
6.0,HUMELAFIN,"[326, 1461]",[326],[1461],[326],1870,2,1868,1,1,1868,0
6.0,HUMEPOHYDD,"[2289, 8696, 12105, 13924, 16085, 16775, 19204, 20857, 20994, 21354, 22952, 23010]","[8696, 16085, 16775, 19204, 21354]","[2289, 12105, 13924, 20857, 20994, 22952, 23010]","[5656, 8696, 15620, 16085, 16775, 19204, 21354]",24782,12,24770,5,7,24768,2
6.0,HUMG0S24B,[631],[631],[],[631],3127,1,3126,1,0,3126,0
6.0,HUMG0S8PP,"[3768, 4646]","[3768, 4646]",[],"[2682, 3768, 3932, 4646]",7337,2,7335,2,0,7333,2
6.0,HUMGAD45A,"[2596, 3645]","[2596, 3645]",[],"[2596, 3184, 3645]",5370,2,5368,2,0,5367,1
6.0,HUMGARE,"[3207, 4469]",[],"[3207, 4469]","[810, 2239, 2653, 3118]",4746,2,4744,0,2,4740,4
6.0,HUMGCK,"[3799, 6475]",[6475],[3799],"[1188, 3360, 3882, 4312, 4806, 5015, 5452, 5964, 6475]",7519,2,7517,1,1,7509,8
6.0,HUMGFP40H,[3126],[],[3126],"[910, 1058, 1173, 2593]",4371,1,4370,0,1,4366,4
6.0,HUMGHG,"[689, 1983, 2636, 3398]","[689, 1983, 2636]",[3398],"[689, 1983, 2636, 3099]",4444,4,4440,3,1,4439,1
6.0,HUMGHN,[569],[569],[],"[569, 989, 1316, 1574]",2649,1,2648,1,0,2645,3
6.0,HUMGHV,"[432, 566]",[566],[432],"[566, 998, 1328, 1584]",2652,2,2650,1,1,2647,3
6.0,HUMGSTM4A,"[777, 1272]",[777],[1272],"[777, 1139, 1631, 2024, 2225, 3262, 3463]",6074,2,6072,1,1,6066,6
6.0,HUMHMGIY,"[1075, 1472, 4627, 4660, 5150, 5496, 7133, 7166, 9286, 9390]",[4660],"[1075, 1472, 4627, 5150, 5496, 7133, 7166, 9286, 9390]","[4660, 6544, 7270]",10098,10,10088,1,9,10086,2
6.0,HUMHOX13G,[380],[],[380],[811],3062,1,3061,0,1,3060,1
6.0,HUMHPARS1,"[3855, 5577, 7692, 11385]","[3855, 5577]","[7692, 11385]","[1046, 2632, 3020, 3855, 4744, 5577]",11543,4,11539,2,2,11535,4
6.0,HUMIBP3,"[2441, 2845, 2935, 3142, 4358, 4406, 6617, 8353]","[2441, 6617]","[2845, 2935, 3142, 4358, 4406, 8353]","[2441, 5953, 6617]",10876,8,10868,2,6,10867,1
6.0,HUMIDS,"[2038, 2376, 4119, 4174, 4778, 5244, 11397, 14655, 15879, 15901, 25810, 29400, 30410, 31004, 34645, 35761]","[2038, 5244, 15879]","[2376, 4119, 4174, 4778, 11397, 14655, 15901, 25810, 29400, 30410, 31004, 34645, 35761]","[1160, 2038, 2882, 5244, 8086, 9847, 15879, 19268]",36837,16,36821,3,13,36816,5
6.0,HUMIGERA,"[1342, 1797, 2173, 3105, 4527, 5168]","[1342, 1797, 3105, 5168]","[2173, 4527]","[1342, 1797, 3105, 5168]",7651,6,7645,4,2,7645,0
6.0,HUMIL2RGA,"[840, 3031, 3353]","[3031, 3353]",[840],"[203, 735, 1128, 1476, 2402, 3031, 3353]",4030,3,4027,2,1,4022,5
6.0,HUMIL4A,"[1306, 1626, 3254, 8407, 8466]","[1306, 1626]","[3254, 8407, 8466]","[1306, 1626, 7003]",9892,5,9887,2,3,9886,1
6.0,HUMIRBPG,"[786, 3181, 3550, 5069]",[3181],"[786, 3550, 5069]","[3181, 5157, 7160]",9703,4,9699,1,3,9697,2
6.0,HUMLHDC,"[166, 3070, 7415, 10512, 11221, 11774, 14169, 14605, 18382, 18464, 18855, 20300, 20482, 22046, 23463, 31819]","[7415, 14605, 18382, 20300, 20482]","[166, 3070, 10512, 11221, 11774, 14169, 18464, 18855, 22046, 23463, 31819]","[7415, 9773, 14605, 15584, 18382, 18782, 19312, 20300, 20482, 24666, 29773]",32343,16,32327,5,11,32321,6
6.0,HUMLUCT,"[1550, 2861]","[1550, 2861]",[],"[1550, 2505, 2861]",3288,2,3286,2,0,3285,1
6.0,HUMLYTOXBB,"[1235, 1357, 2934, 6032]",[2934],"[1235, 1357, 6032]","[2934, 3376, 3631]",6297,4,6293,1,3,6291,2
6.0,HUMMCHEMP,"[159, 674]",[674],[159],"[674, 1590]",2756,2,2754,1,1,2753,1
6.0,HUMMET2,"[866, 1233]","[866, 1233]",[],"[866, 1233]",1695,2,1693,2,0,1693,0
6.0,HUMMGPA,[3748],[],[3748],"[3516, 5093, 6334]",7726,1,7725,0,1,7722,3
6.0,HUMMIF,[1643],[1643],[],"[1281, 1643]",2159,1,2158,1,0,2157,1
6.0,HUMMIS,[623],[623],[],"[623, 1358, 1639, 1887]",3092,1,3091,1,0,3088,3
6.0,HUMMKXX,[2463],[],[2463],"[1415, 1737, 2019]",3300,1,3299,0,1,3296,3
6.0,HUMNKG5PRO,"[2262, 3215, 3848, 5468]","[2262, 3215, 3848, 5468]",[],"[2262, 3215, 3848, 5468]",6738,4,6734,4,0,6734,0
6.0,HUMNTRI,"[2145, 2802, 3141]",[2802],"[2145, 3141]",[2802],3702,3,3699,1,2,3699,0
6.0,HUMNTRIII,"[2145, 2802, 3141]",[2802],"[2145, 3141]",[2802],3702,3,3699,1,2,3699,0
6.0,HUMOSTP,"[3657, 6986, 8035]","[3657, 6986]",[8035],"[3509, 3657, 6679, 6986, 8349]",10714,3,10711,2,1,10708,3
6.0,HUMPAP,"[1012, 1410, 3167, 3342, 4164]","[1410, 3167]","[1012, 3342, 4164]","[1410, 2089, 2414, 3167]",4489,5,4484,2,3,4482,2
6.0,HUMPCI,"[2226, 3307, 4697, 7199, 8568, 8725, 14117, 14247]",[8568],"[2226, 3307, 4697, 7199, 8725, 14117, 14247]","[8568, 10898, 11483]",15563,8,15555,1,7,15553,2
6.0,HUMPEM,"[934, 1033, 2266, 2707, 2973, 3203, 3297]","[934, 2266, 2707, 2973, 3203]","[1033, 3297]","[934, 2266, 2421, 2707, 2973, 3203]",4235,7,4228,5,2,4227,1
6.0,HUMPEPYYA,"[727, 1201, 1307]",[1201],"[727, 1307]","[1201, 1388]",2370,3,2367,1,2,2366,1
6.0,HUMPF4V1A,"[381, 826]","[381, 826]",[],"[381, 826]",1460,2,1458,2,0,1458,0
6.0,HUMPHOSA,"[850, 1494]","[850, 1494]",[],"[233, 850, 1494, 1810, 2323, 2988, 3209, 3729]",4884,2,4882,2,0,4876,6
6.0,HUMPRCA,"[130, 2309, 3438, 5118, 5348, 5452, 5585, 11461]","[5118, 5348, 5585]","[130, 2309, 3438, 5452, 11461]","[2201, 3631, 5118, 5348, 5585, 8396, 9387]",11717,8,11709,3,5,11705,4
6.0,HUMPREELAS,"[596, 1729]",[596],[1729],[596],2291,2,2289,1,1,2289,0
6.0,HUMPRPHX,"[1143, 1838, 2127, 2502, 2869, 3173, 3322, 3633]","[1838, 2127, 2869, 3173, 3322, 3633]","[1143, 2502]","[1346, 1838, 2127, 2652, 2869, 3173, 3322, 3633]",4524,8,4516,6,2,4514,2
6.0,HUMRCC1,"[638, 654, 2711, 4304, 4555, 5479, 5741, 11134, 12573, 14368, 14697, 22033, 24201, 26218, 26579, 28010, 28244, 28523, 29766]","[24201, 26218, 26579, 28010, 28244, 29766]","[638, 654, 2711, 4304, 4555, 5479, 5741, 11134, 12573, 14368, 14697, 22033, 28523]","[24201, 26218, 26579, 28010, 28244, 28893, 29247, 29766]",34633,19,34614,6,13,34612,2
6.0,HUMREGHOM,"[52, 684, 1909, 2739, 2825]","[684, 2739]","[52, 1909, 2825]","[684, 1419, 1864, 2739]",3403,5,3398,2,3,3396,2
6.0,HUMROD1X,[1876],[1876],[],"[1242, 1876]",2833,1,2832,1,0,2831,1
6.0,HUMRPIB2,"[899, 1531, 2758, 3588, 3674]","[1531, 3588]","[899, 2758, 3674]","[1531, 2268, 2713, 3588]",4329,5,4324,2,3,4322,2
6.0,HUMRPS6B,"[359, 1168, 1838]","[359, 1838]",[1168],"[359, 1059, 1838, 2178, 4051]",4964,3,4961,2,1,4958,3
6.0,HUMSEMI,[793],[793],[],[793],4156,1,4155,1,0,4155,0
6.0,HUMSEMIIB,"[4486, 4667, 5820, 6446]",[4486],"[4667, 5820, 6446]",[4486],8216,4,8212,1,3,8212,0
6.0,HUMSTATH2,"[1553, 2025, 2848]",[1553],"[2025, 2848]","[353, 1553, 1675]",4715,3,4712,1,2,4710,2
6.0,HUMTBGA,"[854, 1021, 4941, 6314]",[4941],"[854, 1021, 6314]","[4941, 6265, 7144]",8761,4,8757,1,3,8755,2
6.0,HUMTCRBRA,[278],[278],[],[278],728,1,727,1,0,727,0
6.0,HUMTHROMA,"[159, 787, 4817, 5134]",[4817],"[159, 787, 5134]","[1985, 2344, 2717, 4817]",6155,4,6151,1,3,6148,3
6.0,HUMTNP2SS,[],[],[],[658],1774,0,1774,0,0,1773,1
6.0,HUMTPALBU,"[2741, 4587]",[2741],[4587],"[1094, 1621, 2741, 3425, 4361]",6164,2,6162,1,1,6158,4
6.0,HUMTRHYAL,"[201, 1645, 2232]",[1645],"[201, 2232]",[1645],9543,3,9540,1,2,9540,0
6.0,HUMTSHB2,[187],[187],[],[187],978,1,977,1,0,977,0
6.0,HUMV2R,"[261, 1366, 1507, 2128]","[261, 1507]","[1366, 2128]","[261, 1507]",2274,4,2270,2,2,2270,0
6.0,HYPSCGH,"[806, 1624]",[1624],[806],"[41, 451, 1039, 1624]",2476,2,2474,1,1,2471,3
6.0,LAYEGLOBIN,"[238, 584]","[238, 584]",[],"[238, 584]",1694,2,1692,2,0,1692,0
6.0,LEBGLOB,"[94, 157, 1501, 1926]",[1926],"[94, 157, 1501]","[1577, 1926]",3638,4,3634,1,3,3633,1
6.0,LNOEGLOBIN,"[236, 587]","[236, 587]",[],"[236, 587]",1690,2,1688,2,0,1688,0
6.0,MACHBGA1,"[283, 841]",[841],[283],"[495, 841]",2097,2,2095,1,1,2094,1
6.0,MACHBGA2,"[281, 839]",[839],[281],"[493, 839]",2100,2,2098,1,1,2097,1
6.0,MAMGLUTRA,"[484, 2406, 5131]",[484],"[2406, 5131]","[484, 821, 1255, 1627, 1819, 2745, 2938]",6287,3,6284,1,2,6278,6
6.0,MAU09941,"[1031, 1166, 1830]",[1830],"[1031, 1166]",[1830],3798,3,3795,1,2,3795,0
6.0,MFAPOA2A,"[379, 785]","[379, 785]",[],"[379, 785]",1489,2,1487,2,0,1487,0
6.0,MFAPOC3A,[2232],[],[2232],"[913, 1172]",3254,1,3253,0,1,3251,2
6.0,MMA2IXCOA,"[1812, 4386, 5682, 7102, 7250, 7684, 8882, 9322, 9467, 9609, 9626, 13447, 13726, 14575, 15597, 15933, 16114, 16240, 16522, 16811, 17275, 18283]","[4386, 5682, 7102, 7250, 7684, 8882, 9322, 9467, 9626, 13447, 13726, 14575, 15597, 15933, 16114, 16240, 16522, 16811, 17275]","[1812, 9609, 18283]","[3132, 4386, 5682, 5831, 7102, 7250, 7371, 7684, 8064, 8216, 8401, 8539, 8882, 9322, 9467, 9626, 13033, 13447, 13726, 14575, 15021, 15338, 15597, 15746, 15933, 16114, 16240, 16522, 16811, 17275, 17647]",19471,22,19449,19,3,19437,12
6.0,MMACLGNA,[1458],[],[1458],"[474, 3178]",3873,1,3872,0,1,3870,2
6.0,MMAPOG,"[265, 536]",[536],[265],"[536, 806]",2168,2,2166,1,1,2165,1
6.0,MMASM1G,"[1088, 3245, 3745]","[1088, 3245, 3745]",[],"[1088, 2244, 2928, 3245, 3745]",4767,3,4764,3,0,4762,2
6.0,MMCASEIB,"[4901, 5615, 7023, 7160, 10443]","[7023, 7160]","[4901, 5615, 10443]","[6252, 7023, 7160, 8126, 8252, 9803]",13046,5,13041,2,3,13037,4
6.0,MMCD24A,[2486],[2486],[],[2486],7632,1,7631,1,0,7631,0
6.0,MMCFOS,"[844, 1850, 2363, 3414]","[844, 1850, 2363]",[3414],"[844, 1850, 2363]",3959,4,3955,3,1,3955,0
6.0,MMCOL10A,"[1070, 1802, 5660, 6146, 6704, 7009, 9322]",[1802],"[1070, 5660, 6146, 6704, 7009, 9322]",[1802],9323,7,9316,1,6,9316,0
6.0,MMCRPG,[],[],[],[375],2132,0,2132,0,0,2131,1
6.0,MMCYTOKNA,[810],[810],[],"[810, 1559]",2551,1,2550,1,0,2549,1
6.0,MMDM2RR,"[665, 854, 1651, 2702, 3378, 3962, 4925, 6030]","[665, 854, 1651, 2702, 3962, 4925]","[3378, 6030]","[665, 854, 1305, 1651, 2702, 3701, 3962, 4925, 5134]",6632,8,6624,6,2,6621,3
6.0,MMDNAASFA,"[855, 1497, 1576]","[855, 1576]",[1497],"[855, 1241, 1576, 1823, 2135, 2357, 2695]",4307,3,4304,2,1,4299,5
6.0,MMEZGL,[1599],[1599],[],"[589, 1599]",1945,1,1944,1,0,1943,1
6.0,MMG37,"[788, 2570]","[788, 2570]",[],"[332, 788, 1303, 2119, 2363, 2570]",3065,2,3063,2,0,3059,4
6.0,MMGBCRYA,"[671, 1003]","[671, 1003]",[],"[671, 1003]",2653,2,2651,2,0,2651,0
6.0,MMGCCRYA,"[721, 1056, 2488]","[721, 1056]",[2488],"[721, 1056]",2884,3,2881,2,1,2881,0
6.0,MMGFAPD,"[1901, 4335, 7907]","[1901, 4335, 7907]",[],"[713, 1624, 1901, 2995, 3906, 4335, 5452, 7907]",9963,3,9960,3,0,9955,5
6.0,MMGGLINE,"[204, 2076, 2634, 6374, 6955, 7513, 9179]",[7513],"[204, 2076, 2634, 6374, 6955, 9179]","[7167, 7513]",11278,7,11271,1,6,11270,1
6.0,MMGK5,[],[],[],"[695, 1805, 2595, 2825]",3602,0,3602,0,0,3598,4
6.0,MMH2D4Q5,"[159, 644]","[159, 644]",[],"[159, 644]",1100,2,1098,2,0,1098,0
6.0,MMHOX13,"[369, 1037, 1570]",[],"[369, 1037, 1570]",[800],2827,3,2824,0,3,2823,1
6.0,MMHOX24I,"[837, 1264]",[837],[1264],[837],1915,2,1913,1,1,1913,0
6.0,MMIL1BG,"[572, 1938, 4398, 5679]","[1938, 4398, 5679]",[572],"[1356, 1938, 3680, 4398, 5679]",7092,4,7088,3,1,7086,2
6.0,MMIL3G,[2090],[2090],[],"[686, 824, 1913, 2090]",3482,1,3481,1,0,3478,3
6.0,MMIL5G,"[3597, 5303]",[3597],[5303],"[731, 1593, 3597]",6719,2,6717,1,1,6715,2
6.0,MMKFGF,"[1045, 1337, 1556, 2886]",[1045],"[1337, 1556, 2886]","[542, 1045]",3981,4,3977,1,3,3976,1
6.0,MMLDHAG,"[4377, 4577, 5333, 7171, 7668, 8315, 8402, 8597]","[4577, 7171, 7668, 8597]","[4377, 5333, 8315, 8402]","[4577, 5919, 7171, 7668, 8597, 10704]",12843,8,12835,4,4,12833,2
6.0,MMMMP9A,"[2781, 3945, 4864, 5695, 6356, 6564]","[2781, 3945, 5695, 6356, 6564]",[4864],"[1341, 2008, 2375, 2781, 3064, 3418, 3945, 4206, 5695, 5936, 6356, 6564]",8182,6,8176,5,1,8169,7
6.0,MMMRPS24,"[404, 1460, 3934]","[404, 1460]",[3934],"[404, 1460, 1761, 3137]",5491,3,5488,2,1,5486,2
6.0,MMMTIX,[402],[402],[],"[402, 951]",1552,1,1551,1,0,1550,1
6.0,MMMUPBS6,[2425],[],[2425],"[731, 1203, 2045, 2793, 3236]",4614,1,4613,0,1,4608,5
6.0,MMMYCL,"[919, 7565, 8161]",[],"[919, 7565, 8161]",[1787],8308,3,8305,0,3,8304,1
6.0,MMNFMG,"[4409, 4804]",[],"[4409, 4804]","[1634, 2540]",5463,2,5461,0,2,5459,2
6.0,MMNMYC,[],[],[],[1163],4799,0,4799,0,0,4798,1
6.0,MMNUCLEO,"[863, 2042, 3040, 3141, 3984, 4071, 4293, 4879, 5198, 6230, 8122, 8928, 10436]","[2042, 3141, 4293, 4879, 5198, 6230, 8122, 10436]","[863, 3040, 3984, 4071, 8928]","[2042, 3141, 4293, 4694, 4879, 5198, 6230, 7517, 8122, 8738, 9050, 9881, 10436]",11470,13,11457,8,5,11452,5
6.0,MMODC2,"[737, 1374, 2508, 2523, 2702, 2999]","[737, 1374, 2508, 2702, 2999]",[2523],"[331, 737, 1053, 1374, 1557, 1801, 2508, 2702, 2999]",4252,6,4246,5,1,4242,4
6.0,MMOESTEOP,"[1127, 4834]",[1127],[4834],"[993, 1127, 2283, 2821, 4101]",5774,2,5772,1,1,5768,4
6.0,MMPO,"[324, 475, 561, 1709, 2446, 3054, 3728, 3749, 8043, 8907, 9903]","[2446, 3728, 8907, 9903]","[324, 475, 561, 1709, 3054, 3749, 8043]","[2193, 2446, 2948, 3503, 3728, 4018, 4769, 7167, 8440, 8907, 9903]",11905,11,11894,4,7,11887,7
6.0,MMPPSOMA,"[562, 1034, 1208]",[1034],"[562, 1208]",[1034],2556,3,2553,1,2,2553,0
6.0,MMPROP2,[],[],[],[289],712,0,712,0,0,711,1
6.0,MMPROT1,[],[],[],[759],1178,0,1178,0,0,1177,1
6.0,MMPROT2,"[508, 1218]",[1218],[508],[1218],1568,2,1566,1,1,1566,0
6.0,MMSAP,[441],[441],[],[441],1868,1,1867,1,0,1867,0
6.0,MMSCIMIP,"[415, 1017]","[415, 1017]",[],"[415, 1017]",1980,2,1978,2,0,1978,0
6.0,MMSYNDE1A,"[1345, 1992, 9867, 11397, 11583, 14080, 19009, 19542, 19726, 20385, 20735, 20942, 22802, 23203]","[1345, 19009, 20385, 20942]","[1992, 9867, 11397, 11583, 14080, 19542, 19726, 20735, 22802, 23203]","[1345, 19009, 20385, 20942]",23592,14,23578,4,10,23578,0
6.0,MMTHY1G,[1009],[1009],[],"[80, 1009]",2682,1,2681,1,0,2680,1
6.0,MMTLAC,"[299, 1171]","[299, 1171]",[],"[299, 748, 1171, 3092, 3338]",5239,2,5237,2,0,5234,3
6.0,MMTNFBG,"[1196, 1553, 1728]",[1728],"[1196, 1553]","[1728, 1911]",3211,3,3208,1,2,3207,1
6.0,MMTROPIB,"[183, 1832, 1932, 2033, 4604]","[1932, 4604]","[183, 1832, 2033]","[1697, 1932, 2185, 2656, 3037, 3564, 4604]",5683,5,5678,2,3,5673,5
6.0,MMTUM198,"[120, 2818, 3313, 3587, 3818, 4220]","[2818, 3313, 3587, 3818]","[120, 4220]","[1692, 2818, 3098, 3313, 3587, 3818, 4180]",4376,6,4370,4,2,4367,3
6.0,MMU01530,"[1357, 3231]",[3231],[1357],"[3094, 3231]",6694,2,6692,1,1,6691,1
6.0,MMU02278,[],[],[],[1638],3973,0,3973,0,0,3972,1
6.0,MMU02298,"[1180, 4897]",[1180],[4897],"[1180, 2413]",5851,2,5849,1,1,5848,1
6.0,MMU02884,"[814, 1630, 5244, 7567]","[1630, 5244]","[814, 7567]","[1630, 5244, 6836]",8757,4,8753,2,2,8752,1
6.0,MMU04056,"[901, 1382, 2747, 3530, 4688, 6264, 7683, 8680, 14615, 15417, 16348, 18100]","[1382, 3530, 4688]","[901, 2747, 6264, 7683, 8680, 14615, 15417, 16348, 18100]","[1382, 3530, 4688, 7979, 8895, 10317, 10876, 11259, 12211, 13491, 16230, 16561]",21710,12,21698,3,9,21689,9
6.0,MMU04827,"[105, 2280, 4281, 4301, 4969, 5675]","[4281, 4969]","[105, 2280, 4301, 5675]","[3684, 4281, 4969]",7600,6,7594,2,4,7593,1
6.0,MMU07568,"[84, 267, 482, 527]","[84, 267, 482]",[527],"[84, 267, 482]",743,4,739,3,1,739,0
6.0,MMU07808,"[61, 547, 673]",[673],"[61, 547]","[673, 1697]",2840,3,2837,1,2,2836,1
6.0,MMU09741,"[1094, 1230]",[1230],[1094],"[245, 1230]",2844,2,2842,1,1,2841,1
6.0,MMU09964,"[375, 2490, 2680, 3428, 5091, 5726, 6890, 7525, 7760, 7962, 8601, 11246]","[3428, 7962, 8601]","[375, 2490, 2680, 5091, 5726, 6890, 7525, 7760, 11246]","[1968, 3428, 4303, 4607, 7962, 8162, 8601, 9017, 9311, 10875]",11454,12,11442,3,9,11435,7
6.0,MMU10098,"[1173, 5292, 5695]",[1173],"[5292, 5695]","[1173, 3509]",6117,3,6114,1,2,6113,1
6.0,MMU11054,[204],[],[204],"[457, 1418, 1996]",2564,1,2563,0,1,2560,3
6.0,MMU11713,"[288, 634]","[288, 634]",[],"[288, 634]",1759,2,1757,2,0,1757,0
6.0,MMU12029,"[17, 582]",[582],[17],"[582, 1264]",2255,2,2253,1,1,2252,1
6.0,MMU12273,"[38, 680]",[680],[38],"[680, 1085, 1740]",2575,2,2573,1,1,2571,2
6.0,MMU12559,[],[],[],[247],918,0,918,0,0,917,1
6.0,MMU12560,[],[],[],[247],920,0,920,0,0,919,1
6.0,MMU12561,[],[],[],[247],916,0,916,0,0,915,1
6.0,MMU12562,[],[],[],[247],918,0,918,0,0,917,1
6.0,MMU12565,[247],[247],[],[247],1043,1,1042,1,0,1042,0
6.0,MMU13921,"[952, 1867, 2003, 2197, 2354, 3990]","[952, 2003, 2354, 3990]","[1867, 2197]","[952, 2003, 2354, 2693, 2930, 3241, 3990]",4670,6,4664,4,2,4661,3
6.0,MMU14421,[3848],[],[3848],"[3668, 4237, 4502, 4814]",6254,1,6253,0,1,6249,4
6.0,MMVITRO,"[2054, 2826, 3812, 3855, 4941, 4996]",[2054],"[2826, 3812, 3855, 4941, 4996]","[1845, 2054, 2474, 2693, 3017, 3279, 4355]",4996,6,4990,1,5,4984,6
6.0,MMVPREB2,"[172, 379]",[379],[172],[379],1045,2,1043,1,1,1043,0
6.0,MMVPREB3,"[172, 379]",[379],[172],[379],1045,2,1043,1,1,1043,0
6.0,MNKEGLOBIM,"[237, 583]","[237, 583]",[],"[237, 583]",1693,2,1691,2,0,1691,0
6.0,MNKEGLOBIN,"[237, 583]","[237, 583]",[],"[237, 583]",1691,2,1689,2,0,1689,0
6.0,MNKHGBGGAG,"[75, 633, 1338]",[633],"[75, 1338]","[287, 633]",1697,3,1694,1,2,1693,1
6.0,MNPROP2,[],[],[],[278],696,0,696,0,0,695,1
6.0,MUS8HS20,"[940, 2562]",[940],[2562],[940],2622,2,2620,1,1,2620,0
6.0,MUSAP,"[3574, 4740, 5547, 6013, 6406, 6709]","[3574, 4740, 6406, 6709]","[5547, 6013]","[3574, 3815, 4034, 4509, 4740, 4971, 5290, 5619, 5952, 6406, 6709]",8086,6,8080,4,2,8073,7
6.0,MUSAP5A,"[551, 697, 786, 1768, 2428, 2463, 4614, 6816]","[2428, 4614]","[551, 697, 786, 1768, 2463, 6816]","[2428, 2759, 4614]",6821,8,6813,2,6,6812,1
6.0,MUSAPEX,"[1042, 1684]",[1684],[1042],"[1684, 2089, 2742]",4034,2,4032,1,1,4030,2
6.0,MUSAPOAII,"[723, 1155]","[723, 1155]",[],"[723, 1155]",2952,2,2950,2,0,2950,0
6.0,MUSAPOIVA,"[588, 975, 1385]","[588, 975]",[1385],"[588, 975]",3012,3,3009,2,1,3009,0
6.0,MUSBMP4,"[768, 2149, 2473, 5497]",[],"[768, 2149, 2473, 5497]",[7179],9660,4,9656,0,4,9655,1
6.0,MUSBNP,"[336, 753]","[336, 753]",[],"[336, 753]",1460,2,1458,2,0,1458,0
6.0,MUSCD14A,[176],[176],[],[176],1865,1,1864,1,0,1864,0
6.0,MUSCRKNB,"[1440, 3842, 3862]",[3842],"[1440, 3862]","[1904, 2245, 2455, 2796, 3505, 3842]",4513,3,4510,1,2,4505,5
6.0,MUSCYTCOVB,[724],[724],[],"[724, 1319, 1585]",2532,1,2531,1,0,2529,2
6.0,MUSENDOBA,"[2117, 2130, 2743, 3115, 3618, 4049, 4430, 4898, 5090, 5589, 5696]","[2743, 3618, 4049, 5090, 5589]","[2117, 2130, 3115, 4430, 4898, 5696]","[2743, 3618, 4049, 4853, 5090, 5589]",7871,11,7860,5,6,7859,1
6.0,MUSFAUA,"[846, 1249, 1496, 2124]","[1249, 1496, 2124]",[846],"[1249, 1496, 2124]",2842,4,2838,3,1,2838,0
6.0,MUSFERHC,"[483, 1827, 2185]","[483, 1827, 2185]",[],"[483, 1827, 2185]",2782,3,2779,3,0,2779,0
6.0,MUSFKBP13X,"[321, 736]","[321, 736]",[],"[321, 736, 904, 1282]",1573,2,1571,2,0,1569,2
6.0,MUSGAD45,"[935, 1458, 2647]","[935, 1458]",[2647],"[935, 1126, 1458]",3092,3,3089,2,1,3088,1
6.0,MUSGFJE,[624],[624],[],"[624, 1489]",2403,1,2402,1,0,2401,1
6.0,MUSGPOAD,"[1044, 4403, 4816, 4916, 5400, 7929]","[1044, 4403, 4916]","[4816, 5400, 7929]","[1044, 2306, 4403, 4916]",8068,6,8062,3,3,8061,1
6.0,MUSHBBH0,"[365, 1112, 1265, 2081]",[365],"[1112, 1265, 2081]","[365, 914]",2127,4,2123,1,3,2122,1
6.0,MUSHBBH1,[451],[451],[],"[451, 780]",1918,1,1917,1,0,1916,1
6.0,MUSHES1,"[556, 1108, 1351]","[556, 1108]",[1351],"[556, 784, 1108]",2817,3,2814,2,1,2813,1
6.0,MUSHOX35A,"[232, 3519]",[],"[232, 3519]",[1308],3847,2,3845,0,2,3844,1
6.0,MUSIL1RN,"[512, 2186, 2289, 2483, 3549]","[512, 2483, 3549]","[2186, 2289]","[512, 2483, 3549]",6342,5,6337,3,2,6337,0
6.0,MUSKE3A,"[1604, 1881, 2194, 3405]",[],"[1604, 1881, 2194, 3405]","[21, 544, 3218, 3400]",3612,4,3608,0,4,3604,4
6.0,MUSLMP7A,"[1318, 1407, 3029]","[1318, 3029]",[1407],"[1318, 2153, 2454, 3029, 3674]",4259,3,4256,2,1,4253,3
6.0,MUSLTA,"[1207, 1632, 1807]",[1807],"[1207, 1632]","[1807, 1990]",3286,3,3283,1,2,3282,1
6.0,MUSMC26,"[843, 2419, 2475, 3666, 3716]",[2419],"[843, 2475, 3666, 3716]","[2419, 3190, 4144]",5386,5,5381,1,4,5379,2
6.0,MUSOGC,"[113, 489]","[113, 489]",[],"[113, 290, 489]",941,2,939,2,0,938,1
6.0,MUSOGCA,"[214, 285, 866, 1242]","[866, 1242]","[214, 285]","[866, 1043, 1242]",1694,4,1690,2,2,1689,1
6.0,MUSOGCB,"[113, 490]","[113, 490]",[],"[113, 290, 490]",942,2,940,2,0,939,1
6.0,MUSPNMT,"[1665, 1881, 2135, 2755]",[1665],"[1881, 2135, 2755]","[1665, 2343]",3136,4,3132,1,3,3131,1
6.0,MUSPROTA,"[1945, 2585, 3663]","[1945, 2585, 3663]",[],"[1945, 2585, 3224, 3663]",4636,3,4633,3,0,4632,1
6.0,MUSPROTEB,"[337, 496, 1024]",[337],"[496, 1024]","[337, 594, 993, 1988]",2389,3,2386,1,2,2383,3
6.0,MUSPRPC2,[3019],[],[3019],[801],7298,1,7297,0,1,7296,1
6.0,MUSPRPMPB,"[1480, 2974]",[],"[1480, 2974]",[801],3566,2,3564,0,2,3563,1
6.0,MUSREGI,"[775, 1159, 2230, 2993]","[1159, 2230, 2993]",[775],"[1159, 1799, 2230, 2993]",3748,4,3744,3,1,3743,1
6.0,MUSREGII,"[530, 927]",[927],[530],"[927, 1626, 1988, 3091]",3924,2,3922,1,1,3919,3
6.0,MUSROM1X,[],[],[],"[1242, 1848]",2779,0,2779,0,0,2777,2
6.0,MUSRPL30,"[500, 660, 2459, 3441]","[660, 2459]","[500, 3441]","[660, 1050, 2459]",3468,4,3464,2,2,3463,1
6.0,MUSRPS16,[1868],[1868],[],"[450, 687, 1868, 2005]",2641,1,2640,1,0,2637,3
6.0,MUSS100B,"[342, 1721, 4920, 5219]",[4920],"[342, 1721, 5219]",[4920],8865,4,8861,1,3,8861,0
6.0,MUSSERPROA,"[1034, 1449, 2092, 3178]","[1449, 2092, 3178]",[1034],"[1449, 2092, 2739, 3178]",4449,4,4445,3,1,4444,1
6.0,MUSSSATGN,"[840, 1825, 3039]","[840, 3039]",[1825],"[840, 1162, 1346, 2905, 3039]",4058,3,4055,2,1,4052,3
6.0,MUSTCP,"[453, 470, 4019, 4278, 4687, 6098, 7230, 7512]","[453, 4278, 4687, 6098, 7230, 7512]","[470, 4019]","[453, 1705, 1993, 3270, 3746, 4278, 4687, 6098, 6552, 7230, 7512]",9253,8,9245,6,2,9240,5
6.0,MUSTHY1,[1009],[1009],[],"[80, 1009]",2682,1,2681,1,0,2680,1
6.0,MUSTLAG,"[261, 705, 1573]","[705, 1573]",[261],"[705, 1155, 1573, 3494, 3740]",5412,3,5409,2,1,5406,3
6.0,MUSTSHBA2,[464],[464],[],[464],1283,1,1282,1,0,1282,0
6.0,MUSY1GLOB,"[377, 1249]",[377],[1249],"[377, 690]",1745,2,1743,1,1,1742,1
6.0,OABBGLOB,"[525, 958, 1309]","[958, 1309]",[525],"[958, 1309]",3241,3,3238,2,1,3238,0
6.0,OABCGLOB,"[957, 1312]","[957, 1312]",[],"[957, 1312]",3192,2,3190,2,0,3190,0
6.0,OAINIGFII1,[2106],[],[2106],[740],2385,1,2384,0,1,2383,1
6.0,OAINTL3,"[813, 1909, 2072]","[813, 1909, 2072]",[],"[674, 813, 1909, 2072]",2793,3,2790,3,0,2789,1
6.0,OAKRT213,"[3198, 4813, 5288, 5684, 8453, 9294]","[3198, 4813, 5288, 5684]","[8453, 9294]","[3198, 4147, 4813, 5288, 5684, 6077, 6548, 7393]",9521,6,9515,4,2,9511,4
6.0,OALGB,"[959, 2660, 3500]",[2660],"[959, 3500]","[938, 1742, 2660, 3883, 4656]",7371,3,7368,1,2,7364,4
6.0,OAMETIAG,[],[],[],"[701, 1479]",2792,0,2792,0,0,2790,2
6.0,OAMTIB,[],[],[],"[965, 1721]",3211,0,3211,0,0,3209,2
6.0,OAMTIC,[],[],[],"[621, 1295]",2375,0,2375,0,0,2373,2
6.0,OAMTII,"[799, 1023, 1976]",[1023],"[799, 1976]","[1023, 1378]",2047,3,2044,1,2,2043,1
6.0,OAPROTP1,[],[],[],[212],524,0,524,0,0,523,1
6.0,OATRICH,"[1183, 3157, 4772]",[3157],"[1183, 4772]",[3157],9336,3,9333,1,2,9333,0
6.0,OCAPOAIG,"[361, 1467]",[],"[361, 1467]","[553, 855]",1986,2,1984,0,2,1982,2
6.0,OCTNFBETA,"[68, 577]",[577],[68],"[577, 766]",1963,2,1961,1,1,1960,1
6.0,OCUTGLOB,"[3172, 3357, 3424, 5072]",[3357],"[3172, 3424, 5072]","[3357, 5831]",6560,4,6556,1,3,6555,1
6.0,OOGH,"[333, 1475]","[333, 1475]",[],"[333, 740, 1084, 1475]",2154,2,2152,2,0,2150,2
6.0,OPOP1,[],[],[],[249],616,0,616,0,0,615,1
6.0,ORAPROTP1A,[],[],[],[163],409,0,409,0,0,408,1
6.0,PAA1GL,"[204, 513]","[204, 513]",[],"[204, 513]",872,2,870,2,0,870,0
6.0,PAAFPG,[214],[214],[],[214],1087,1,1086,1,0,1086,0
6.0,PAU03674,"[3171, 4013]","[3171, 4013]",[],"[3171, 3574, 3773, 4013, 4294, 4611]",5437,2,5435,2,0,5431,4
6.0,PIGAPAI,"[562, 794]",[794],[562],"[794, 1129]",3325,2,3323,1,1,3322,1
6.0,PIGAPCIII,"[45, 867, 944]",[],"[45, 867, 944]","[1432, 1711]",3268,3,3265,0,3,3263,2
6.0,PIGCNP,"[400, 528, 1150, 1622]",[400],"[528, 1150, 1622]",[400],1886,4,1882,1,3,1882,0
6.0,PIGFSB,[1598],[],[1598],"[515, 1042]",2043,1,2042,0,1,2040,2
6.0,PIKEGLOBIN,"[237, 588]","[237, 588]",[],"[237, 588]",1701,2,1699,2,0,1699,0
6.0,PPGLTG,[662],[662],[],"[373, 662]",1064,1,1063,1,0,1062,1
6.0,PPPROP2,[],[],[],[319],739,0,739,0,0,738,1
6.0,PPYPROP2,[],[],[],[272],688,0,688,0,0,687,1
6.0,PTAZGLO,"[943, 1603, 1648]",[1603],"[943, 1648]","[1603, 3077]",3609,3,3606,1,2,3605,1
6.0,PTGGGLOG,[545],[545],[],"[200, 545]",1814,1,1813,1,0,1812,1
6.0,PTPPINS,[],[],[],[1410],2475,0,2475,0,0,2474,1
6.0,PTPROP2,[],[],[],[330],750,0,750,0,0,749,1
6.0,PVU11715,"[288, 633]","[288, 633]",[],"[288, 633]",1781,2,1779,2,0,1779,0
6.0,QULNFLW,"[1222, 3794, 5849, 5873, 6808]",[3794],"[1222, 5849, 5873, 6808]","[3794, 4656, 5921]",7925,5,7920,1,4,7918,2
6.0,QULTROPIA,"[591, 2360, 3004, 3437, 3638, 4047]","[2360, 3004, 3437, 4047]","[591, 3638]","[2186, 2360, 3004, 3437, 4047, 4336]",4956,6,4950,4,2,4948,2
6.0,RABCRP,[397],[397],[],[397],1430,1,1429,1,0,1429,0
6.0,RABDNP3AA,"[816, 2156]",[2156],[816],[2156],3082,2,3080,1,1,3080,0
6.0,RABSURFA,"[471, 3239, 4361, 5088, 6529]","[4361, 5088]","[471, 3239, 6529]","[4033, 4361, 5088]",8089,5,8084,2,3,8083,1
6.0,RABTNF,[851],[851],[],"[851, 1355, 1563]",3192,1,3191,1,0,3189,2
6.0,RATCYC,"[362, 572, 1333]",[1333],"[362, 572]",[1333],2520,3,2517,1,2,2517,0
6.0,RATCYSS,[1006],[1006],[],"[1006, 4026]",5555,1,5554,1,0,5553,1
6.0,RATDCCOVB,"[2267, 3716]",[2267],[3716],"[2267, 2864, 3126]",5323,2,5321,1,1,5319,2
6.0,RATGRG,"[83, 286, 2187, 2392, 3290]","[83, 286, 2187, 3290]",[2392],"[83, 286, 1291, 1494, 1696, 1942, 2187, 2319, 2616, 2994, 3290]",3880,5,3875,4,1,3868,7
6.0,RATGROS,"[1178, 1390]","[1178, 1390]",[],"[1178, 1390, 1587]",2488,2,2486,2,0,2485,1
6.0,RATGSTY,"[659, 2830, 3804]",[659],"[2830, 3804]","[659, 996, 1495, 1862, 2060, 3180, 3376]",6286,3,6283,1,2,6277,6
6.0,RATIGFBA,"[850, 1788, 2034, 3002, 4512]","[2034, 3002]","[850, 1788, 4512]","[526, 2034, 3002]",4992,5,4987,2,3,4986,1
6.0,RATJE,"[1191, 1299, 2986]",[1191],"[1299, 2986]","[1191, 1989]",3097,3,3094,1,2,3093,1
6.0,RATKALA,"[3282, 4709, 4729]","[3282, 4709]",[4729],"[1275, 3282, 4476, 4709]",6249,3,6246,2,1,6244,2
6.0,RATLHB,[817],[817],[],"[817, 1230]",1790,1,1789,1,0,1788,1
6.0,RATLITHOST,"[2464, 2847, 4652]","[2847, 4652]",[2464],"[2847, 3471, 3902, 4652]",5399,3,5396,2,1,5394,2
6.0,RATLYSOZYM,"[960, 3255]",[3255],[960],"[1561, 3255, 5174]",6732,2,6730,1,1,6728,2
6.0,RATLYSZYM,"[6, 1007, 1099, 1667, 3840, 4290]",[4290],"[6, 1007, 1099, 1667, 3840]","[574, 4290, 6230]",7943,6,7937,1,5,7935,2
6.0,RATOSCAL,"[1192, 1586]","[1192, 1586]",[],"[1192, 1373, 1586]",2119,2,2117,2,0,2116,1
6.0,RATPAP,"[633, 1648]",[1648],[633],"[1308, 1648, 2295, 2604, 3305]",4863,2,4861,1,1,4857,4
6.0,RATPAPIIB,"[1916, 2291, 2298, 3387, 4107]","[2298, 4107]","[1916, 2291, 3387]","[2298, 3140, 3473, 4107]",4717,5,4712,2,3,4710,2
6.0,RATPPP,"[1497, 1538, 2002, 2451, 4400]",[],"[1497, 1538, 2002, 2451, 4400]",[2261],4534,5,4529,0,5,4528,1
6.0,RATPTBZR02,"[871, 1927, 2066, 3232]",[2066],"[871, 1927, 3232]","[1306, 2066]",3426,4,3422,1,3,3421,1
6.0,RATRGPI,"[2329, 2712, 4521]","[2712, 4521]",[2329],"[2712, 3339, 3770, 4521]",5237,3,5234,2,1,5232,2
6.0,RATRPIII,"[1226, 1601, 1608, 2704, 3426]","[1608, 3426]","[1226, 1601, 2704]","[1608, 2456, 2790, 3426]",4133,5,4128,2,3,4126,2
6.0,RATSVSIV1,"[72, 244, 892]",[244],"[72, 892]",[244],972,3,969,1,2,969,0
6.0,RATTSHB,"[265, 4375]",[4375],[265],[4375],5159,2,5157,1,1,5157,0
6.0,RN0B2GLOB,"[693, 1134]",[693],[1134],"[354, 693]",1789,2,1787,1,1,1786,1
6.0,RN2BGLOB,[764],[764],[],"[432, 764]",1876,1,1875,1,0,1874,1
6.0,RN3B2GLOB,[460],[460],[],"[122, 460]",1436,1,1435,1,0,1434,1
6.0,RN3B3GLOB,[739],[739],[],"[403, 739]",1738,1,1737,1,0,1736,1
6.0,RN3BGLOB,[626],[626],[],"[288, 626]",1526,1,1525,1,0,1524,1
6.0,RNAC01,"[127, 309, 1367, 2597, 2685, 2867]","[1367, 2597, 2867]","[127, 309, 2685]","[1367, 1694, 2597, 2867]",4083,6,4077,3,3,4076,1
6.0,RNAC02,"[1787, 2138, 2561]","[1787, 2138]",[2561],"[1368, 1787, 2138, 2429, 2743]",3192,3,3189,2,1,3186,3
6.0,RNANTANT,"[1524, 3119]",[1524],[3119],"[1524, 3263, 3883]",5117,2,5115,1,1,5113,2
6.0,RNAPOEG,"[1293, 1955, 2863]","[1293, 1955]",[2863],"[1293, 1955]",3229,3,3226,2,1,3226,0
6.0,RNCALBD9,[2736],[2736],[],[2736],4883,1,4882,1,0,4882,0
6.0,RNGAMT,"[4003, 4704, 4715]",[4003],"[4704, 4715]","[2173, 3141, 3319, 3760, 4003]",4956,3,4953,1,2,4949,4
6.0,RNGMTG,"[1011, 1682, 2067, 3918, 4463]","[1682, 3918, 4463]","[1011, 2067]","[1682, 3249, 3918, 4254, 4463]",5391,5,5386,3,2,5384,2
6.0,RNGROW3,"[216, 471]",[471],[216],"[471, 817, 1652, 1973]",2549,2,2547,1,1,2544,3
6.0,RNHSC73,"[498, 1244, 1713, 1982, 3448]","[1244, 1713, 1982, 3448]",[498],"[1244, 1713, 1982, 2618, 3034, 3448, 3766]",4312,5,4307,4,1,4304,3
6.0,RNLALB01,[2419],[2419],[],"[1414, 1914, 2419]",3812,1,3811,1,0,3809,2
6.0,RNLPKG,"[2847, 3195, 7818, 8078, 12937]","[7818, 8078]","[2847, 3195, 12937]","[3219, 3949, 6009, 6284, 6605, 7192, 7453, 7818, 8078, 9480]",13003,5,12998,2,3,12990,8
6.0,RNODC,"[1344, 3918, 4182, 4517, 4982, 5631, 5825, 6291]","[3918, 4182, 4517, 5631, 5825, 6291]","[1344, 4982]","[3525, 3918, 4182, 4517, 4698, 4953, 5631, 5825, 6291]",7768,8,7760,6,2,7757,3
6.0,RNP9KA,"[823, 1227, 2311]",[1227],"[823, 2311]",[1227],2332,3,2329,1,2,2329,0
6.0,RNPBPG,"[1117, 1155, 1180, 4056]",[1117],"[1155, 1180, 4056]","[1117, 2950]",6021,4,6017,1,3,6016,1
6.0,RNPGMUT,[1216],[],[1216],"[1596, 1872]",2420,1,2419,0,1,2417,2
6.0,RNPROST22,[876],[876],[],"[876, 3647, 4526]",7667,1,7666,1,0,7664,2
6.0,RNREVSV2A,"[67, 1341]",[67],[1341],"[67, 1304]",1730,2,1728,1,1,1727,1
6.0,RNSDHG,"[379, 1993, 2205, 5691, 6052, 6253, 6984, 7081]","[5691, 6052, 6253, 6984]","[379, 1993, 2205, 7081]","[4640, 5691, 6052, 6253, 6984, 8671]",9570,8,9562,4,4,9560,2
6.0,RNSVFG,"[500, 1250, 1267]",[500],"[1250, 1267]",[500],1841,3,1838,1,2,1838,0
6.0,RNTHYCSG,"[318, 1071, 1906]",[1071],"[318, 1906]","[68, 1071]",2855,3,2852,1,2,2851,1
6.0,RNU03551,"[832, 2418]","[832, 2418]",[],"[832, 2418, 3083]",3590,2,3588,2,0,3587,1
6.0,RNU09193,"[1727, 3787, 3899]",[3787],"[1727, 3899]","[2084, 2749, 3084, 3787]",4187,3,4184,1,2,4181,3
6.0,RNU12250,"[293, 473]","[293, 473]",[],"[293, 473]",1863,2,1861,2,0,1861,0
6.0,RNUCPG,"[4187, 6121, 7395, 8157, 9172, 10198, 10292, 10603, 11061]",[8157],"[4187, 6121, 7395, 9172, 10198, 10292, 10603, 11061]","[4310, 5157, 7964, 8157, 9401]",12496,9,12487,1,8,12483,4
6.0,RNVEGP1,"[1043, 1994, 2076, 4037, 4140, 4844]",[4037],"[1043, 1994, 2076, 4140, 4844]","[1262, 1834, 3032, 4037, 4611]",5948,6,5942,1,5,5938,4
6.0,RNVEGP2C,"[1159, 2182, 4146, 4960, 5078]",[4146],"[1159, 2182, 4960, 5078]","[1378, 1950, 3128, 4146, 4723]",5742,5,5737,1,4,5733,4
6.0,RRU04320,[2500],[2500],[],"[2500, 3643]",6798,1,6797,1,0,6796,1
6.0,S46763,"[1235, 1252, 4801, 5060, 5469, 6880, 8012, 8294]","[1235, 5060, 5469, 6880, 8012, 8294]","[1252, 4801]","[1235, 2487, 2775, 4052, 4528, 5060, 5469, 6880, 7334, 8012, 8294]",10035,8,10027,6,2,10022,5
6.0,S49651,[1652],[1652],[],"[1652, 2786, 3255, 4137]",5440,1,5439,1,0,5436,3
6.0,S57980,[875],[875],[],"[875, 3645, 4524]",7665,1,7664,1,0,7662,2
6.0,S62287,[190],[],[190],[1266],3425,1,3424,0,1,3423,1
6.0,S63697,[280],[280],[],"[280, 829]",1331,1,1330,1,0,1329,1
6.0,S66606,"[2506, 4598]","[2506, 4598]",[],"[2506, 2706, 3899, 4598]",6359,2,6357,2,0,6355,2
6.0,S67057,[840],[840],[],[840],1746,1,1745,1,0,1745,0
6.0,S69277,"[3316, 3839]","[3316, 3839]",[],"[3098, 3316, 3521, 3839, 4103]",5516,2,5514,2,0,5511,3
6.0,S69278,"[846, 861, 2826, 3347, 3832]","[2826, 3347]","[846, 861, 3832]","[2590, 2826, 3031, 3347, 3561]",5015,5,5010,2,3,5007,3
6.0,S69350,[235],[235],[],[235],2152,1,2151,1,0,2151,0
6.0,SAIEGLOBIM,"[237, 588, 983]","[237, 588]",[983],"[237, 588]",1826,3,1823,2,1,1823,0
6.0,SMIGCU,"[799, 1233, 1946, 2624]","[799, 1233]","[1946, 2624]","[799, 1233, 1631]",2833,4,2829,2,2,2828,1
6.0,SMNPRP1A,[],[],[],[215],623,0,623,0,0,622,1
6.0,SOEEGLOBIN,"[236, 586]","[236, 586]",[],"[236, 586]",1688,2,1686,2,0,1686,0
6.0,SSBAT1G,"[1471, 2215, 2582, 2814, 4538, 6104, 9144]","[2215, 2582, 4538, 9144]","[1471, 2814, 6104]","[1316, 2215, 2582, 4538, 5771, 8238, 9144, 9388, 9674]",10666,7,10659,4,3,10654,5
6.0,SSIKBAGE,"[3713, 4091, 4470]","[3713, 4091, 4470]",[],"[2469, 3151, 3713, 4091, 4470]",5756,3,5753,3,0,5751,2
6.0,SSPINT1B,"[2551, 6605, 6774, 8049, 8611]","[2551, 6605]","[6774, 8049, 8611]","[1971, 2551, 3903, 5245, 6605]",8743,5,8738,2,3,8735,3
6.0,TAPROTP1,[],[],[],[230],547,0,547,0,0,546,1
6.0,TARHBE,"[119, 465]","[119, 465]",[],"[119, 465]",1682,2,1680,2,0,1680,0
6.0,TARHBG,"[58, 265, 608]",[265],"[58, 608]","[265, 612]",2139,3,2136,1,2,2135,1
6.0,TFLPA2P1,"[596, 972, 1749, 2495]","[596, 972, 1749]",[2495],"[596, 972, 1749]",2708,4,2704,3,1,2704,0
6.0,TFLPA2P2,"[590, 966, 1783]","[590, 966, 1783]",[],"[590, 966, 1783]",2431,3,2428,3,0,2428,0
6.0,TFLPA2P3,"[596, 972, 1749, 2495]","[596, 972, 1749]",[2495],"[596, 972, 1749]",2708,4,2704,3,1,2704,0
6.0,TFLPA2P4,"[590, 966, 1783]","[590, 966, 1783]",[],"[590, 966, 1783]",2431,3,2428,3,0,2428,0
6.0,TGLHBB,[2034],[],[2034],"[519, 888]",2300,1,2299,0,1,2297,2
6.0,TIOPRP1A,[],[],[],[212],556,0,556,0,0,555,1
6.0,U00432,"[237, 1101]","[237, 1101]",[],"[83, 237, 793, 1101, 1312]",1575,2,1573,2,0,1570,3
6.0,U00433,"[267, 752]","[267, 752]",[],"[83, 267, 752, 1062, 1270]",1545,2,1543,2,0,1540,3
6.0,U00454,"[1598, 4179, 5820, 6800]",[1598],"[4179, 5820, 6800]","[1598, 4862]",7192,4,7188,1,3,7187,1
6.0,U00938,"[1169, 3079, 4070, 5155, 5202, 5261, 5809]","[1169, 4070, 5155]","[3079, 5202, 5261, 5809]","[1169, 4070, 5155]",6780,7,6773,3,4,6773,0
6.0,U01026,"[1364, 1746, 2537]","[1364, 1746, 2537]",[],"[1364, 1746, 2537]",3216,3,3213,3,0,3213,0
6.0,U01027,"[571, 947, 1710, 2740]","[571, 947, 1710]",[2740],"[571, 947, 1710]",2761,4,2757,3,1,2757,0
6.0,U01844,"[2090, 2653, 3211]","[2653, 3211]",[2090],"[1986, 2141, 2474, 2653, 3211]",4219,3,4216,2,1,4213,3
6.0,XELCRPGA,"[842, 1096]",[1096],[842],[1096],3891,2,3889,1,1,3889,0
6.0,XELCRYB,[],[],[],"[706, 1326]",2049,0,2049,0,0,2047,2
6.0,XELHBBC,[263],[263],[],"[263, 678]",1981,1,1980,1,0,1979,1
6.0,XLACTA,"[553, 2591, 4138, 4845, 4946]","[2591, 4138, 4845]","[553, 4946]","[2591, 3868, 4138, 4845, 5128]",5946,5,5941,3,2,5939,2
6.0,XLACTCAG,"[831, 3128, 3614, 4931, 6461, 7511, 8347, 8892]","[3614, 4931, 6461]","[831, 3128, 7511, 8347, 8892]","[2473, 3614, 4931, 5562, 6461]",8900,8,8892,3,5,8890,2
6.0,XLBGL3,[1175],[1175],[],"[388, 1175]",2964,1,2963,1,0,2962,1
6.0,XLGLAA1,[],[],[],"[137, 502]",1192,0,1192,0,0,1190,2
6.0,XLGLAA2,[1163],[],[1163],"[138, 519]",1192,1,1191,0,1,1189,2
6.0,XLK81A1G,"[2734, 3531, 3849]","[2734, 3531, 3849]",[],"[1759, 2294, 2734, 3026, 3531, 3849, 4170]",5892,3,5889,3,0,5885,4
6.0,XLRPL14,[1292],[],[1292],"[912, 1891, 2087, 4978, 5356, 7904]",9116,1,9115,0,1,9109,6
6.0,XLRPL1AG,"[2638, 3735, 3831, 4573, 5179, 5303, 6451]","[3831, 4573, 5179]","[2638, 3735, 5303, 6451]","[512, 2121, 2438, 2818, 3137, 3831, 4573, 5179, 5757]",6949,7,6942,3,4,6936,6
6.0,XLS8,"[164, 692, 3963, 5912, 7381, 12978]","[5912, 7381]","[164, 692, 3963, 12978]","[2032, 3938, 5912, 7381, 12177]",13512,6,13506,2,4,13503,3
6.0,XLTUBAG,"[595, 678, 1280, 4179, 5575, 6630]","[678, 5575]","[595, 1280, 4179, 6630]","[678, 4401, 5575]",6888,6,6882,2,4,6881,1
6.0,XLXANF1A,[],[],[],"[1460, 1960, 2706]",4878,0,4878,0,0,4875,3
6.0,XTGLA,[2838],[2838],[],"[731, 2838]",4838,1,4837,1,0,4836,1
6.0,XTGLAA,[],[],[],"[1036, 1411]",1992,0,1992,0,0,1990,2
6.0,XTGLB,[21],[],[21],"[2384, 2836]",4043,1,4042,0,1,4040,2
6.0,ZEFB2MICB,"[1187, 1345]",[1187],[1345],"[304, 1187]",2193,2,2191,1,1,2190,1
