Threshold,Locus,Predict Sites,Positive Sites,Negative Sites,Actual Donor Sites,Predict Num,Predict Positive Num,Predict Negative Num,TP,FP,TN,FN
4.0,ACU08131,"[463, 642, 710, 845, 1024, 1255, 1363, 1735, 2029, 2245, 2350, 2498, 2803, 3336, 3798, 3914, 4038, 4306, 4512, 5313]","[642, 1363, 2029, 2803, 3798]","[463, 710, 845, 1024, 1255, 1735, 2245, 2350, 2498, 3336, 3914, 4038, 4306, 4512, 5313]","[642, 1363, 2029, 2803, 3798]",5384,20,5364,5,15,5364,0
4.0,AGGGLINE,"[32, 70, 805, 869, 935, 1571, 2325, 2347, 2658, 2946, 2963, 3120, 3158, 3504, 3600, 4035, 4309, 4685, 5259, 5585, 5648, 6262, 6387, 6421, 7054]","[3158, 3504]","[32, 70, 805, 869, 935, 1571, 2325, 2347, 2658, 2946, 2963, 3120, 3600, 4035, 4309, 4685, 5259, 5585, 5648, 6262, 6387, 6421, 7054]","[3158, 3504]",7220,25,7195,2,23,7195,0
4.0,AGU04852,"[491, 536, 631, 653, 734, 1464, 2073, 2117, 2302, 2478, 2972, 3116, 3402, 3788, 3877, 3956, 4566, 4701, 4863, 4906, 5517, 5912, 6224, 6383, 6740, 7509, 7636, 8085, 8301, 8354, 8635, 8694, 8817, 8877, 8934, 8961, 9856, 10812]","[3956, 5517, 5912, 6740]","[491, 536, 631, 653, 734, 1464, 2073, 2117, 2302, 2478, 2972, 3116, 3402, 3788, 3877, 4566, 4701, 4863, 4906, 6224, 6383, 7509, 7636, 8085, 8301, 8354, 8635, 8694, 8817, 8877, 8934, 8961, 9856, 10812]","[3956, 5517, 5912, 6740]",10976,38,10938,4,34,10938,0
4.0,ALOEGLOBIM,"[221, 237, 583, 1170, 1297]","[237, 583]","[221, 1170, 1297]","[237, 583]",1683,5,1678,2,3,1678,0
4.0,ALOEGLOBIN,"[221, 237, 583, 1170, 1182, 1297]","[237, 583]","[221, 1170, 1182, 1297]","[237, 583]",1683,6,1677,2,4,1677,0
4.0,ALOPROTP1A,"[59, 166, 267]",[166],"[59, 267]",[166],410,3,407,1,2,407,0
4.0,AMU12024,"[257, 667, 1583, 1594, 1695, 1960, 2013, 2126, 2482, 2685]","[257, 667, 2126, 2482]","[1583, 1594, 1695, 1960, 2013, 2685]","[257, 667, 1864, 2126, 2482]",3644,10,3634,4,6,3633,1
4.0,AMU12025,"[1080, 1412, 1830, 2485, 2654, 2689, 2705, 2736, 2789, 2902, 3278, 3313, 3343, 4481]","[1412, 1830, 2654, 2902, 3278]","[1080, 2485, 2689, 2705, 2736, 2789, 3313, 3343, 4481]","[1412, 1830, 2654, 2902, 3278]",5375,14,5361,5,9,5361,0
4.0,AOIRHODOPS,"[141, 255, 620, 894, 1314, 1702, 1749, 1969, 2754, 4005, 4067, 4336, 4385, 4840, 4953, 5373, 5452, 6243, 6372, 7039, 7056, 7580, 7600, 7622, 7630, 7800, 8003, 8308, 8837, 9057, 9133]","[1702, 4067, 5373, 6243]","[141, 255, 620, 894, 1314, 1749, 1969, 2754, 4005, 4336, 4385, 4840, 4953, 5452, 6372, 7039, 7056, 7580, 7600, 7622, 7630, 7800, 8003, 8308, 8837, 9057, 9133]","[1702, 4067, 5373, 6243]",9915,31,9884,4,27,9884,0
4.0,ASPROP2,"[75, 589]",[],"[75, 589]",[325],664,2,662,0,2,661,1
4.0,ASYRVISP,"[99, 260, 625, 634, 656, 1042, 1166, 1335, 1419, 1585, 1916, 2021]","[625, 1042, 1335, 1585, 1916]","[99, 260, 634, 656, 1166, 1419, 2021]","[625, 1042, 1335, 1585, 1916]",2221,12,2209,5,7,2209,0
4.0,ATREGLOBIN,"[221, 237, 588, 604, 1187, 1314]","[237, 588]","[221, 604, 1187, 1314]","[237, 588]",1691,6,1685,2,4,1685,0
4.0,BABAPOE,"[33, 60, 198, 267, 481, 550, 897, 1080, 1374, 1702, 2109, 2262, 2803, 2847, 3916, 3978, 3999]","[897, 2847]","[33, 60, 198, 267, 481, 550, 1080, 1374, 1702, 2109, 2262, 2803, 3916, 3978, 3999]","[897, 2847]",4754,17,4737,2,15,4737,0
4.0,BATROX,"[341, 875, 1839, 2078, 2428, 2446, 2890, 3011, 3556, 3593, 3924, 3967, 3975, 4110, 4495, 4705, 4836, 5035, 5085, 6789, 6874, 6955, 7378, 7567, 7655, 7992]","[341, 3011, 5035, 6955]","[875, 1839, 2078, 2428, 2446, 2890, 3556, 3593, 3924, 3967, 3975, 4110, 4495, 4705, 4836, 5085, 6789, 6874, 7378, 7567, 7655, 7992]","[341, 3011, 5035, 6955]",8092,26,8066,4,22,8066,0
4.0,BCHEGLOBIN,"[221, 237, 583, 1184, 1196, 1311]","[237, 583]","[221, 1184, 1196, 1311]","[237, 583]",1697,6,1691,2,4,1691,0
4.0,BOVANPA,"[334, 433, 858]","[433, 858]",[334],"[433, 858]",1761,3,1758,2,1,1758,0
4.0,BOVCOX7AL,"[1056, 1501, 1540, 1826, 2141, 2470, 2630, 2812, 2867, 2874, 3328, 3721, 3969, 4284, 4555, 5049, 5521, 6167]","[1540, 2812, 5049]","[1056, 1501, 1826, 2141, 2470, 2630, 2867, 2874, 3328, 3721, 3969, 4284, 4555, 5521, 6167]","[1540, 2812, 5049]",6848,18,6830,3,15,6830,0
4.0,BOVGAS,"[192, 406, 751, 996]",[751],"[192, 406, 996]",[751],1058,4,1054,1,3,1054,0
4.0,BOVIAP,"[174, 437, 457, 533, 602, 926, 1116, 1318, 1568, 1764, 1994, 2107, 2159, 2269, 2354, 2756, 2793, 2864, 2999, 3092, 3392, 3440, 3535, 3667, 3782, 3996, 4024, 4731, 5074, 5262]","[1568, 1764, 1994, 2354, 2999, 3392, 3667, 3996]","[174, 437, 457, 533, 602, 926, 1116, 1318, 2107, 2159, 2269, 2756, 2793, 2864, 3092, 3440, 3535, 3782, 4024, 4731, 5074, 5262]","[1568, 1764, 1994, 2354, 2606, 2999, 3157, 3392, 3667, 3996]",5391,30,5361,8,22,5359,2
4.0,BOVIRBP,"[129, 552, 936, 994, 1284, 1509, 2388, 2586, 2649, 2769, 3090, 3174, 3723, 3801, 4212, 4806, 4970, 4983, 5048, 5349, 5507, 5595, 5643, 5761, 6214, 6494, 6540, 6779, 7699, 7773, 8937, 9190, 9309, 9959, 10082, 10749, 10841, 11020]","[3174, 5595, 7699]","[129, 552, 936, 994, 1284, 1509, 2388, 2586, 2649, 2769, 3090, 3723, 3801, 4212, 4806, 4970, 4983, 5048, 5349, 5507, 5643, 5761, 6214, 6494, 6540, 6779, 7773, 8937, 9190, 9309, 9959, 10082, 10749, 10841, 11020]","[3174, 5595, 7699]",11785,38,11747,3,35,11747,0
4.0,BOVLHB,"[244, 592, 761, 803, 944, 1062, 1272, 1401, 1460]","[803, 1272]","[244, 592, 761, 944, 1062, 1401, 1460]","[803, 1272]",1856,9,1847,2,7,1847,0
4.0,BOVLYSOZMA,"[70, 322, 397, 944, 2115, 2268, 2374, 2819, 2872, 2973, 3039, 3078, 3208, 3255, 3424, 3672, 4100, 4372, 4694, 5256, 5771, 5955, 6973, 7260, 7512, 7928, 8654, 9247, 9304, 9453, 9603, 10062, 10799]","[3039, 5771, 8654]","[70, 322, 397, 944, 2115, 2268, 2374, 2819, 2872, 2973, 3078, 3208, 3255, 3424, 3672, 4100, 4372, 4694, 5256, 5955, 6973, 7260, 7512, 7928, 9247, 9304, 9453, 9603, 10062, 10799]","[3039, 5771, 8654]",12214,33,12181,3,30,12181,0
4.0,BOVLYSOZMB,"[140, 461, 646, 1229, 1662, 1890, 1993, 2453, 2506, 2607, 2673, 2843, 3007, 3717, 3743, 4005, 4135, 4797, 5148, 5241, 5594, 5708, 5732, 6212, 6807, 6895, 6917, 6928, 7058, 7511, 8354, 9580, 10002]","[2673, 4005, 6212]","[140, 461, 646, 1229, 1662, 1890, 1993, 2453, 2506, 2607, 2843, 3007, 3717, 3743, 4135, 4797, 5148, 5241, 5594, 5708, 5732, 6807, 6895, 6917, 6928, 7058, 7511, 8354, 9580, 10002]","[2673, 4005, 6212]",10204,33,10171,3,30,10171,0
4.0,BOVLYSOZMC,"[738, 839, 905, 1274, 2107, 2323, 2933, 3388, 4194, 4908, 4941, 4964, 5325, 6235, 6245, 6302]","[905, 2323, 4194]","[738, 839, 1274, 2107, 2933, 3388, 4908, 4941, 4964, 5325, 6235, 6245, 6302]","[905, 2323, 4194]",8043,16,8027,3,13,8027,0
4.0,BOVMYF5A,"[273, 698, 1398, 1433, 1625, 1824, 2273, 2895, 3199, 3272, 3947, 4171, 4402, 4583, 4629, 4851]","[698, 1625]","[273, 1398, 1433, 1824, 2273, 2895, 3199, 3272, 3947, 4171, 4402, 4583, 4629, 4851]","[698, 1625]",5211,16,5195,2,14,5195,0
4.0,BRHOX22,"[600, 843, 1431, 1815, 2301, 2493, 2572, 3122]",[1431],"[600, 843, 1815, 2301, 2493, 2572, 3122]",[1431],3434,8,3426,1,7,3426,0
4.0,BRHOX34A,"[460, 588, 613, 981, 1359, 1791, 1819, 2313, 2675, 3491]",[981],"[460, 588, 613, 1359, 1791, 1819, 2313, 2675, 3491]",[981],3490,10,3480,1,9,3480,0
4.0,BRU12895,"[793, 799, 1135, 1526, 1986, 2140, 2232, 2341]",[1135],"[793, 799, 1526, 1986, 2140, 2232, 2341]",[1135],3232,8,3224,1,7,3224,0
4.0,BTATPAAA,"[55, 296, 740, 826, 1111, 1146, 1166, 1200, 2314, 2377, 2501, 2761, 3383, 3707, 4106, 4183, 4188, 5345, 5556, 5729, 5886, 5953, 6155, 6472, 7693, 7770, 7885, 7915, 8023, 8311, 8831, 9129, 9733, 9844]","[740, 2314, 3707, 5729, 7770, 8023, 9129]","[55, 296, 826, 1111, 1146, 1166, 1200, 2377, 2501, 2761, 3383, 4106, 4183, 4188, 5345, 5556, 5886, 5953, 6155, 6472, 7693, 7885, 7915, 8311, 8831, 9733, 9844]","[740, 2314, 3707, 5729, 5984, 6337, 6827, 7151, 7770, 8023, 9129]",9907,34,9873,7,27,9869,4
4.0,BTEBGL2,"[201, 294, 310, 327, 658, 920, 1171, 1254]","[310, 658]","[201, 294, 327, 920, 1171, 1254]","[310, 658]",1833,8,1825,2,6,1825,0
4.0,BTEBGL4,"[4, 201, 294, 310, 327, 658, 815]","[310, 658]","[4, 201, 294, 327, 815]","[310, 658]",1828,7,1821,2,5,1821,0
4.0,BTGL01,"[98, 327, 349, 365, 711, 873, 910, 1008]","[365, 1008]","[98, 327, 349, 711, 873, 910]","[365, 1008]",2040,8,2032,2,6,2032,0
4.0,BTHOR02,"[16, 169, 484, 1123, 1268, 1920, 1936]","[484, 1920]","[16, 169, 1123, 1268, 1936]","[484, 1920]",2419,7,2412,2,5,2412,0
4.0,BTKER6B,"[826, 1008, 1678, 1820, 1830, 1925, 2044, 2171, 2219, 2346, 2559, 2913, 2926, 3070, 3530, 4056, 4335, 4666, 5608, 5686]","[1678, 2559, 3070, 3530, 4056, 4666]","[826, 1008, 1820, 1830, 1925, 2044, 2171, 2219, 2346, 2913, 2926, 4335, 5608, 5686]","[1678, 2559, 3070, 3315, 3530, 4056, 4666]",5718,20,5698,6,14,5697,1
4.0,BTSPDNA,"[84, 685, 960, 1054, 1546, 2123]",[],"[84, 685, 960, 1054, 1546, 2123]",[1541],2148,6,2142,0,6,2141,1
4.0,BTSVSP109,"[52, 799, 1357, 1452, 1604, 2189, 2258, 2359, 2387, 2555, 2863, 5292, 5315, 5643, 6096, 6131, 6240, 6451, 6730]","[2359, 5292]","[52, 799, 1357, 1452, 1604, 2189, 2258, 2387, 2555, 2863, 5315, 5643, 6096, 6131, 6240, 6451, 6730]","[2359, 3984, 5292]",6948,19,6929,2,17,6928,1
4.0,BTTNP2G,"[24, 125, 710, 774, 847, 852, 1029, 1115, 1326, 1342]",[774],"[24, 125, 710, 847, 852, 1029, 1115, 1326, 1342]",[774],1841,10,1831,1,9,1831,0
4.0,BTU02285,"[21, 434, 1476, 1858, 2131, 2334, 2367, 2438, 2873, 2936, 2980, 3792, 3866, 4169, 4222, 4325, 4487, 4780, 5056, 5087, 5654, 6075]","[3792, 4222, 4487, 4780, 5056]","[21, 434, 1476, 1858, 2131, 2334, 2367, 2438, 2873, 2936, 2980, 3866, 4169, 4325, 5087, 5654, 6075]","[3792, 4222, 4487, 4780, 5056]",6388,22,6366,5,17,6366,0
4.0,CALEGLOBIM,"[220, 236, 345, 587, 603, 1185, 1197, 1312]","[236, 587]","[220, 345, 603, 1185, 1197, 1312]","[236, 587]",1690,8,1682,2,6,1682,0
4.0,CBUEGLOBIM,"[220, 236, 345, 587, 603, 874, 1185, 1197, 1312]","[236, 587]","[220, 345, 603, 874, 1185, 1197, 1312]","[236, 587]",1690,9,1681,2,7,1681,0
4.0,CCALAC,"[436, 932, 1128, 1178, 1358, 1852, 2409, 2973, 3275, 3279, 3333, 3397]","[1358, 1852, 2409]","[436, 932, 1128, 1178, 2973, 3275, 3279, 3333, 3397]","[1358, 1852, 2409]",3619,12,3607,3,9,3607,0
4.0,CCBEGLOBIM,"[221, 237, 587, 1191, 1203, 1318]","[237, 587]","[221, 1191, 1203, 1318]","[237, 587]",1695,6,1689,2,4,1689,0
4.0,CCBEGLOBIN,"[222, 238, 589, 1194, 1206, 1321]","[238, 589]","[222, 1194, 1206, 1321]","[238, 589]",1698,6,1692,2,4,1692,0
4.0,CCGHG,"[283, 863, 1051, 1389, 1778, 2305]","[283, 1051, 1778]","[863, 1389, 2305]","[283, 706, 1051, 1778]",2830,6,2824,3,3,2823,1
4.0,CCGONBS1,"[1649, 1767, 1974, 2688]",[1767],"[1649, 1974, 2688]","[1767, 2072]",3463,4,3459,1,3,3458,1
4.0,CCGONBS2,"[1667, 1785, 1993, 2344, 2707]",[1785],"[1667, 1993, 2344, 2707]","[1785, 2091]",3482,5,3477,1,4,3476,1
4.0,CCGTHA1,"[26, 166, 302, 390]",[302],"[26, 166, 390]","[302, 572]",1144,4,1140,1,3,1139,1
4.0,CCT64CLU,"[274, 563, 1644, 1664, 2757, 2761, 2766, 3005, 3496, 4436, 4514, 4518, 4572, 4577, 4643, 5272, 5528, 5659, 6121, 6277]","[1644, 2757, 3005, 3496, 4514, 5272, 5659]","[274, 563, 1664, 2761, 2766, 4436, 4518, 4572, 4577, 4643, 5528, 6121, 6277]","[1644, 2757, 3005, 3496, 4514, 5272, 5659]",6276,20,6256,7,13,6256,0
4.0,CEPPINS,"[464, 490, 858, 1399, 1509, 1513, 1615, 1760]",[858],"[464, 490, 1399, 1509, 1513, 1615, 1760]",[858],1901,8,1893,1,7,1893,0
4.0,CHBLG,"[166, 698, 928, 1465, 1472, 2301, 2308, 2564, 2807, 3030, 3640, 3788, 3794, 4019, 4266, 4298, 4700, 4861, 4919, 5246, 5573, 5619, 5756, 6025, 6255, 6280, 6376, 6555]","[4019, 5246, 6025]","[166, 698, 928, 1465, 1472, 2301, 2308, 2564, 2807, 3030, 3640, 3788, 3794, 4266, 4298, 4700, 4861, 4919, 5573, 5619, 5756, 6255, 6280, 6376, 6555]","[2285, 3090, 4019, 5246, 6025]",8080,28,8052,3,25,8050,2
4.0,CHEBGLI,"[456, 909, 1213]",[909],"[456, 1213]","[570, 909]",2204,3,2201,1,2,2200,1
4.0,CHEBGLII,"[217, 454, 547, 563, 580, 912, 923, 1049, 1426]","[563, 912]","[217, 454, 547, 580, 923, 1049, 1426]","[563, 912]",2258,9,2249,2,7,2249,0
4.0,CHKALDB,"[535, 606, 1062, 1452, 1506, 1922, 1927, 2460, 3077, 3115, 4004, 4388, 4462, 4802, 5731, 5748, 6172, 6664, 6955, 6960, 6983, 7265, 7360, 7487, 7504, 7523, 8186, 8617, 9185, 9626, 10577, 10705, 10844]","[6172, 6664, 6955, 7265, 8186, 9185]","[535, 606, 1062, 1452, 1506, 1922, 1927, 2460, 3077, 3115, 4004, 4388, 4462, 4802, 5731, 5748, 6960, 6983, 7360, 7487, 7504, 7523, 8617, 9626, 10577, 10705, 10844]","[6172, 6664, 6955, 7265, 8186, 8842, 9185]",11643,33,11610,6,27,11609,1
4.0,CHKAPOII,"[282, 1246, 1328, 1339, 1626, 1839, 1891, 1901, 2131, 2620, 2798, 3317, 3381, 3771, 3820, 3906, 3975, 4026, 4488]","[3317, 3820]","[282, 1246, 1328, 1339, 1626, 1839, 1891, 1901, 2131, 2620, 2798, 3381, 3771, 3906, 3975, 4026, 4488]","[3317, 3820]",4953,19,4934,2,17,4934,0
4.0,CHKDPCP,"[347, 637, 1624, 1878]",[637],"[347, 1624, 1878]",[637],1902,4,1898,1,3,1898,0
4.0,CHKMAX,"[27, 632, 727, 1236, 1299, 1816, 2127, 2291, 2882, 3172, 3189, 3400, 3928, 4295, 4931, 5130, 5173]","[2127, 2291, 3928, 4295]","[27, 632, 727, 1236, 1299, 1816, 2882, 3172, 3189, 3400, 4931, 5130, 5173]","[2127, 2291, 3928, 4295]",5690,17,5673,4,13,5673,0
4.0,CHKMYOD,"[316, 984, 1268, 1738, 2106, 3066, 3379, 3468, 4038, 4849, 4941, 5145, 5517, 5592, 5660, 6150, 6284, 6456, 6527]","[4941, 6150]","[316, 984, 1268, 1738, 2106, 3066, 3379, 3468, 4038, 4849, 5145, 5517, 5592, 5660, 6284, 6456, 6527]","[4941, 6150]",7381,19,7362,2,17,7362,0
4.0,CHKOVAL,"[779, 1293, 1390, 2449, 2657, 3164, 3466, 3812, 3915, 4176, 4694, 4890, 4915, 5144, 5170, 6282, 6975, 7079, 7148, 7691, 8334, 8410, 8791, 9028]","[3164, 3466, 4176, 4694, 6282]","[779, 1293, 1390, 2449, 2657, 3812, 3915, 4890, 4915, 5144, 5170, 6975, 7079, 7148, 7691, 8334, 8410, 8791, 9028]","[3164, 3466, 4176, 4694, 5795, 6282]",9198,24,9174,5,19,9173,1
4.0,CHKRPL30,"[545, 571, 671, 749, 801, 916, 1471, 1684, 1778, 1872, 2113, 2158, 2753, 2816, 2850, 3799, 3838]","[801, 1872, 2753]","[545, 571, 671, 749, 916, 1471, 1684, 1778, 2113, 2158, 2816, 2850, 3799, 3838]","[801, 1872, 2753]",3884,17,3867,3,14,3867,0
4.0,CHKRPL37A,"[16, 201, 798, 996, 1265, 1376, 1558, 1618, 1946, 2125, 2255, 2386, 2739, 3052, 3376]","[798, 1376, 2386]","[16, 201, 996, 1265, 1558, 1618, 1946, 2125, 2255, 2739, 3052, 3376]","[798, 1376, 2386]",3465,15,3450,3,12,3450,0
4.0,CHKRPL5G,"[99, 153, 300, 498, 1227, 1419, 1540, 1632, 1637, 2138, 2397, 2428, 2618, 2974, 3157, 3433, 4259, 4746, 5165, 6060, 6897, 7986]","[498, 1419, 1632, 3157, 5165, 6897]","[99, 153, 300, 1227, 1540, 1637, 2138, 2397, 2428, 2618, 2974, 3433, 4259, 4746, 6060, 7986]","[498, 1419, 1632, 3157, 3955, 5165, 6897]",8313,22,8291,6,16,8290,1
4.0,CHKTUB4B,"[243, 264, 437, 762, 779, 949, 1188, 1199, 1469, 1573, 1710, 1895, 3110]","[437, 949, 1573]","[243, 264, 762, 779, 1188, 1199, 1469, 1710, 1895, 3110]","[437, 949, 1573]",3145,13,3132,3,10,3132,0
4.0,CHKY,"[319, 641, 691, 794, 1650, 1664, 2096, 2197, 2725, 2858, 3082, 3577, 3603, 3953, 4199, 4683, 4750, 5049, 5186, 5213, 5648, 6012, 6249, 6473, 8349, 8361]","[3603, 4199, 4683, 5648, 6012, 6249]","[319, 641, 691, 794, 1650, 1664, 2096, 2197, 2725, 2858, 3082, 3577, 3953, 4750, 5049, 5186, 5213, 6473, 8349, 8361]","[3603, 4199, 4683, 5648, 6012, 6249]",8364,26,8338,6,20,8338,0
4.0,CHPPHYGEN,"[22, 543, 555, 1736, 1818, 2214, 2284, 3020, 3516, 3764, 3786, 4096, 4387, 4561, 4599, 4945, 5459, 5471, 5521, 6609, 6693, 7000, 7011, 7072, 7138, 7830, 8472, 8746, 8823, 8841, 8862, 9306, 9395, 9894, 10066, 10818, 10833, 10849, 11000, 11193, 11828, 11903, 11936, 12575, 12603, 13318, 13493, 13548]","[4599, 4945]","[22, 543, 555, 1736, 1818, 2214, 2284, 3020, 3516, 3764, 3786, 4096, 4387, 4561, 5459, 5471, 5521, 6609, 6693, 7000, 7011, 7072, 7138, 7830, 8472, 8746, 8823, 8841, 8862, 9306, 9395, 9894, 10066, 10818, 10833, 10849, 11000, 11193, 11828, 11903, 11936, 12575, 12603, 13318, 13493, 13548]","[4599, 4945]",13689,48,13641,2,46,13641,0
4.0,CHPPROTP1A,"[58, 159]",[159],[58],[159],397,2,395,1,1,395,0
4.0,CHPPROTP1B,"[56, 160]",[160],[56],[160],396,2,394,1,1,394,0
4.0,CHWEGLOBIM,"[221, 237, 588, 1193, 1319]","[237, 588]","[221, 1193, 1319]","[237, 588]",1701,5,1696,2,3,1696,0
4.0,CIGH,"[457, 1249, 1281, 2029, 2130, 2280, 2536, 2593, 2889]","[1281, 2280, 2889]","[457, 1249, 2029, 2130, 2536, 2593]","[1281, 1691, 2280, 2889]",3967,9,3958,3,6,3957,1
4.0,CITEGLOBIM,"[220, 236, 345, 587, 603, 890, 1186, 1198, 1313]","[236, 587]","[220, 345, 603, 890, 1186, 1198, 1313]","[236, 587]",1691,9,1682,2,7,1682,0
4.0,CJAEGLOBIN,"[221, 237, 588, 1193, 1319]","[237, 588]","[221, 1193, 1319]","[237, 588]",1702,5,1697,2,3,1697,0
4.0,CJINTERFG,"[191, 512, 1143, 1860, 2428, 2635, 2881, 3158, 3303, 4125, 4187, 4465, 4702, 4730, 4750, 5524, 6036, 6127, 6397, 6760, 7468, 8152, 8324, 8352, 8486]","[2881, 4187, 4465]","[191, 512, 1143, 1860, 2428, 2635, 3158, 3303, 4125, 4702, 4730, 4750, 5524, 6036, 6127, 6397, 6760, 7468, 8152, 8324, 8352, 8486]","[2881, 4187, 4465]",8519,25,8494,3,22,8494,0
4.0,CL54K,"[119, 141, 183, 512, 535, 649, 706, 771, 959, 1177, 1186, 1238, 1294, 1538, 1926, 2581, 2696, 2715, 2954, 3218]",[512],"[119, 141, 183, 535, 649, 706, 771, 959, 1177, 1186, 1238, 1294, 1538, 1926, 2581, 2696, 2715, 2954, 3218]",[512],3407,20,3387,1,19,3387,0
4.0,CMBGA2B2,"[383, 718, 810, 989, 1597]","[383, 718]","[810, 989, 1597]","[383, 718]",2684,5,2679,2,3,2679,0
4.0,CMEGA2E2,"[416, 492, 718, 753]","[416, 753]","[492, 718]","[416, 753]",2046,4,2042,2,2,2042,0
4.0,CMU11711,"[15, 204, 790, 826, 906, 1647, 1685, 2031, 2627]","[1685, 2031]","[15, 204, 790, 826, 906, 1647, 2627]","[1685, 2031]",3163,9,3154,2,7,3154,0
4.0,CPPROT1GN,"[102, 164, 255]",[164],"[102, 255]",[164],390,3,387,1,2,387,0
4.0,CRASEQB,"[79, 669, 783, 1920, 2123, 2825, 3434, 3452, 3464, 3482, 3593, 3635, 3641, 3647, 3812, 4825, 4931]","[1920, 2825]","[79, 669, 783, 2123, 3434, 3452, 3464, 3482, 3593, 3635, 3641, 3647, 3812, 4825, 4931]","[1920, 2825]",5120,17,5103,2,15,5103,0
4.0,CRUCH7AHYD,"[1205, 1339, 1731, 2690, 2936, 2941, 3016, 3418, 3651, 3792, 3841, 4121, 4201, 4774, 5283, 6963, 7866, 7901, 9375, 9626, 10316]","[1731, 3651, 7866]","[1205, 1339, 2690, 2936, 2941, 3016, 3418, 3792, 3841, 4121, 4201, 4774, 5283, 6963, 7901, 9375, 9626, 10316]","[1731, 3651, 4938, 6076, 7866]",10606,21,10585,3,18,10583,2
4.0,CRUGAD45A,"[208, 691, 859, 1811, 1877, 1971, 2063, 2417, 2500, 2553, 3428, 3555, 3605, 4003]","[1877, 2063, 2417]","[208, 691, 859, 1811, 1971, 2500, 2553, 3428, 3555, 3605, 4003]","[1877, 2063, 2417]",4427,14,4413,3,11,4413,0
4.0,DMPROTP1,[249],[249],[],[249],616,1,615,1,0,615,0
4.0,DMU11712,"[16, 792, 1667, 1705, 2043]","[1705, 2043]","[16, 792, 1667]","[1705, 2043]",3019,5,3014,2,3,3014,0
4.0,DOGCOLIP,"[224, 249, 416, 789, 1108, 1343, 1411, 1747, 2378, 2503, 2508, 2694, 2821, 2839, 3119]","[1108, 2378]","[224, 249, 416, 789, 1343, 1411, 1747, 2503, 2508, 2694, 2821, 2839, 3119]","[1108, 2378]",3156,15,3141,2,13,3141,0
4.0,DOGIL8T,"[118, 577, 671, 1206, 1406, 1769, 1918]","[118, 1406, 1769]","[577, 671, 1206, 1918]","[118, 1406, 1769]",2229,7,2222,3,4,2222,0
4.0,ECGLOAP1,"[363, 657, 889, 962, 968]","[363, 657]","[889, 962, 968]","[363, 657]",1133,5,1128,2,3,1128,0
4.0,ECPZA2GL,"[19, 193, 767, 954, 1560, 1585, 1600, 1623, 1648, 1728, 2012, 2153, 2613, 3576, 3650, 3945, 4059, 5046, 5060, 5077]","[3576, 4059]","[19, 193, 767, 954, 1560, 1585, 1600, 1623, 1648, 1728, 2012, 2153, 2613, 3650, 3945, 5046, 5060, 5077]","[3576, 4059]",5081,20,5061,2,18,5061,0
4.0,ECZGL1,"[700, 725, 740, 763, 845, 874, 1033, 1534]","[700, 1534]","[725, 740, 763, 845, 874, 1033]","[700, 1534]",1993,8,1985,2,6,1985,0
4.0,ECZGL2,"[255, 280, 295, 318, 400, 429, 588, 1084]","[255, 1084]","[280, 295, 318, 400, 429, 588]","[255, 1084]",1555,8,1547,2,6,1547,0
4.0,ELMETL,"[1097, 1120, 1291]","[1097, 1291]",[1120],"[1097, 1291]",1865,3,1862,2,1,1862,0
4.0,FDFELDI2,"[276, 641, 678, 703, 1070, 1643, 1882, 2011]",[276],"[641, 678, 703, 1070, 1643, 1882, 2011]","[276, 970]",2417,8,2409,1,7,2408,1
4.0,FDTNFA,"[187, 291, 547, 790, 885, 972, 1590]","[187, 790, 972]","[291, 547, 885, 1590]","[187, 790, 972]",1714,7,1707,3,4,1707,0
4.0,GDMYF5G,"[138, 524, 639, 655, 1036, 1104]","[639, 1036]","[138, 524, 655, 1104]","[639, 1036]",1601,6,1595,2,4,1595,0
4.0,GGAC01,"[22, 116, 273, 443, 634, 774, 833, 914, 970, 1057, 1119, 1343, 1586, 1666, 1903, 2226, 2261, 2585, 2602, 2782, 3189, 3276, 3330, 3495, 3561, 3677, 3831, 3857, 4055, 4309, 4499, 4695]","[1666, 2226, 3189, 3677]","[22, 116, 273, 443, 634, 774, 833, 914, 970, 1057, 1119, 1343, 1586, 1903, 2261, 2585, 2602, 2782, 3276, 3330, 3495, 3561, 3831, 3857, 4055, 4309, 4499, 4695]","[1666, 2226, 3189, 3677]",5038,32,5006,4,28,5006,0
4.0,GGACTAC,"[339, 351, 533, 970, 1554, 1815, 2127, 2277, 2752, 2914, 3032, 3218, 3948, 4216, 4398, 5278]","[970, 2127, 2914, 3218, 4398]","[339, 351, 533, 1554, 1815, 2277, 2752, 3032, 3948, 4216, 5278]","[970, 2127, 2914, 3218, 4398]",5455,16,5439,5,11,5439,0
4.0,GGACTI,"[153, 404, 525, 529, 788, 841, 929, 975, 1030, 1368, 1554, 1659, 1779, 1841]","[404, 841, 1554, 1841]","[153, 525, 529, 788, 929, 975, 1030, 1368, 1659, 1779]","[404, 841, 1137, 1554, 1841]",2418,14,2404,4,10,2403,1
4.0,GGCALB,"[386, 416, 421, 589, 596, 866, 944, 1016, 1292, 1863, 2289, 3467, 3509, 3617, 3629, 3793, 4235, 4414, 4894, 5205, 5262, 5524, 5867, 5933, 6149, 6321, 6694, 6784, 7035, 7824, 7865, 8249, 8718, 9052, 9685, 9916, 10030, 10195, 10530, 10551]","[386, 1863, 2289, 3467, 3793, 4235, 4894, 5205, 5933, 6784, 7035, 7824, 8718, 9052, 9685, 10195]","[416, 421, 589, 596, 866, 944, 1016, 1292, 3509, 3617, 3629, 4414, 5262, 5524, 5867, 6149, 6321, 6694, 7865, 8249, 9916, 10030, 10530, 10551]","[386, 1863, 2289, 3467, 3793, 4235, 4894, 5205, 5933, 6784, 7035, 7824, 8718, 9052, 9685, 10195]",11060,40,11020,16,24,11020,0
4.0,GGCRYD1,"[217, 267, 441, 910, 2077, 2539, 2742, 3516, 3944, 4297, 4332, 4528, 4907, 5234, 5498, 5899, 6003, 6138, 6395, 6734, 6829, 6835, 7213, 7373, 7435, 7529, 7779]","[441, 2742, 3516, 3944, 4332, 4528, 4907, 5234, 5899, 6138, 6395, 6734, 7213]","[217, 267, 910, 2077, 2539, 4297, 5498, 6003, 6829, 6835, 7373, 7435, 7529, 7779]","[441, 1734, 2742, 3150, 3516, 3944, 4332, 4528, 4907, 5234, 5899, 6138, 6395, 6734, 7213]",8152,27,8125,13,14,8123,2
4.0,GGGL03,"[432, 768, 1160]","[432, 768]",[1160],"[432, 768]",1199,3,1196,2,1,1196,0
4.0,GGGNRHIA,"[338, 1684, 1950, 2577, 2787, 2822, 2951, 3048, 3627, 4195, 4392, 4472, 4544, 5575, 5640, 5885]","[3627, 4392]","[338, 1684, 1950, 2577, 2787, 2822, 2951, 3048, 4195, 4472, 4544, 5575, 5640, 5885]","[3627, 4392]",6274,16,6258,2,14,6258,0
4.0,GGNFM1D,"[859, 874, 932, 1295, 1541, 2051, 2451, 3184, 3354, 3448, 3595, 4194, 4284, 4395, 4596, 4656, 4663, 4746, 4768, 4851, 5057]",[2451],"[859, 874, 932, 1295, 1541, 2051, 3184, 3354, 3448, 3595, 4194, 4284, 4395, 4596, 4656, 4663, 4746, 4768, 4851, 5057]","[2132, 2451]",5630,21,5609,1,20,5608,1
4.0,GGPROP2,"[51, 564]",[],"[51, 564]",[307],640,2,638,0,2,637,1
4.0,GGRIHBGEN,"[202, 219, 254, 676, 961, 981, 990, 1038, 1973, 2450, 2863, 2982, 3219, 3317, 3394, 3454]","[2982, 3219, 3454]","[202, 219, 254, 676, 961, 981, 990, 1038, 1973, 2450, 2863, 3317, 3394]","[2982, 3219, 3454]",3878,16,3862,3,13,3862,0
4.0,GGVITIIG,"[54, 190, 442, 567, 830, 1596, 2561, 2694, 2948, 2952, 3064, 3138, 3145, 3267, 3791, 4295, 4818, 4876, 5129, 5441, 5848, 6011, 6062, 6229, 6408, 6443, 7045, 7123, 7740, 8026, 8302, 8481, 9149, 9439, 9467, 10448, 10618, 10703, 10714, 10930, 10951, 10971, 11663, 11667, 12272, 12547, 12750, 12791, 13267, 13505, 13819, 14077, 14139, 14252, 14413, 14589, 14704, 15348, 15710, 15771, 15880, 16552, 16955, 17019, 17193, 17299, 17447, 17481, 17492, 17815, 17864, 17913, 18132, 18829, 18882, 19081, 19128, 19337, 19348, 19513, 19933, 20096, 20126]","[54, 190, 442, 2694, 2948, 3267, 3791, 4818, 5441, 6229, 6443, 7045, 8026, 8302, 9149, 9467, 10448, 10714, 12272, 13267, 13505, 14704, 15348, 15771, 16955, 17864, 19081]","[567, 830, 1596, 2561, 2952, 3064, 3138, 3145, 4295, 4876, 5129, 5848, 6011, 6062, 6408, 7123, 7740, 8481, 9439, 10618, 10703, 10930, 10951, 10971, 11663, 11667, 12547, 12750, 12791, 13819, 14077, 14139, 14252, 14413, 14589, 15710, 15880, 16552, 17019, 17193, 17299, 17447, 17481, 17492, 17815, 17913, 18132, 18829, 18882, 19128, 19337, 19348, 19513, 19933, 20096, 20126]","[54, 190, 442, 2021, 2694, 2948, 3267, 3543, 3791, 4818, 5441, 6229, 6443, 7045, 7268, 8026, 8302, 9149, 9467, 10104, 10448, 10714, 11757, 12272, 12615, 13267, 13505, 14028, 14704, 15348, 15771, 16955, 17864, 19081]",20335,83,20252,27,56,20245,7
4.0,GIBPROTP1A,"[56, 160, 260]",[160],"[56, 260]",[160],393,3,390,1,2,390,0
4.0,GORAFPA,"[75, 999, 1860, 1939, 2268, 2395, 2784, 2871, 2955, 3434, 3684, 4151, 4192, 4363, 4369, 4564, 4744, 5457, 5550, 5602, 6121, 6760, 6976, 7046, 7156, 7445, 7766, 7795, 8836, 9548, 10041, 10422, 10727, 10903, 11145, 11629, 11823, 12575, 13421, 14087, 14183, 14424, 14707, 15952, 16581, 17195, 17207, 17834, 19231, 20297, 20427, 20474, 20718, 21186, 21207, 22550, 23096, 23229, 23233, 23613, 23937]","[999, 1860, 2955, 5457, 6760, 7766, 11629, 13421, 14087, 14707, 16581, 17834]","[75, 1939, 2268, 2395, 2784, 2871, 3434, 3684, 4151, 4192, 4363, 4369, 4564, 4744, 5550, 5602, 6121, 6976, 7046, 7156, 7445, 7795, 8836, 9548, 10041, 10422, 10727, 10903, 11145, 11823, 12575, 14183, 14424, 15952, 17195, 17207, 19231, 20297, 20427, 20474, 20718, 21186, 21207, 22550, 23096, 23229, 23233, 23613, 23937]","[999, 1860, 2955, 5457, 6760, 7766, 9445, 11629, 13421, 14087, 14707, 16581, 17834]",24599,61,24538,12,49,24537,1
4.0,GORPROTP1A,"[60, 164]",[164],[60],[164],404,2,402,1,1,402,0
4.0,GPIINS,"[203, 526]",[526],[203],[526],1464,2,1462,1,1,1462,0
4.0,HAMAMYLP,"[48, 1394, 1473, 1549, 1794, 2308, 3934, 4561, 5045, 5424]",[2308],"[48, 1394, 1473, 1549, 1794, 3934, 4561, 5045, 5424]",[2308],5947,10,5937,1,9,5937,0
4.0,HAMHG5,"[615, 640, 781, 1333, 1373, 1385, 1640, 1817, 2464, 2817, 3433, 3461, 3620, 4662, 4856, 5439, 5517, 5603, 6188, 6597, 7156, 7240, 7441, 7668, 7956, 8108, 8258, 8295, 8396, 9231]","[4856, 5517, 6188, 6597, 7441]","[615, 640, 781, 1333, 1373, 1385, 1640, 1817, 2464, 2817, 3433, 3461, 3620, 4662, 5439, 5603, 7156, 7240, 7668, 7956, 8108, 8258, 8295, 8396, 9231]","[4856, 5517, 6188, 6597, 7441]",9711,30,9681,5,25,9681,0
4.0,HROAMD1,"[237, 289, 1072, 1585, 2687, 3486, 3494, 3830, 4700, 4816, 5311, 5962, 6863, 6983]","[2687, 3486, 4700]","[237, 289, 1072, 1585, 3494, 3830, 4816, 5311, 5962, 6863, 6983]","[2687, 3486, 4700]",7091,14,7077,3,11,7077,0
4.0,HROMA2,"[292, 358, 427, 686, 739, 1174, 1285, 1351]","[739, 1174]","[292, 358, 427, 686, 1285, 1351]","[739, 1174]",1779,8,1771,2,6,1771,0
4.0,HROMA4A,"[661, 727, 1055, 1108, 1670, 1774, 1840, 2287]","[1108, 1670]","[661, 727, 1055, 1774, 1840, 2287]","[1108, 1670]",2331,8,2323,2,6,2323,0
4.0,HRSPRMI,"[247, 416, 722, 1245, 1605, 1880, 2047]",[722],"[247, 416, 1245, 1605, 1880, 2047]",[722],2198,7,2191,1,6,2191,0
4.0,HS1D3HLH,"[173, 757, 1039, 1231, 1634, 1750, 2146]",[1039],"[173, 757, 1231, 1634, 1750, 2146]",[1039],2473,7,2466,1,6,2466,0
4.0,HS2OXOC,"[116, 1162, 1421, 1451, 1694, 1719, 1825, 1894, 2227]","[116, 1162, 1421, 1694, 1825]","[1451, 1719, 1894, 2227]","[116, 871, 1162, 1421, 1694, 1825]",2510,9,2501,5,4,2500,1
4.0,HSABLGR1,"[371, 749, 860, 902, 1236, 1670, 1981, 2265, 2923, 2977, 3130, 3140, 3344, 3683, 4148, 4166, 4321, 4479, 4506, 4865, 5108, 5284, 5312, 5465, 5666, 5890, 6125, 6508, 6567, 6743, 6820, 6977, 7049, 7197, 8039, 8356, 8470, 8720, 9075, 9294, 9340, 9507, 10016, 10073, 10400, 10413, 10509, 10535, 10623, 10950, 11090, 11118, 11135, 11167, 11354, 11597, 11929, 11951, 11988, 11992, 12007, 12239, 12325, 12434, 12880, 12948, 13058, 13262, 13875, 14754, 15060, 15400, 15442, 15514, 15741, 16572, 17116, 17249, 17547, 17991, 18028, 18211, 19026, 19158, 19199, 19244, 19282, 19672, 19906, 19972, 20015, 20105, 20121, 20282, 20665, 20991, 21219, 21558, 23084, 23126, 23330, 23472, 23507, 23730, 23851, 23938, 23981, 24042, 24066, 24277, 24298, 24805, 24896, 24979, 25292, 25849, 25902, 25906, 26127, 26288, 26300, 26508, 26789, 27114, 27158, 29268, 29760, 30552, 31027, 31138, 31699, 32126, 32233, 32399, 32910, 33591, 33629, 33787, 33826, 34153, 34563, 35331, 35464, 35562, 35751, 35835]","[8720, 10400, 12434, 15741, 17116, 17991]","[371, 749, 860, 902, 1236, 1670, 1981, 2265, 2923, 2977, 3130, 3140, 3344, 3683, 4148, 4166, 4321, 4479, 4506, 4865, 5108, 5284, 5312, 5465, 5666, 5890, 6125, 6508, 6567, 6743, 6820, 6977, 7049, 7197, 8039, 8356, 8470, 9075, 9294, 9340, 9507, 10016, 10073, 10413, 10509, 10535, 10623, 10950, 11090, 11118, 11135, 11167, 11354, 11597, 11929, 11951, 11988, 11992, 12007, 12239, 12325, 12880, 12948, 13058, 13262, 13875, 14754, 15060, 15400, 15442, 15514, 16572, 17249, 17547, 18028, 18211, 19026, 19158, 19199, 19244, 19282, 19672, 19906, 19972, 20015, 20105, 20121, 20282, 20665, 20991, 21219, 21558, 23084, 23126, 23330, 23472, 23507, 23730, 23851, 23938, 23981, 24042, 24066, 24277, 24298, 24805, 24896, 24979, 25292, 25849, 25902, 25906, 26127, 26288, 26300, 26508, 26789, 27114, 27158, 29268, 29760, 30552, 31027, 31138, 31699, 32126, 32233, 32399, 32910, 33591, 33629, 33787, 33826, 34153, 34563, 35331, 35464, 35562, 35751, 35835]","[8720, 10400, 12434, 14200, 15741, 17116, 17991]",35954,146,35808,6,140,35807,1
4.0,HSALDCG,"[88, 349, 555, 801, 1014, 1283, 2098, 2481, 2641, 2663, 3110, 3366, 3386, 3567, 3994, 4346, 4434]","[2641, 3110, 3366, 3567, 3994]","[88, 349, 555, 801, 1014, 1283, 2098, 2481, 2663, 3386, 4346, 4434]","[2641, 2939, 3110, 3366, 3567, 3994, 4326]",5190,17,5173,5,12,5171,2
4.0,HSAPC3A,"[110, 172, 226, 636, 919, 1178, 1246, 1829, 2140, 2325, 2515, 2778, 3212, 3409, 3492, 3863, 3874, 4086, 4222, 4585, 4618, 4662, 4679, 5823]","[919, 1178]","[110, 172, 226, 636, 1246, 1829, 2140, 2325, 2515, 2778, 3212, 3409, 3492, 3863, 3874, 4086, 4222, 4585, 4618, 4662, 4679, 5823]","[919, 1178]",6039,24,6015,2,22,6015,0
4.0,HSAPOA2B,"[232, 245, 338, 490, 698, 916, 1554]","[490, 916]","[232, 245, 338, 698, 1554]","[490, 916]",1747,7,1740,2,5,1740,0
4.0,HSAPOAIA,"[57, 317, 661, 1397, 1799, 1849, 2090]","[317, 661]","[57, 1397, 1799, 1849, 2090]","[317, 661]",2183,7,2176,2,5,2176,0
4.0,HSAPOAIT,"[120, 231, 491, 835, 1572, 1974, 2024, 2265]","[491, 835]","[120, 231, 1572, 1974, 2024, 2265]","[491, 835]",2377,8,2369,2,6,2369,0
4.0,HSAPOC2G,"[33, 231, 255, 606, 645, 946, 1276, 1494, 1553, 1572, 1971, 2021, 2191, 2346, 2358, 2479, 2714, 2943]",[2714],"[33, 231, 255, 606, 645, 946, 1276, 1494, 1553, 1572, 1971, 2021, 2191, 2346, 2358, 2479, 2943]","[2714, 3041]",3832,18,3814,1,17,3813,1
4.0,HSAQUPN2,"[431, 632, 917]","[431, 632]",[917],"[431, 632, 746]",987,3,984,2,1,983,1
4.0,HSARYLA,"[275, 459, 1091, 1238, 1571, 1815, 1906, 2141, 2252, 2470, 2528, 2666, 3040, 3432]","[1238, 1571, 1815, 2252, 2470]","[275, 459, 1091, 1906, 2141, 2528, 2666, 3040, 3432]","[848, 1238, 1571, 1815, 2252, 2470, 2823]",3629,14,3615,5,9,3613,2
4.0,HSAT3,"[160, 280, 327, 646, 655, 825, 2225, 2451, 2846, 3311, 4422, 4823, 4978, 5095, 5305, 5311, 5717, 6015, 6059, 6235, 6645, 6879, 6934, 7102, 7225, 7231, 8072, 8303, 8536, 8551, 8733, 9045, 9260, 9625, 9717, 10089, 10131, 10336, 10401, 10948, 11303, 11320, 11748, 12007, 12719, 13056, 13775]","[646, 3311, 6059, 7102, 8303, 10401]","[160, 280, 327, 655, 825, 2225, 2451, 2846, 4422, 4823, 4978, 5095, 5305, 5311, 5717, 6015, 6235, 6645, 6879, 6934, 7225, 7231, 8072, 8536, 8551, 8733, 9045, 9260, 9625, 9717, 10089, 10131, 10336, 10948, 11303, 11320, 11748, 12007, 12719, 13056, 13775]","[646, 3311, 6059, 7102, 8303, 10401]",14198,47,14151,6,41,14151,0
4.0,HSATPCP1,"[158, 496, 534, 831, 989, 1257, 1680, 1994, 2127, 2258, 2846, 3169, 4036, 4080, 4245, 4726, 4773, 4843, 4975, 5389, 5394, 5525, 5934, 6099, 6382, 6830, 6843, 6860, 6999, 7267, 7698, 7854, 7927, 8207, 8529, 8701, 8714, 9101]","[5389, 6382, 7267]","[158, 496, 534, 831, 989, 1257, 1680, 1994, 2127, 2258, 2846, 3169, 4036, 4080, 4245, 4726, 4773, 4843, 4975, 5394, 5525, 5934, 6099, 6830, 6843, 6860, 6999, 7698, 7854, 7927, 8207, 8529, 8701, 8714, 9101]","[5389, 6382, 7267]",9449,38,9411,3,35,9411,0
4.0,HSATPCP2,"[6, 107, 1210, 1546, 2402, 2996, 3624, 3721, 3890, 4013, 4738, 4743, 5367, 6152, 6504, 6916, 7005, 7310, 7490, 7768, 8252, 8414, 8957, 9194, 9627, 9637, 9689, 9752, 10099, 10195, 10918, 10966, 11516, 11602, 11686, 11693, 12001, 12497, 13012, 13435, 13888, 14022]","[7490, 10195, 10918]","[6, 107, 1210, 1546, 2402, 2996, 3624, 3721, 3890, 4013, 4738, 4743, 5367, 6152, 6504, 6916, 7005, 7310, 7768, 8252, 8414, 8957, 9194, 9627, 9637, 9689, 9752, 10099, 10966, 11516, 11602, 11686, 11693, 12001, 12497, 13012, 13435, 13888, 14022]","[7490, 10195, 10918]",15008,42,14966,3,39,14966,0
4.0,HSB3A,"[580, 1424, 1843, 1940, 2085, 2623, 2640, 2655, 2670, 3047, 3139, 3203, 3474]",[1843],"[580, 1424, 1940, 2085, 2623, 2640, 2655, 2670, 3047, 3139, 3203, 3474]",[1843],3675,13,3662,1,12,3662,0
4.0,HSBGPG,"[29, 151, 560, 817, 856, 1096, 1340, 1593, 1645]","[560, 1096]","[29, 151, 817, 856, 1340, 1593, 1645]","[560, 850, 1096]",1667,9,1658,2,7,1657,1
4.0,HSBSF2,"[238, 318, 477, 1242, 1587, 1621, 2450, 2748, 2930, 2956, 3022, 3106, 3336, 3601, 4086, 4317, 4427, 4505, 4715, 4895, 4943, 5688]","[1242, 1587, 2748, 3601]","[238, 318, 477, 1621, 2450, 2930, 2956, 3022, 3106, 3336, 4086, 4317, 4427, 4505, 4715, 4895, 4943, 5688]","[1242, 1587, 2748, 3601]",5953,22,5931,4,18,5931,0
4.0,HSCBMYHC,"[62, 278, 297, 345, 369, 649, 1577, 2258, 2583, 2735, 2858, 2868, 3016, 3193, 3218, 3592, 3819, 3932, 4595, 4612, 4776, 4921, 5041, 5485, 5644, 6160, 6529, 6694, 7246, 7567, 7609, 7735, 7912, 8095, 8354, 8647, 8867, 8898, 8933, 9024, 9174, 9885, 10554, 10877, 11339, 12155, 12229, 12303, 12427, 12635, 12825, 12829, 13037, 13342, 14042, 14210, 14394, 14571, 14806, 15416, 15683, 15784, 16410, 17120, 18138, 18228, 18590, 18734, 18777, 18896, 19262, 19970, 20057, 20132, 20604, 20964, 21466, 21505, 21839, 22088, 22369, 22423, 22474, 22643, 23209, 23454, 23701, 23830, 24751]","[4595, 5041, 5485, 5644, 6529, 6694, 7246, 7567, 8354, 8898, 9174, 10877, 11339, 12155, 12427, 12829, 13342, 14210, 14571, 17120, 18228, 18590, 18896, 19262, 19970, 20604, 21466, 21839, 22088, 22474, 23454, 23701]","[62, 278, 297, 345, 369, 649, 1577, 2258, 2583, 2735, 2858, 2868, 3016, 3193, 3218, 3592, 3819, 3932, 4612, 4776, 4921, 6160, 7609, 7735, 7912, 8095, 8647, 8867, 8933, 9024, 9885, 10554, 12229, 12303, 12635, 12825, 13037, 14042, 14394, 14806, 15416, 15683, 15784, 16410, 18138, 18734, 18777, 20057, 20132, 20964, 21505, 22369, 22423, 22643, 23209, 23830, 24751]","[4595, 5041, 5485, 5644, 6354, 6529, 6694, 7246, 7567, 8354, 8898, 9174, 9626, 10530, 10877, 11339, 12155, 12427, 12829, 13342, 14210, 14571, 15900, 17120, 18228, 18590, 18896, 19262, 19970, 20319, 20604, 21466, 21839, 22088, 22474, 23454, 23701]",24992,89,24903,32,57,24898,5
4.0,HSCD14G,"[159, 562, 763, 986, 1318]",[159],"[562, 763, 986, 1318]",[159],1562,5,1557,1,4,1557,0
4.0,HSCKBG,"[236, 876, 1075, 1341, 1619, 1733, 1824, 2068, 2124, 2380, 2570, 2638, 2643, 2877, 3022, 3434, 3521, 3534, 3620]","[1341, 1619, 1824, 2380, 3521]","[236, 876, 1075, 1733, 2068, 2124, 2570, 2638, 2643, 2877, 3022, 3434, 3534, 3620]","[1341, 1619, 1824, 2380, 3174, 3521]",4192,19,4173,5,14,4172,1
4.0,HSCOMT2,"[197, 589, 636, 911, 1075, 1959, 2212, 2350, 2378, 2547, 2897]","[1959, 2378]","[197, 589, 636, 911, 1075, 2212, 2350, 2547, 2897]","[1630, 1959, 2378]",3643,11,3632,2,9,3631,1
4.0,HSCPH70,"[205, 297, 633, 773, 829, 865, 1057, 2936, 3382, 3675, 3831, 3895, 4204, 4407, 4801, 5251, 6024]","[4204, 4407, 4801]","[205, 297, 633, 773, 829, 865, 1057, 2936, 3382, 3675, 3831, 3895, 5251, 6024]","[1729, 4204, 4407, 4801]",6703,17,6686,3,14,6685,1
4.0,HSCSF1PO,"[359, 496, 534, 678, 779, 1290, 1965, 2385, 2428, 2704, 2816, 3283, 3327, 3691, 3740, 3777, 3815, 4479, 4703, 4825, 5393, 5647, 6274, 6579, 6651, 6706, 7061, 7314, 7572, 7831, 7943, 8115, 8250, 8287, 8486, 8680, 8694, 8699, 8725, 8843, 8847, 8876, 8943, 9217, 9575, 9882, 10227, 10249, 10517, 11059, 11063, 11092, 11515, 11707, 11723, 12404, 12975, 13021, 13044, 13436, 13526, 13657, 13951, 14683, 14890, 15036, 15556, 15733, 16061, 16103, 17256, 17882, 17968, 18046, 18156, 18208, 18274, 18350, 18465, 18756, 19403, 19724, 20123, 21307, 21311, 21444, 23086, 23668, 24059, 24072, 24260, 24806, 25151, 25196, 25690, 25817, 26044, 26095, 26605, 26732, 26837, 26963, 27465, 27905, 29084, 29206, 29926, 30172, 30657, 30823, 30890, 31040, 31077, 31133, 31663, 31739, 31836, 31942, 32108, 32301, 32402, 32862, 33463, 33729, 33743, 33816, 34006, 34015, 34038, 34158, 34399]","[1965, 7572, 8287, 10227, 11063, 15036, 17882, 18156, 18465, 20123, 26605, 26837, 27465, 30823, 31040, 32108, 32301, 34006]","[359, 496, 534, 678, 779, 1290, 2385, 2428, 2704, 2816, 3283, 3327, 3691, 3740, 3777, 3815, 4479, 4703, 4825, 5393, 5647, 6274, 6579, 6651, 6706, 7061, 7314, 7831, 7943, 8115, 8250, 8486, 8680, 8694, 8699, 8725, 8843, 8847, 8876, 8943, 9217, 9575, 9882, 10249, 10517, 11059, 11092, 11515, 11707, 11723, 12404, 12975, 13021, 13044, 13436, 13526, 13657, 13951, 14683, 14890, 15556, 15733, 16061, 16103, 17256, 17968, 18046, 18208, 18274, 18350, 18756, 19403, 19724, 21307, 21311, 21444, 23086, 23668, 24059, 24072, 24260, 24806, 25151, 25196, 25690, 25817, 26044, 26095, 26732, 26963, 27905, 29084, 29206, 29926, 30172, 30657, 30890, 31077, 31133, 31663, 31739, 31836, 31942, 32402, 32862, 33463, 33729, 33743, 33816, 34015, 34038, 34158, 34399]","[1965, 7572, 8287, 10227, 11063, 15036, 17882, 18156, 18465, 20123, 26605, 26837, 27465, 28627, 30823, 31040, 32108, 32301, 33091, 34006]",35092,131,34961,18,113,34959,2
4.0,HSCST3G,"[271, 536, 888, 931, 1145, 1328, 1661, 2234, 2342, 3064, 3155, 3443, 3468, 3694, 3783, 3865, 3879, 3938, 4129, 4620, 4741, 5518, 5990, 6231, 6293, 6448, 6632, 6921, 7112]","[1328, 3694]","[271, 536, 888, 931, 1145, 1661, 2234, 2342, 3064, 3155, 3443, 3468, 3783, 3865, 3879, 3938, 4129, 4620, 4741, 5518, 5990, 6231, 6293, 6448, 6632, 6921, 7112]","[1328, 3694]",7284,29,7255,2,27,7255,0
4.0,HSCYCLA,"[1029, 1049, 1098, 1102, 1333, 1393, 1422, 2406, 2509, 2954, 3031, 3668, 3731, 4168, 4520, 5338, 5389, 5670, 5911, 6070, 6323, 6667, 6982, 7024, 7439, 7622, 7956, 7973, 8113]","[1393, 2406, 3731, 4168, 5338, 5911, 6667]","[1029, 1049, 1098, 1102, 1333, 1422, 2509, 2954, 3031, 3668, 4520, 5389, 5670, 6070, 6323, 6982, 7024, 7439, 7622, 7956, 7973, 8113]","[1393, 2406, 3731, 4168, 5338, 5911, 6667]",8355,29,8326,7,22,8326,0
4.0,HSCYP216,"[255, 302, 442, 665, 874, 879, 1278, 1466, 1475, 1836, 1888, 2215, 2402]","[255, 442, 879, 1278, 1466, 1836, 2215, 2402]","[302, 665, 874, 1475, 1888]","[255, 442, 879, 1088, 1278, 1466, 1836, 2215, 2402]",2763,13,2750,8,5,2749,1
4.0,HSCYP45C,"[185, 731, 947, 1256, 1688, 1772, 2048, 2667, 3358, 3538, 3975, 4603, 4680, 4942, 4963, 5008, 5624, 5801, 6016, 6248, 6525, 6562, 6694, 6935, 7081]","[4942, 5624, 5801, 6016, 6248]","[185, 731, 947, 1256, 1688, 1772, 2048, 2667, 3358, 3538, 3975, 4603, 4680, 4963, 5008, 6525, 6562, 6694, 6935, 7081]","[4942, 5624, 5801, 6016, 6248]",7546,25,7521,5,20,7521,0
4.0,HSCYTOK17,"[396, 452, 488, 581, 1709, 1951, 2079, 2304, 2928, 2935, 3066, 3131, 3171, 3245, 3257, 3468, 3601, 3693, 4000, 4123, 4987]","[581, 1709, 2304, 3066, 3693, 4000, 4123]","[396, 452, 488, 1951, 2079, 2928, 2935, 3131, 3171, 3245, 3257, 3468, 3601, 4987]","[581, 1709, 2304, 3066, 3693, 4000, 4123]",5252,21,5231,7,14,5231,0
4.0,HSCYTOK20,"[1277, 1871, 2287, 2601, 2644, 3128, 3978, 4019, 4075, 4732, 5152, 5205, 5281, 5352, 7290, 7458, 7512, 8061, 8722, 8760, 9313, 9470, 9642, 9984, 10005, 10271, 10714, 10828, 11206, 11940, 12458, 12705, 12783, 12902, 13941, 15297, 15989, 16190, 16343, 16498, 16620, 16791, 17174, 17254]","[5281, 7512, 9470, 9984, 10271, 11940, 12705]","[1277, 1871, 2287, 2601, 2644, 3128, 3978, 4019, 4075, 4732, 5152, 5205, 5352, 7290, 7458, 8061, 8722, 8760, 9313, 9642, 10005, 10714, 10828, 11206, 12458, 12783, 12902, 13941, 15297, 15989, 16190, 16343, 16498, 16620, 16791, 17174, 17254]","[5281, 7512, 9470, 9984, 10271, 11940, 12705]",18053,44,18009,7,37,18009,0
4.0,HSDAO,"[588, 956, 1035, 1080, 1177, 1329, 1381, 1437, 1635, 1665, 1751, 2351, 2551, 2877, 3236, 3885, 3987, 4584, 5121, 5561, 5744, 6200, 6426, 6696, 7384, 7431, 7766, 8028, 8329, 8502, 8880, 9013, 9343]","[6426, 7431, 9013]","[588, 956, 1035, 1080, 1177, 1329, 1381, 1437, 1635, 1665, 1751, 2351, 2551, 2877, 3236, 3885, 3987, 4584, 5121, 5561, 5744, 6200, 6696, 7384, 7766, 8028, 8329, 8502, 8880, 9343]","[6426, 7431, 9013]",9895,33,9862,3,30,9862,0
4.0,HSERPG,"[628, 1303, 1340, 1683, 1774, 1943, 2026, 2069, 2290, 2474, 2768]","[628, 1340, 1683, 2474]","[1303, 1774, 1943, 2026, 2069, 2290, 2768]","[628, 1340, 1683, 2474]",3390,11,3379,4,7,3379,0
4.0,HSFAU1,"[335, 505, 655, 824, 857, 1096, 1129, 1140, 1557, 1592, 1613, 1821]","[857, 1096, 1613]","[335, 505, 655, 824, 1129, 1140, 1557, 1592, 1821]","[857, 1096, 1613]",2008,12,1996,3,9,1996,0
4.0,HSFESFPS,"[8, 13, 543, 608, 728, 738, 872, 1227, 1248, 1553, 1650, 3180, 3336, 3645, 3726, 3769, 3797, 3873, 3923, 4008, 4522, 4547, 5028, 5154, 5405, 5598, 5924, 6108, 6240, 6445, 6767, 7089, 7150, 7230, 7330, 7634, 7757, 7836, 8020, 8052, 8069, 8349, 8546, 8720, 8782, 9151, 9176, 9294, 9371, 9424, 9768, 10015, 10445, 10483, 10626, 10664, 10965, 11511, 11788, 11865, 12034, 12062, 12225]","[1227, 1553, 3336, 5405, 5598, 5924, 6240, 6445, 7150, 7634, 8069, 8782, 9151, 9371, 9768, 10015]","[8, 13, 543, 608, 728, 738, 872, 1248, 1650, 3180, 3645, 3726, 3769, 3797, 3873, 3923, 4008, 4522, 4547, 5028, 5154, 6108, 6767, 7089, 7230, 7330, 7757, 7836, 8020, 8052, 8349, 8546, 8720, 9176, 9294, 9424, 10445, 10483, 10626, 10664, 10965, 11511, 11788, 11865, 12034, 12062, 12225]","[1227, 1553, 3023, 3336, 5405, 5598, 5924, 6240, 6445, 7150, 7634, 8069, 8782, 9151, 9371, 9768, 10015]",12255,63,12192,16,47,12191,1
4.0,HSGCSFG,"[264, 404, 690, 735, 744, 748, 774, 970, 1230, 1521, 2121, 2296]","[404, 744, 1230, 1521]","[264, 690, 735, 748, 774, 970, 2121, 2296]","[404, 744, 1230, 1521]",2952,12,2940,4,8,2940,0
4.0,HSGEBCMA,"[334, 607, 700, 888, 983, 1137, 1206, 1294, 1496, 1545, 1648, 2292, 2430, 2587, 3234, 3273, 3292, 3607]","[607, 1496]","[334, 700, 888, 983, 1137, 1206, 1294, 1545, 1648, 2292, 2430, 2587, 3234, 3273, 3292, 3607]","[607, 1496]",3711,18,3693,2,16,3693,0
4.0,HSGGL2,"[164, 202, 547, 1055, 1067]","[202, 547]","[164, 1055, 1067]","[202, 547]",1620,5,1615,2,3,1615,0
4.0,HSGLA,"[94, 852, 868, 885, 901, 937, 955, 1374, 1822, 2011, 2148, 2472, 2499, 3422, 4062, 4106, 4149, 4435, 5040, 5269, 5308, 6740, 6958, 6983, 7846, 8167, 8378, 8413, 9335, 10329, 10359, 10369, 10708, 11472, 11761, 12322]","[1374, 5269, 8413, 10708]","[94, 852, 868, 885, 901, 937, 955, 1822, 2011, 2148, 2472, 2499, 3422, 4062, 4106, 4149, 4435, 5040, 5308, 6740, 6958, 6983, 7846, 8167, 8378, 9335, 10329, 10359, 10369, 11472, 11761, 12322]","[1374, 5269, 7447, 8413, 10293, 10708]",12428,36,12392,4,32,12390,2
4.0,HSGROW2,"[92, 211, 345, 462, 1091]","[345, 1091]","[92, 211, 462]","[345, 762, 1091, 1349]",1956,5,1951,2,3,1949,2
4.0,HSGSTM4,"[37, 117, 391, 522, 874, 1262, 1357, 1458, 1793, 2098, 2142, 2232, 2469, 2670, 2960, 3366, 3511, 3516, 3623, 3953, 3984, 3991]","[37, 391, 874, 1262, 1458, 2469, 2670]","[117, 522, 1357, 1793, 2098, 2142, 2232, 2960, 3366, 3511, 3516, 3623, 3953, 3984, 3991]","[37, 391, 874, 1262, 1458, 2469, 2670]",4834,22,4812,7,15,4812,0
4.0,HSGTRH,"[442, 515, 1193, 1293, 1847, 2111, 2205, 2322, 2502, 2809, 2814, 3141, 3732, 3816, 5548, 5645, 5766, 5921, 6094, 6275, 6449, 6552]","[2205, 3816]","[442, 515, 1193, 1293, 1847, 2111, 2322, 2502, 2809, 2814, 3141, 3732, 5548, 5645, 5766, 5921, 6094, 6275, 6449, 6552]","[2205, 3816]",7216,22,7194,2,20,7194,0
4.0,HSHMG17G,"[283, 400, 651, 856, 1043, 1117, 1538, 1793, 2037, 2279, 2335, 2524, 2927, 2946, 3403, 3415, 3620, 4021, 4342, 4469, 4815, 4833, 4854, 5920, 7087, 7188]","[2524, 3415, 3620, 4021]","[283, 400, 651, 856, 1043, 1117, 1538, 1793, 2037, 2279, 2335, 2927, 2946, 3403, 4342, 4469, 4815, 4833, 4854, 5920, 7087, 7188]","[2524, 3415, 3620, 4021, 4553]",7187,26,7161,4,22,7160,1
4.0,HSHNRNPA,"[49, 220, 707, 814, 868, 1086, 1159, 1494, 1789, 1936, 2295, 2481, 2511, 2660, 2869, 2988, 3229, 3559, 3602, 3773, 3962, 4312]","[814, 1494, 1936, 2295, 2481, 2660, 2869, 3962]","[49, 220, 707, 868, 1086, 1159, 1789, 2511, 2988, 3229, 3559, 3602, 3773, 4312]","[814, 1494, 1936, 2295, 2481, 2660, 2869, 3962]",5360,22,5338,8,14,5338,0
4.0,HSHOX51,"[760, 1278, 1425, 1651, 1791, 2052, 2126, 2201, 2393, 2415, 2519, 2611, 2690, 3022, 3601, 4023, 4748, 6206]",[2052],"[760, 1278, 1425, 1651, 1791, 2126, 2201, 2393, 2415, 2519, 2611, 2690, 3022, 3601, 4023, 4748, 6206]",[2052],6297,18,6279,1,17,6279,0
4.0,HSHSC70,"[27, 41, 54, 305, 777, 913, 1194, 1245, 1313, 1773, 1778, 2052, 2250, 2550, 2893, 2938, 3307, 3734, 3841, 4114, 4735, 4819, 4910, 5378]","[1245, 1773, 2250, 2893, 3307, 3734, 4114]","[27, 41, 54, 305, 777, 913, 1194, 1313, 1778, 2052, 2550, 2938, 3841, 4735, 4819, 4910, 5378]","[1245, 1773, 2250, 2893, 3307, 3734, 4114]",5400,24,5376,7,17,5376,0
4.0,HSIFNAR,"[329, 365, 394, 429, 549, 583, 616, 631, 830, 869, 1356, 1404, 1420, 1540, 1597, 2165, 2445, 2612, 2684, 2696, 3337, 4481, 4612, 5386, 5843, 7631, 7976, 8112, 8182, 8569, 8594, 9219, 10270, 10423, 10677, 10800, 11127, 11325, 11655, 12704, 12838, 13828, 13884, 14172, 14247, 14793, 14937, 15464, 15482, 15686, 16062, 16909, 16944, 17681, 17725, 17942, 18117, 18564, 19188, 19220, 19442, 19858, 19910, 20036, 20088, 20346, 20795, 20837, 21132, 21239, 21243, 21261, 22130, 22538, 22586, 22719, 23043, 23136, 23180, 23783, 24341, 24515, 24742, 25061, 25314, 25630, 25777, 26285, 26897, 27236, 27744, 27840, 27880, 28142, 28272, 28315, 28489, 28657, 28679, 29018, 29168, 29554, 29885, 30053, 30214, 30400, 30452, 30489, 30881, 30998, 31727, 31769, 31918, 32103]","[830, 11325, 16944, 19188, 19442, 21132, 25061, 25314, 28679, 29554]","[329, 365, 394, 429, 549, 583, 616, 631, 869, 1356, 1404, 1420, 1540, 1597, 2165, 2445, 2612, 2684, 2696, 3337, 4481, 4612, 5386, 5843, 7631, 7976, 8112, 8182, 8569, 8594, 9219, 10270, 10423, 10677, 10800, 11127, 11655, 12704, 12838, 13828, 13884, 14172, 14247, 14793, 14937, 15464, 15482, 15686, 16062, 16909, 17681, 17725, 17942, 18117, 18564, 19220, 19858, 19910, 20036, 20088, 20346, 20795, 20837, 21239, 21243, 21261, 22130, 22538, 22586, 22719, 23043, 23136, 23180, 23783, 24341, 24515, 24742, 25630, 25777, 26285, 26897, 27236, 27744, 27840, 27880, 28142, 28272, 28315, 28489, 28657, 29018, 29168, 29885, 30053, 30214, 30400, 30452, 30489, 30881, 30998, 31727, 31769, 31918, 32103]","[830, 11325, 16944, 19188, 19442, 21132, 25061, 25314, 28679, 29554]",32898,114,32784,10,104,32784,0
4.0,HSIFNG,"[136, 589, 976, 1897, 2175, 2347, 2364, 2413, 2442, 2446, 3213, 3631, 3690, 3742, 3833, 4115, 4278, 4482, 5167, 5305, 5853]","[589, 1897, 2175]","[136, 976, 2347, 2364, 2413, 2442, 2446, 3213, 3631, 3690, 3742, 3833, 4115, 4278, 4482, 5167, 5305, 5853]","[589, 1897, 2175]",5953,21,5932,3,18,5932,0
4.0,HSIL1AG,"[826, 916, 1489, 1617, 1987, 2208, 2641, 2949, 3215, 3631, 3939, 4118, 4326, 4847, 5019, 5155, 5343, 5580, 6433, 7173, 7384, 7604, 7940, 8025, 8132, 8526, 9174, 9436, 9875, 10013, 11229]","[2208, 3215, 4326, 6433, 7940]","[826, 916, 1489, 1617, 1987, 2641, 2949, 3631, 3939, 4118, 4847, 5019, 5155, 5343, 5580, 7173, 7384, 7604, 8025, 8132, 8526, 9174, 9436, 9875, 10013, 11229]","[2208, 3215, 4326, 6433, 7940]",11962,31,11931,5,26,11931,0
4.0,HSIL1B,"[735, 1352, 1515, 1565, 2240, 2528, 3144, 3269, 4554, 5657, 6039, 7406, 8995, 9010, 9336, 9353, 9692]","[2528, 3144, 6039, 7406]","[735, 1352, 1515, 1565, 2240, 3269, 4554, 5657, 8995, 9010, 9336, 9353, 9692]","[2528, 3144, 5327, 6039, 7406]",9703,17,9686,4,13,9685,1
4.0,HSINT2,"[439, 516, 1156, 1285, 2267, 2792, 3197, 3471, 3509, 3549, 3567, 4140, 4327, 5335, 8668, 8973, 9331, 9443, 9480, 10216, 10232, 10273, 10458, 10533, 10644, 10708, 10736, 11562]","[1156, 3549]","[439, 516, 1285, 2267, 2792, 3197, 3471, 3509, 3567, 4140, 4327, 5335, 8668, 8973, 9331, 9443, 9480, 10216, 10232, 10273, 10458, 10533, 10644, 10708, 10736, 11562]","[1156, 3549]",11600,28,11572,2,26,11572,0
4.0,HSL7A,"[122, 420, 1288, 1408, 2073, 2576, 2646, 2867, 3525, 4052, 4164, 4259, 4564, 4572, 4919, 5073]","[2073, 2867, 3525, 4164, 4572, 4919]","[122, 420, 1288, 1408, 2576, 2646, 4052, 4259, 4564, 5073]","[2073, 2867, 3525, 3881, 4164, 4572, 4919]",5498,16,5482,6,10,5481,1
4.0,HSLCATG,"[361, 991, 1352, 1590, 1620, 1629, 1672, 1704, 1881, 2076, 2266, 2574, 2609, 3577, 3893, 4200, 4283, 4458, 5051, 5147, 5320, 5372, 5638, 5649, 5873, 6060, 6184, 6402, 6574, 6705, 6743]","[991, 1881, 2076, 2266, 2574]","[361, 1352, 1590, 1620, 1629, 1672, 1704, 2609, 3577, 3893, 4200, 4283, 4458, 5051, 5147, 5320, 5372, 5638, 5649, 5873, 6060, 6184, 6402, 6574, 6705, 6743]","[991, 1881, 2076, 2266, 2574]",6893,31,6862,5,26,6862,0
4.0,HSMECDAG,"[93, 230, 471, 716, 1153, 1393, 1456, 1805, 2149, 2517, 2584, 2588, 2593, 2597, 2601, 2616, 2776, 2870, 2966, 3072, 3162, 3170, 3202, 3245, 3353, 3544, 3673, 3852, 3939, 4095, 4361]","[1393, 2517, 2776, 2966, 3544, 3852]","[93, 230, 471, 716, 1153, 1456, 1805, 2149, 2584, 2588, 2593, 2597, 2601, 2616, 2870, 3072, 3162, 3170, 3202, 3245, 3353, 3673, 3939, 4095, 4361]","[1393, 2517, 2776, 2966, 3544, 3852]",4362,31,4331,6,25,4331,0
4.0,HSMED,"[36, 52, 277, 636, 789, 967, 1354, 1506, 1592, 1704, 1774, 1943, 1993, 1998, 2186, 2315, 3315, 4051, 4686, 4762, 4833, 5214]","[1354, 1943, 2315]","[36, 52, 277, 636, 789, 967, 1506, 1592, 1704, 1774, 1993, 1998, 2186, 3315, 4051, 4686, 4762, 4833, 5214]","[1354, 1943, 2315, 4716]",5284,22,5262,3,19,5261,1
4.0,HSMT1H,"[20, 196, 396, 442, 816, 1475, 2125]","[816, 1475]","[20, 196, 396, 442, 2125]","[816, 1475]",2134,7,2127,2,5,2127,0
4.0,HSNCAMX1,"[188, 280, 638, 1256, 1550, 1609, 1794, 2245, 2381, 2470, 2486, 2537, 2557, 2791, 2808, 2917, 2974, 4142, 4157, 4190, 4608, 4778, 6024, 6582, 6983, 7316, 7569, 7640, 7795, 7852, 8033, 8171, 8529, 8552, 8809, 9068, 9248, 9369, 9373, 9522, 9571, 10015, 10317, 10722, 11249, 11509, 11667, 11710, 11726, 11870, 12072, 12467, 12550, 12786, 12924, 13049, 13302, 13357, 13408, 13684, 13893, 14002, 14016]","[1609, 4142, 4778, 6582, 6983, 7316, 7569, 7852, 8529, 8809, 9068, 9373, 9571, 10015, 10317, 10722, 11667, 12072, 12550, 12786, 13049, 13893, 14002]","[188, 280, 638, 1256, 1550, 1794, 2245, 2381, 2470, 2486, 2537, 2557, 2791, 2808, 2917, 2974, 4157, 4190, 4608, 6024, 7640, 7795, 8033, 8171, 8552, 9248, 9369, 9522, 11249, 11509, 11710, 11726, 11870, 12467, 12924, 13302, 13357, 13408, 13684, 14016]","[1609, 4142, 4778, 5218, 6315, 6582, 6983, 7316, 7569, 7852, 8529, 8809, 9068, 9373, 9571, 10015, 10317, 10722, 11667, 12072, 12283, 12550, 12786, 13049, 13487, 13893, 14002]",16280,63,16217,23,40,16213,4
4.0,HSNFM,"[417, 432, 1188, 1252, 1741, 1822, 2243, 2675, 3371, 3772, 3849, 4101, 4491, 4575, 4896, 5057, 5148, 5343, 5388]","[1822, 2675]","[417, 432, 1188, 1252, 1741, 2243, 3371, 3772, 3849, 4101, 4491, 4575, 4896, 5057, 5148, 5343, 5388]","[1822, 2675]",6228,19,6209,2,17,6209,0
4.0,HSODCG,"[362, 735, 1002, 1361, 1938, 2612, 2912, 3007, 3411, 3454, 3745, 3968, 4192, 4433, 4445, 4649, 5028, 5421, 5633, 5815, 5893, 6211, 6298, 6336, 7111, 7208, 7306, 7614, 7881, 8052, 8090, 8214, 8758, 8842, 8854, 9013]","[4192, 4649, 5028, 5421, 5633, 5893, 7111, 7306, 7614]","[362, 735, 1002, 1361, 1938, 2612, 2912, 3007, 3411, 3454, 3745, 3968, 4433, 4445, 5815, 6211, 6298, 6336, 7208, 7881, 8052, 8090, 8214, 8758, 8842, 8854, 9013]","[4192, 4649, 5028, 5421, 5633, 5893, 7111, 7306, 7614]",9035,36,8999,9,27,8999,0
4.0,HSODF2,"[4, 97, 131, 158, 250, 269, 964, 993, 1375]",[],"[4, 97, 131, 158, 250, 269, 964, 993, 1375]",[600],1422,9,1413,0,9,1412,1
4.0,HSPAT133,"[393, 558, 654, 762, 794, 1126, 1173, 1447, 3711]",[1447],"[393, 558, 654, 762, 794, 1126, 1173, 3711]",[1447],3712,9,3703,1,8,3703,0
4.0,HSPLAPL,"[24, 403, 599, 808, 827, 1192, 1225]","[403, 599, 827]","[24, 808, 1192, 1225]","[403, 599, 827]",1274,7,1267,3,4,1267,0
4.0,HSPRB3L,"[279, 356, 386, 566, 789, 896, 1103, 1412, 1537, 2934, 3083, 3376, 4014]","[566, 1537]","[279, 356, 386, 789, 896, 1103, 1412, 2934, 3083, 3376, 4014]","[566, 1537]",4508,13,4495,2,11,4495,0
4.0,HSPRB4S,"[97, 411, 487, 518, 693, 741, 913, 1018, 1534, 1565, 1658, 2128, 2384, 2495, 2812, 2957, 3999]","[693, 1658]","[97, 411, 487, 518, 741, 913, 1018, 1534, 1565, 2128, 2384, 2495, 2812, 2957, 3999]","[693, 1658]",5805,17,5788,2,15,5788,0
4.0,HSPSAG,"[46, 447, 872, 1848, 2551, 2695, 2834, 3544, 3611, 3866, 3987, 4044, 4080, 4368, 4493, 5088, 5456]","[447, 1848, 4044]","[46, 872, 2551, 2695, 2834, 3544, 3611, 3866, 3987, 4080, 4368, 4493, 5088, 5456]","[447, 1848, 3764, 4044]",5865,17,5848,3,14,5847,1
4.0,HSRPII145,"[449, 588, 908, 1071, 1097, 1102, 1181, 1233, 1378, 1535, 1619, 1688, 1729]","[449, 588, 908, 1071, 1233]","[1097, 1102, 1181, 1378, 1535, 1619, 1688, 1729]","[449, 588, 908, 1071, 1233]",2085,13,2072,5,8,2072,0
4.0,HSRPS7,"[55, 115, 264, 284, 404, 415, 516, 1008, 1077, 1599, 1831, 2166, 2369, 2530, 2551, 3108, 3329, 3383, 3755, 4254, 4644, 4654, 5088, 5100, 5409, 5736, 5912, 6064, 6068, 6325, 6386, 6429, 6734, 6773]","[2166, 2369, 3108, 4254, 6734]","[55, 115, 264, 284, 404, 415, 516, 1008, 1077, 1599, 1831, 2530, 2551, 3329, 3383, 3755, 4644, 4654, 5088, 5100, 5409, 5736, 5912, 6064, 6068, 6325, 6386, 6429, 6773]","[2166, 2369, 3108, 4254, 6734]",7505,34,7471,5,29,7471,0
4.0,HSSAA1B,"[527, 862, 1009, 1151, 1543, 1831, 2345, 2367, 3845, 3876, 4007, 4013, 4267, 4403, 4571, 4697, 4712, 4744]","[1543, 3845]","[527, 862, 1009, 1151, 1831, 2345, 2367, 3876, 4007, 4013, 4267, 4403, 4571, 4697, 4712, 4744]","[1543, 3845]",4815,18,4797,2,16,4797,0
4.0,HSSHBG,"[472, 1016, 1058, 2388, 2575, 2615, 2672, 2759, 2810, 2867, 3148, 3440]","[472, 1058, 3148]","[1016, 2388, 2575, 2615, 2672, 2759, 2810, 2867, 3440]","[472, 696, 1058, 1551, 1938, 2205, 3148]",3802,12,3790,3,9,3786,4
4.0,HSSSPN1AG,"[418, 589, 1434, 1635, 1809, 2066, 2280, 2330, 2652, 3028, 3073, 3360, 3491, 3518, 4053]","[1635, 1809, 3360, 3491]","[418, 589, 1434, 2066, 2280, 2330, 2652, 3028, 3073, 3518, 4053]","[1343, 1635, 1809, 3360, 3491]",4088,15,4073,4,11,4072,1
4.0,HSSURF3,"[284, 743, 813, 1033, 1692, 2048, 2160, 2209, 2321, 2415, 2721, 2729, 3074, 3226]","[284, 1033, 1692, 2048, 2321, 2729, 3074]","[743, 813, 2160, 2209, 2415, 2721, 3226]","[284, 1033, 1692, 2048, 2321, 2729, 3074]",3407,14,3393,7,7,3393,0
4.0,HSTNFB,"[836, 980, 1375, 3015]",[1375],"[836, 980, 3015]","[1375, 1567]",3029,4,3025,1,3,3024,1
4.0,HSTPI1G,"[730, 746, 919, 972, 1558, 1616, 1685, 1817, 2035, 2176, 2231, 2438, 2493, 2821, 3181, 3249, 3760, 3846, 4330, 4376, 4651, 4845, 4849]","[746, 2035, 2231, 2438, 2821, 3181]","[730, 919, 972, 1558, 1616, 1685, 1817, 2176, 2493, 3249, 3760, 3846, 4330, 4376, 4651, 4845, 4849]","[746, 2035, 2231, 2438, 2821, 3181]",4987,23,4964,6,17,4964,0
4.0,HSTUBAG,"[96, 536, 1912, 2065, 2287, 2310, 2584, 3623, 3733, 3759, 3777, 3815, 3843]","[536, 2287, 2584]","[96, 1912, 2065, 2310, 3623, 3733, 3759, 3777, 3815, 3843]","[536, 2287, 2584]",4079,13,4066,3,10,4066,0
4.0,HSU01102,"[222, 275, 668, 817, 858, 1671, 1943, 2082, 2568, 3273, 4166, 4611, 4655]",[668],"[222, 275, 817, 858, 1671, 1943, 2082, 2568, 3273, 4166, 4611, 4655]","[668, 3896]",4987,13,4974,1,12,4973,1
4.0,HSU04357,"[97, 123, 1201, 1239, 1342, 1650, 1882, 1963]","[97, 1342]","[123, 1201, 1239, 1650, 1882, 1963]","[97, 1342]",2074,8,2066,2,6,2066,0
4.0,HSU04636,"[103, 852, 1018, 1449, 1935, 2199, 2262, 2996, 3426, 3608, 3849, 3965, 4424, 5359, 5719, 5723, 6008, 6340, 7357, 8301]","[1018, 1935, 2199, 2996, 3608, 4424, 5359, 6008]","[103, 852, 1449, 2262, 3426, 3849, 3965, 5719, 5723, 6340, 7357, 8301]","[1018, 1935, 2199, 2996, 3608, 4424, 4790, 5359, 6008]",9445,20,9425,8,12,9424,1
4.0,HSU05259,"[164, 499, 782, 814, 951, 1891, 2055, 2091, 2173, 2435, 2571, 2685, 2859, 3045, 3387, 3672, 3937, 4128, 5264]","[782, 2685, 3045, 4128]","[164, 499, 814, 951, 1891, 2055, 2091, 2173, 2435, 2571, 2859, 3387, 3672, 3937, 5264]","[782, 2685, 3045, 4128]",5662,19,5643,4,15,5643,0
4.0,HSU07807,"[454, 459, 609, 614, 757, 1040, 1362, 1983, 1991, 2047, 2481, 2568, 2736, 2873, 3386, 3446, 3664, 4350]","[757, 3386]","[454, 459, 609, 614, 1040, 1362, 1983, 1991, 2047, 2481, 2568, 2736, 2873, 3446, 3664, 4350]","[757, 3386]",4831,18,4813,2,16,4813,0
4.0,HSU07983,"[287, 354, 390, 1286]",[390],"[287, 354, 1286]",[390],1418,4,1414,1,3,1414,0
4.0,HSU08198,"[311, 676, 707, 895, 1072, 1124, 1316, 1392, 1601, 1684, 1689, 1811, 1845, 1892, 1900]","[895, 1124, 1316, 1689, 1811]","[311, 676, 707, 1072, 1392, 1601, 1684, 1845, 1892, 1900]","[583, 895, 1124, 1316, 1689, 1811]",2336,15,2321,5,10,2320,1
4.0,HSU12421,"[227, 311, 583, 1400, 1882, 1941, 2080, 2255, 2434, 2624, 3216, 3242, 3287, 3573, 3705, 3747, 3869]","[311, 2080]","[227, 583, 1400, 1882, 1941, 2255, 2434, 2624, 3216, 3242, 3287, 3573, 3705, 3747, 3869]","[311, 2080]",4250,17,4233,2,15,4233,0
4.0,HSUBR,"[374, 564, 957, 1589, 2316, 2324, 3005, 3124]","[1589, 2324]","[374, 564, 957, 2316, 3005, 3124]","[1589, 2324]",3287,8,3279,2,6,3279,0
4.0,HSXBXVIII,"[473, 644, 1059, 1189, 1193, 1199, 1213, 1671, 2137, 2578, 2596, 2723, 2781, 2897, 3019, 3026, 3061, 3074, 3123, 3248, 3333, 3339, 3371, 3859, 4456, 4586, 5362, 5486, 6115, 6193, 6240, 6599, 6733, 7675, 8302, 8850, 8934, 9475, 9552, 9633, 10043, 10077, 10107, 10136, 10425, 10687, 11253, 11405, 11714, 11843, 11856, 11870, 12085, 12311, 12693]","[11405, 11843, 12085]","[473, 644, 1059, 1189, 1193, 1199, 1213, 1671, 2137, 2578, 2596, 2723, 2781, 2897, 3019, 3026, 3061, 3074, 3123, 3248, 3333, 3339, 3371, 3859, 4456, 4586, 5362, 5486, 6115, 6193, 6240, 6599, 6733, 7675, 8302, 8850, 8934, 9475, 9552, 9633, 10043, 10077, 10107, 10136, 10425, 10687, 11253, 11714, 11856, 11870, 12311, 12693]","[11405, 11589, 11843, 12085]",12630,55,12575,3,52,12574,1
4.0,HSZNGP1,"[445, 518, 565, 1142, 2672, 3191, 3608, 4109, 4718, 4777, 5026, 5073, 5752, 5805, 5990, 6144, 6347, 6402, 6435, 7275, 7410, 8313, 8597, 8986, 8991, 9067, 9762]","[518, 4718, 8313]","[445, 565, 1142, 2672, 3191, 3608, 4109, 4777, 5026, 5073, 5752, 5805, 5990, 6144, 6347, 6402, 6435, 7275, 7410, 8597, 8986, 8991, 9067, 9762]","[518, 4718, 8313]",9815,27,9788,3,24,9788,0
4.0,HUMADAG,"[710, 1241, 1309, 1355, 1609, 1677, 2050, 2405, 2418, 2578, 2769, 2805, 3343, 3539, 3737, 4064, 4501, 4521, 4549, 4817, 4900, 5136, 5267, 5278, 5341, 5657, 5751, 5773, 5828, 6192, 7184, 7938, 7980, 8160, 8421, 9092, 9628, 9946, 10139, 10515, 11124, 11190, 11568, 11763, 12435, 12555, 13187, 13314, 13416, 13458, 13503, 14450, 14833, 15069, 15395, 15582, 15661, 15857, 15955, 16030, 17025, 17067, 17161, 17205, 17401, 17492, 17850, 18465, 19292, 19437, 19529, 19940, 20245, 20776, 21006, 21027, 21114, 22735, 22747, 23112, 23808, 24224, 24752, 25434, 25532, 26467, 27206, 27250, 28038, 28083, 28255, 28362, 28712, 28722, 28987, 28992, 29052, 29419, 29939, 30766, 30860, 31115, 31304, 31313, 31342, 31644, 31682, 32470, 32497, 32675, 32916, 33952, 33998, 34262, 34484, 34578, 34742, 35203, 36268, 36357]","[4064, 19292, 26467, 29052, 29939, 31304, 32497, 32675, 32916, 34484, 35203]","[710, 1241, 1309, 1355, 1609, 1677, 2050, 2405, 2418, 2578, 2769, 2805, 3343, 3539, 3737, 4501, 4521, 4549, 4817, 4900, 5136, 5267, 5278, 5341, 5657, 5751, 5773, 5828, 6192, 7184, 7938, 7980, 8160, 8421, 9092, 9628, 9946, 10139, 10515, 11124, 11190, 11568, 11763, 12435, 12555, 13187, 13314, 13416, 13458, 13503, 14450, 14833, 15069, 15395, 15582, 15661, 15857, 15955, 16030, 17025, 17067, 17161, 17205, 17401, 17492, 17850, 18465, 19437, 19529, 19940, 20245, 20776, 21006, 21027, 21114, 22735, 22747, 23112, 23808, 24224, 24752, 25434, 25532, 27206, 27250, 28038, 28083, 28255, 28362, 28712, 28722, 28987, 28992, 29419, 30766, 30860, 31115, 31313, 31342, 31644, 31682, 32470, 33952, 33998, 34262, 34578, 34742, 36268, 36357]","[4064, 19292, 26467, 29052, 29939, 31304, 32497, 32675, 32916, 34484, 35203]",36733,120,36613,11,109,36613,0
4.0,HUMADPRF02,"[90, 359, 514, 638, 1308, 1456, 1650, 2953, 2972, 3035, 3305, 3392, 3994, 4213, 4223, 4253, 4732, 4870, 5150]","[359, 1308, 1650]","[90, 514, 638, 1456, 2953, 2972, 3035, 3305, 3392, 3994, 4213, 4223, 4253, 4732, 4870, 5150]","[359, 1308, 1650]",5159,19,5140,3,16,5140,0
4.0,HUMAPEXN,"[137, 349, 1190, 1364, 1376, 1465, 1535, 1693, 1863, 2233, 2622, 2850]","[1465, 1863, 2622]","[137, 349, 1190, 1364, 1376, 1535, 1693, 2233, 2850]","[1465, 1863, 2622]",3722,12,3710,3,9,3710,0
4.0,HUMAPOCII,"[70, 184, 349, 547, 571, 891, 930, 1230, 1557, 1778, 1837, 1856, 2255, 2305, 2630, 2642, 2760, 2995, 3223]",[2995],"[70, 184, 349, 547, 571, 891, 930, 1230, 1557, 1778, 1837, 1856, 2255, 2305, 2630, 2642, 2760, 3223]","[2995, 3321]",4332,19,4313,1,18,4312,1
4.0,HUMAPOE4,"[617, 1064, 1091, 1225, 1294, 1324, 1506, 1575, 1773, 1914, 2365, 2409, 2611, 3156, 3200, 4001, 4032, 4292, 4313]","[1914, 3200]","[617, 1064, 1091, 1225, 1294, 1324, 1506, 1575, 1773, 2365, 2409, 2611, 3156, 4001, 4032, 4292, 4313]","[1914, 3200]",5507,19,5488,2,17,5488,0
4.0,HUMATPGG,"[156, 203, 213, 285, 831, 1445, 1762, 1902, 2553, 2677, 2891, 3180, 3691, 4114, 4293, 4578, 5307, 5627, 5882, 5953, 6118, 6191, 6534, 6749, 7456, 7488, 7885, 7908, 8198, 9299, 9436, 9672, 10001, 10190, 10354, 10406, 10478, 10770, 11018, 11405, 11435, 12074, 12415, 12987, 13458, 14100, 14110, 14276, 14537, 14755]","[1445, 1902, 2677, 4293, 5307, 6118, 6534, 6749, 7456, 8198, 9436, 9672, 10190, 11405, 12074, 14100, 14276]","[156, 203, 213, 285, 831, 1762, 2553, 2891, 3180, 3691, 4114, 4578, 5627, 5882, 5953, 6191, 7488, 7885, 7908, 9299, 10001, 10354, 10406, 10478, 10770, 11018, 11435, 12415, 12987, 13458, 14110, 14537, 14755]","[1445, 1727, 1902, 2677, 4293, 4749, 5307, 6118, 6534, 6749, 7456, 8198, 9436, 9672, 9946, 10190, 11405, 12074, 13663, 14100, 14276]",15107,50,15057,17,33,15053,4
4.0,HUMBETGLOA,"[52, 376, 601, 687, 920, 942, 958, 1176, 1311, 2016, 2475, 2559, 2931]","[958, 1311]","[52, 376, 601, 687, 920, 942, 1176, 2016, 2475, 2559, 2931]","[958, 1311]",2994,13,2981,2,11,2981,0
4.0,HUMBETGLOB,"[52, 374, 599, 685, 918, 940, 956, 1174, 1309, 2014, 2473, 2557, 2929]","[956, 1309]","[52, 374, 599, 685, 918, 940, 1174, 2014, 2473, 2557, 2929]","[956, 1309]",2992,13,2979,2,11,2979,0
4.0,HUMBETGLOC,"[52, 376, 601, 687, 920, 942, 958, 1176, 1311, 2016, 2475, 2559, 2931]","[958, 1311]","[52, 376, 601, 687, 920, 942, 1176, 2016, 2475, 2559, 2931]","[958, 1311]",2994,13,2981,2,11,2981,0
4.0,HUMBETGLOD,"[52, 376, 601, 687, 920, 942, 958, 1176, 1311, 2016, 2475, 2559, 2931]","[958, 1311]","[52, 376, 601, 687, 920, 942, 1176, 2016, 2475, 2559, 2931]","[958, 1311]",2994,13,2981,2,11,2981,0
4.0,HUMBETGLOE,"[52, 374, 599, 685, 918, 940, 956, 1174, 1309, 2014, 2473, 2557, 2929]","[956, 1309]","[52, 374, 599, 685, 918, 940, 1174, 2014, 2473, 2557, 2929]","[956, 1309]",2992,13,2979,2,11,2979,0
4.0,HUMBETGLOF,"[52, 376, 601, 687, 920, 942, 958, 1176, 1311, 2016, 2475, 2559, 2931]","[958, 1311]","[52, 376, 601, 687, 920, 942, 1176, 2016, 2475, 2559, 2931]","[958, 1311]",2994,13,2981,2,11,2981,0
4.0,HUMBETGLOG,"[52, 376, 601, 687, 920, 942, 958, 1176, 1311, 2016, 2475, 2559, 2931]","[958, 1311]","[52, 376, 601, 687, 920, 942, 1176, 2016, 2475, 2559, 2931]","[958, 1311]",2994,13,2981,2,11,2981,0
4.0,HUMBETGLOH,"[52, 376, 601, 687, 920, 942, 958, 1176, 1311, 2016, 2475, 2559, 2931]","[958, 1311]","[52, 376, 601, 687, 920, 942, 1176, 2016, 2475, 2559, 2931]","[958, 1311]",2994,13,2981,2,11,2981,0
4.0,HUMBETGLOI,"[52, 374, 599, 685, 918, 940, 956, 1174, 1309, 2014, 2473, 2557, 2929]","[956, 1309]","[52, 374, 599, 685, 918, 940, 1174, 2014, 2473, 2557, 2929]","[956, 1309]",2992,13,2979,2,11,2979,0
4.0,HUMBETGLOJ,"[52, 374, 599, 685, 918, 940, 956, 1174, 1309, 2014, 2473, 2557, 2929]","[956, 1309]","[52, 374, 599, 685, 918, 940, 1174, 2014, 2473, 2557, 2929]","[956, 1309]",2992,13,2979,2,11,2979,0
4.0,HUMBETGLOK,"[52, 374, 599, 685, 918, 940, 956, 1174, 1309, 2014, 2473, 2557, 2929]","[956, 1309]","[52, 374, 599, 685, 918, 940, 1174, 2014, 2473, 2557, 2929]","[956, 1309]",2992,13,2979,2,11,2979,0
4.0,HUMBETGLOL,"[52, 374, 599, 685, 918, 940, 956, 1174, 1309, 2014, 2473, 2557, 2929]","[956, 1309]","[52, 374, 599, 685, 918, 940, 1174, 2014, 2473, 2557, 2929]","[956, 1309]",2992,13,2979,2,11,2979,0
4.0,HUMBETGLOM,"[52, 373, 598, 684, 917, 939, 955, 1173, 1308, 2013, 2472, 2556, 2928]","[955, 1308]","[52, 373, 598, 684, 917, 939, 1173, 2013, 2472, 2556, 2928]","[955, 1308]",2991,13,2978,2,11,2978,0
4.0,HUMBETGLON,"[52, 374, 599, 685, 918, 940, 956, 1174, 1309, 2014, 2473, 2557, 2929]","[956, 1309]","[52, 374, 599, 685, 918, 940, 1174, 2014, 2473, 2557, 2929]","[956, 1309]",2992,13,2979,2,11,2979,0
4.0,HUMBETGLOO,"[52, 374, 599, 685, 918, 940, 956, 1174, 1309, 2014, 2473, 2557, 2929]","[956, 1309]","[52, 374, 599, 685, 918, 940, 1174, 2014, 2473, 2557, 2929]","[956, 1309]",2992,13,2979,2,11,2979,0
4.0,HUMBETGLOP,"[52, 374, 599, 685, 918, 940, 956, 1174, 1309, 2014, 2473, 2557, 2929]","[956, 1309]","[52, 374, 599, 685, 918, 940, 1174, 2014, 2473, 2557, 2929]","[956, 1309]",2992,13,2979,2,11,2979,0
4.0,HUMBETGLOR,"[52, 374, 599, 685, 918, 940, 956, 1174, 1309, 2014, 2473, 2557, 2929]","[956, 1309]","[52, 374, 599, 685, 918, 940, 1174, 2014, 2473, 2557, 2929]","[956, 1309]",2992,13,2979,2,11,2979,0
4.0,HUMCBRG,"[80, 167, 237, 567, 704, 1220, 2897, 2901, 3041]","[567, 1220]","[80, 167, 237, 704, 2897, 2901, 3041]","[567, 1220]",3318,9,3309,2,7,3309,0
4.0,HUMCHYMASE,"[510, 646, 969, 1185, 1277, 1379, 1826, 3165, 3406, 3982, 4038, 4104, 5216, 5644, 5779, 6037, 6922, 7220, 7255, 7363, 7455, 7463, 8006, 8052]","[5216, 6037, 6922, 7363]","[510, 646, 969, 1185, 1277, 1379, 1826, 3165, 3406, 3982, 4038, 4104, 5644, 5779, 7220, 7255, 7455, 7463, 8006, 8052]","[5216, 6037, 6922, 7363]",8107,24,8083,4,20,8083,0
4.0,HUMCP21OH,"[92, 185, 408, 435, 463, 505, 622, 644, 947, 994, 1134, 1357, 1566, 1571, 1970, 2158, 2167, 2528, 2580, 2907, 3094, 3659]","[947, 1134, 1571, 1970, 2158, 2528, 2907, 3094]","[92, 185, 408, 435, 463, 505, 622, 644, 994, 1357, 1566, 2167, 2580, 3659]","[947, 1134, 1571, 1780, 1970, 2158, 2528, 2907, 3094]",4034,22,4012,8,14,4011,1
4.0,HUMCP21OHC,"[92, 185, 408, 435, 506, 623, 645, 948, 995, 1135, 1358, 1567, 1572, 1971, 2159, 2529, 2581, 2908, 3096, 3661]","[948, 1135, 1572, 1971, 2159, 2529, 2908, 3096]","[92, 185, 408, 435, 506, 623, 645, 995, 1358, 1567, 2581, 3661]","[948, 1135, 1572, 1781, 1971, 2159, 2529, 2908, 3096]",4036,20,4016,8,12,4015,1
4.0,HUMCS1,"[85, 148, 310, 429, 565, 669, 991, 1334, 1591, 1679, 2210]","[565, 991, 1334, 1591]","[85, 148, 310, 429, 669, 1679, 2210]","[565, 991, 1334, 1591]",2293,11,2282,4,7,2282,0
4.0,HUMCS3,"[87, 150, 312, 431, 566, 671, 991, 1334, 1588, 2214, 2520]","[566, 991, 1334, 1588]","[87, 150, 312, 431, 671, 2214, 2520]","[566, 991, 1334, 1588]",2732,11,2721,4,7,2721,0
4.0,HUMCSN2A,"[122, 591, 1451, 1845, 2107, 2228, 3194, 3776, 4104, 4855, 5391, 5620, 5742, 5747, 6682, 6747, 6887, 7474, 7789, 8522, 8683, 8805, 9482]","[4855, 5747, 6747, 6887, 8522]","[122, 591, 1451, 1845, 2107, 2228, 3194, 3776, 4104, 5391, 5620, 5742, 6682, 7474, 7789, 8683, 8805, 9482]","[4855, 5747, 6747, 6887, 8522]",10600,23,10577,5,18,10577,0
4.0,HUMCSPA,"[455, 982, 2276, 2929, 3200, 3608, 3691]","[982, 2276, 2929]","[455, 3200, 3608, 3691]","[982, 2276, 2929, 3392]",4783,7,4776,3,4,4775,1
4.0,HUMCTLA1,"[988, 1812, 2119, 2179, 2297, 2336, 2360, 2770, 3041, 3122, 3236, 3532, 3695]","[988, 2179, 2770, 3236]","[1812, 2119, 2297, 2336, 2360, 3041, 3122, 3532, 3695]","[988, 2179, 2770, 3236]",4520,13,4507,4,9,4507,0
4.0,HUMDEF5A,"[296, 500, 923, 1387, 1571, 2323, 2601]",[1571],"[296, 500, 923, 1387, 2323, 2601]",[1571],2872,7,2865,1,6,2865,0
4.0,HUMDZA2G,"[24, 296, 631, 680, 727, 829, 1160, 1425, 1531, 1645, 1982, 2003, 2013, 2928, 3711, 3942, 4857, 5316, 5389, 5436, 6013, 7542, 8063, 8480, 8981, 9590, 9649, 9898, 9945, 10624, 10677, 10862, 11016, 11212, 11267, 11300, 12139, 12274, 13183, 13467, 13857, 13862, 13938, 14633]","[5389, 9590, 13183]","[24, 296, 631, 680, 727, 829, 1160, 1425, 1531, 1645, 1982, 2003, 2013, 2928, 3711, 3942, 4857, 5316, 5436, 6013, 7542, 8063, 8480, 8981, 9649, 9898, 9945, 10624, 10677, 10862, 11016, 11212, 11267, 11300, 12139, 12274, 13467, 13857, 13862, 13938, 14633]","[5389, 9590, 13183]",14686,44,14642,3,41,14642,0
4.0,HUMELAFIN,"[326, 338, 557, 802, 1089, 1351, 1456, 1461, 1517, 1534, 1559]",[326],"[338, 557, 802, 1089, 1351, 1456, 1461, 1517, 1534, 1559]",[326],1870,11,1859,1,10,1859,0
4.0,HUMEPOHYDD,"[504, 776, 1048, 1107, 1724, 1951, 2121, 2164, 2190, 2283, 2289, 2972, 3143, 3680, 4407, 5656, 5814, 5997, 6115, 6277, 6289, 6422, 6542, 6758, 7946, 8217, 8696, 8728, 9045, 9132, 9213, 9470, 10184, 10392, 10475, 10778, 10872, 11088, 11772, 11832, 12105, 12409, 12625, 12819, 12928, 13103, 13241, 13279, 13322, 13416, 13804, 13924, 14095, 14107, 14606, 15062, 15227, 15620, 15705, 15831, 16085, 16324, 16771, 16775, 17075, 17080, 17170, 17238, 17789, 17810, 17870, 18254, 18296, 18395, 18573, 18887, 18944, 19204, 19373, 19698, 19920, 20118, 20318, 20545, 20683, 20720, 20857, 20883, 20954, 20979, 20994, 21354, 21648, 21945, 22251, 22856, 22952, 23010, 23217, 23497, 24312, 24408, 24469]","[5656, 8696, 15620, 16085, 16775, 19204, 21354]","[504, 776, 1048, 1107, 1724, 1951, 2121, 2164, 2190, 2283, 2289, 2972, 3143, 3680, 4407, 5814, 5997, 6115, 6277, 6289, 6422, 6542, 6758, 7946, 8217, 8728, 9045, 9132, 9213, 9470, 10184, 10392, 10475, 10778, 10872, 11088, 11772, 11832, 12105, 12409, 12625, 12819, 12928, 13103, 13241, 13279, 13322, 13416, 13804, 13924, 14095, 14107, 14606, 15062, 15227, 15705, 15831, 16324, 16771, 17075, 17080, 17170, 17238, 17789, 17810, 17870, 18254, 18296, 18395, 18573, 18887, 18944, 19373, 19698, 19920, 20118, 20318, 20545, 20683, 20720, 20857, 20883, 20954, 20979, 20994, 21648, 21945, 22251, 22856, 22952, 23010, 23217, 23497, 24312, 24408, 24469]","[5656, 8696, 15620, 16085, 16775, 19204, 21354]",24782,103,24679,7,96,24679,0
4.0,HUMG0S24B,"[631, 658, 812, 1133, 1264]",[631],"[658, 812, 1133, 1264]",[631],3127,5,3122,1,4,3122,0
4.0,HUMG0S8PP,"[91, 401, 660, 784, 942, 1230, 1379, 2148, 2152, 2682, 3036, 3768, 3840, 3932, 4113, 4399, 4646, 5361, 5877]","[2682, 3768, 3932, 4646]","[91, 401, 660, 784, 942, 1230, 1379, 2148, 2152, 3036, 3840, 4113, 4399, 5361, 5877]","[2682, 3768, 3932, 4646]",7337,19,7318,4,15,7318,0
4.0,HUMGAD45A,"[392, 927, 1215, 1292, 1321, 1558, 1761, 2266, 2457, 2461, 2596, 2968, 3092, 3184, 3645, 3730, 3880, 4167, 4396, 4427, 4828, 4956, 5015]","[2596, 3184, 3645]","[392, 927, 1215, 1292, 1321, 1558, 1761, 2266, 2457, 2461, 2968, 3092, 3730, 3880, 4167, 4396, 4427, 4828, 4956, 5015]","[2596, 3184, 3645]",5370,23,5347,3,20,5347,0
4.0,HUMGARE,"[25, 71, 322, 590, 609, 633, 810, 964, 1467, 1872, 2239, 2243, 2411, 2455, 2653, 2861, 3118, 3133, 3207, 3213, 3259, 4469, 4718]","[810, 2239, 2653, 3118]","[25, 71, 322, 590, 609, 633, 964, 1467, 1872, 2243, 2411, 2455, 2861, 3133, 3207, 3213, 3259, 4469, 4718]","[810, 2239, 2653, 3118]",4746,23,4723,4,19,4723,0
4.0,HUMGCK,"[304, 634, 725, 1188, 1514, 1989, 2345, 2647, 3096, 3197, 3248, 3360, 3789, 3799, 3882, 4288, 4312, 4806, 5015, 5092, 5118, 5341, 5452, 5623, 5808, 5981, 6475, 6500, 6630, 6651, 6744, 6765, 6921, 6946]","[1188, 3360, 3882, 4312, 4806, 5015, 5452, 6475]","[304, 634, 725, 1514, 1989, 2345, 2647, 3096, 3197, 3248, 3789, 3799, 4288, 5092, 5118, 5341, 5623, 5808, 5981, 6500, 6630, 6651, 6744, 6765, 6921, 6946]","[1188, 3360, 3882, 4312, 4806, 5015, 5452, 5964, 6475]",7519,34,7485,8,26,7484,1
4.0,HUMGFP40H,"[910, 1058, 1140, 1173, 1731, 1748, 1846, 1943, 2593, 2752, 2781, 3126, 3261, 3426, 4025, 4290]","[910, 1058, 1173, 2593]","[1140, 1731, 1748, 1846, 1943, 2752, 2781, 3126, 3261, 3426, 4025, 4290]","[910, 1058, 1173, 2593]",4371,16,4355,4,12,4355,0
4.0,HUMGHG,"[40, 689, 1983, 2636, 2907, 3315, 3398]","[689, 1983, 2636]","[40, 2907, 3315, 3398]","[689, 1983, 2636, 3099]",4444,7,4437,3,4,4436,1
4.0,HUMGHN,"[85, 148, 313, 434, 569, 673, 1316, 1574, 2439, 2583]","[569, 1316, 1574]","[85, 148, 313, 434, 673, 2439, 2583]","[569, 989, 1316, 1574]",2649,10,2639,3,7,2638,1
4.0,HUMGHV,"[86, 149, 432, 566, 1328, 1351, 1584, 2443, 2485]","[566, 1328, 1584]","[86, 149, 432, 1351, 2443, 2485]","[566, 998, 1328, 1584]",2652,9,2643,3,6,2642,1
4.0,HUMGSTM4A,"[516, 777, 1139, 1272, 1631, 1844, 2024, 2098, 2124, 2225, 2573, 2880, 2925, 3023, 3262, 3463, 3753, 4160, 4306, 4311, 4425, 4760, 4791, 4798, 4913, 5623]","[777, 1139, 1631, 2024, 2225, 3262, 3463]","[516, 1272, 1844, 2098, 2124, 2573, 2880, 2925, 3023, 3753, 4160, 4306, 4311, 4425, 4760, 4791, 4798, 4913, 5623]","[777, 1139, 1631, 2024, 2225, 3262, 3463]",6074,26,6048,7,19,6048,0
4.0,HUMHMGIY,"[310, 720, 1075, 1337, 1472, 1557, 2136, 2388, 2558, 2578, 3280, 3749, 3875, 3983, 4410, 4529, 4627, 4648, 4660, 4773, 5150, 5496, 5619, 5722, 6274, 6422, 6544, 6687, 6776, 7016, 7102, 7133, 7166, 7270, 7420, 7449, 7781, 7962, 8043, 8361, 9134, 9286, 9390, 9424, 9791, 9823, 10022]","[4660, 6544, 7270]","[310, 720, 1075, 1337, 1472, 1557, 2136, 2388, 2558, 2578, 3280, 3749, 3875, 3983, 4410, 4529, 4627, 4648, 4773, 5150, 5496, 5619, 5722, 6274, 6422, 6687, 6776, 7016, 7102, 7133, 7166, 7420, 7449, 7781, 7962, 8043, 8361, 9134, 9286, 9390, 9424, 9791, 9823, 10022]","[4660, 6544, 7270]",10098,47,10051,3,44,10051,0
4.0,HUMHOX13G,"[336, 380, 503, 811, 1451, 1653, 2083, 2405, 2502, 2576, 2652, 2796]",[811],"[336, 380, 503, 1451, 1653, 2083, 2405, 2502, 2576, 2652, 2796]",[811],3062,12,3050,1,11,3050,0
4.0,HUMHPARS1,"[20, 338, 779, 967, 1046, 1300, 1961, 2005, 2105, 2362, 2632, 3020, 3096, 3337, 3496, 3855, 4744, 4820, 5061, 5220, 5577, 6373, 6499, 6948, 7164, 7217, 7231, 7510, 7569, 7692, 7696, 7752, 8703, 8728, 8994, 9085, 9344, 9570, 9649, 9904, 10183, 10406, 10563, 10607, 10668, 11363, 11385]","[1046, 2632, 3020, 3855, 4744, 5577]","[20, 338, 779, 967, 1300, 1961, 2005, 2105, 2362, 3096, 3337, 3496, 4820, 5061, 5220, 6373, 6499, 6948, 7164, 7217, 7231, 7510, 7569, 7692, 7696, 7752, 8703, 8728, 8994, 9085, 9344, 9570, 9649, 9904, 10183, 10406, 10563, 10607, 10668, 11363, 11385]","[1046, 2632, 3020, 3855, 4744, 5577]",11543,47,11496,6,41,11496,0
4.0,HUMIBP3,"[1260, 1284, 1409, 1556, 1685, 1701, 2441, 2457, 2584, 2715, 2845, 2935, 3142, 3149, 3356, 3635, 3924, 3984, 4247, 4262, 4304, 4358, 4406, 4924, 5122, 5197, 5735, 6375, 6425, 6617, 7184, 7377, 7842, 8353, 8677, 8756, 9118]","[2441, 6617]","[1260, 1284, 1409, 1556, 1685, 1701, 2457, 2584, 2715, 2845, 2935, 3142, 3149, 3356, 3635, 3924, 3984, 4247, 4262, 4304, 4358, 4406, 4924, 5122, 5197, 5735, 6375, 6425, 7184, 7377, 7842, 8353, 8677, 8756, 9118]","[2441, 5953, 6617]",10876,37,10839,2,35,10838,1
4.0,HUMIDS,"[372, 636, 1160, 1972, 2038, 2248, 2376, 3243, 3731, 4119, 4174, 4684, 4778, 4865, 5244, 5385, 5446, 5850, 5864, 5876, 5927, 6071, 6178, 7368, 8086, 8266, 8364, 8721, 8796, 9161, 9282, 9391, 9526, 9847, 9965, 10120, 10170, 10734, 10877, 10987, 11136, 11158, 11397, 11928, 12302, 12329, 13103, 13969, 14418, 14645, 14655, 14702, 15210, 15596, 15803, 15879, 15901, 16084, 16844, 18130, 18552, 18689, 19301, 19599, 19747, 20044, 21250, 21311, 21624, 21795, 21930, 22369, 22536, 22809, 23494, 24724, 25810, 25819, 27097, 27785, 27983, 28773, 28973, 29070, 29300, 29338, 29400, 29441, 29555, 29710, 30034, 30410, 30535, 30554, 30602, 31004, 31147, 31515, 32027, 32099, 33900, 34107, 34645, 35761, 35777, 35958, 36682]","[1160, 2038, 5244, 8086, 9847, 15879]","[372, 636, 1972, 2248, 2376, 3243, 3731, 4119, 4174, 4684, 4778, 4865, 5385, 5446, 5850, 5864, 5876, 5927, 6071, 6178, 7368, 8266, 8364, 8721, 8796, 9161, 9282, 9391, 9526, 9965, 10120, 10170, 10734, 10877, 10987, 11136, 11158, 11397, 11928, 12302, 12329, 13103, 13969, 14418, 14645, 14655, 14702, 15210, 15596, 15803, 15901, 16084, 16844, 18130, 18552, 18689, 19301, 19599, 19747, 20044, 21250, 21311, 21624, 21795, 21930, 22369, 22536, 22809, 23494, 24724, 25810, 25819, 27097, 27785, 27983, 28773, 28973, 29070, 29300, 29338, 29400, 29441, 29555, 29710, 30034, 30410, 30535, 30554, 30602, 31004, 31147, 31515, 32027, 32099, 33900, 34107, 34645, 35761, 35777, 35958, 36682]","[1160, 2038, 2882, 5244, 8086, 9847, 15879, 19268]",36837,107,36730,6,101,36728,2
4.0,HUMIGERA,"[68, 1072, 1089, 1261, 1342, 1601, 1797, 2173, 2574, 3105, 3141, 3416, 3471, 4527, 4792, 5005, 5024, 5043, 5168, 5626, 5681, 5709, 6188, 6281, 6676, 7019, 7275]","[1342, 1797, 3105, 5168]","[68, 1072, 1089, 1261, 1601, 2173, 2574, 3141, 3416, 3471, 4527, 4792, 5005, 5024, 5043, 5626, 5681, 5709, 6188, 6281, 6676, 7019, 7275]","[1342, 1797, 3105, 5168]",7651,27,7624,4,23,7624,0
4.0,HUMIL2RGA,"[28, 231, 772, 817, 840, 1232, 1476, 1646, 1914, 1957, 1980, 2162, 2402, 2683, 2783, 2794, 2841, 3031, 3126, 3353, 4026]","[1476, 2402, 3031, 3353]","[28, 231, 772, 817, 840, 1232, 1646, 1914, 1957, 1980, 2162, 2683, 2783, 2794, 2841, 3126, 4026]","[203, 735, 1128, 1476, 2402, 3031, 3353]",4030,21,4009,4,17,4006,3
4.0,HUMIL4A,"[59, 67, 189, 290, 328, 491, 1306, 1626, 2072, 2810, 3234, 3254, 3380, 3469, 3877, 4037, 4460, 6557, 6702, 7003, 7433, 7514, 7915, 7981, 8041, 8135, 8362, 8391, 8407, 8461, 8466, 8512, 8605, 9292, 9400, 9501, 9622]","[1306, 1626, 7003]","[59, 67, 189, 290, 328, 491, 2072, 2810, 3234, 3254, 3380, 3469, 3877, 4037, 4460, 6557, 6702, 7433, 7514, 7915, 7981, 8041, 8135, 8362, 8391, 8407, 8461, 8466, 8512, 8605, 9292, 9400, 9501, 9622]","[1306, 1626, 7003]",9892,37,9855,3,34,9855,0
4.0,HUMIRBPG,"[786, 1516, 1819, 1823, 2428, 2776, 3181, 3221, 3550, 4554, 4606, 4612, 4672, 5069, 5157, 5340, 5556, 5568, 6592, 6975, 7160, 7261, 8440, 8766, 8885, 9262]","[3181, 5157, 7160]","[786, 1516, 1819, 1823, 2428, 2776, 3221, 3550, 4554, 4606, 4612, 4672, 5069, 5340, 5556, 5568, 6592, 6975, 7261, 8440, 8766, 8885, 9262]","[3181, 5157, 7160]",9703,26,9677,3,23,9677,0
4.0,HUMLHDC,"[166, 766, 791, 843, 1727, 1763, 2138, 3070, 3735, 3820, 4925, 5520, 6016, 6257, 6295, 6492, 7415, 7475, 7949, 8200, 8690, 8890, 8992, 9773, 9823, 10512, 10795, 11183, 11221, 11591, 11765, 11774, 12252, 12347, 12354, 13017, 13087, 14169, 14605, 15099, 15584, 15896, 16409, 16774, 17237, 17363, 18253, 18382, 18464, 18782, 18827, 18855, 19019, 19312, 19687, 19692, 19921, 19951, 20075, 20118, 20143, 20300, 20482, 21206, 21593, 21661, 21813, 21867, 22046, 22090, 22140, 22219, 22928, 23463, 24054, 24086, 24666, 24767, 25206, 25233, 25246, 25563, 26636, 27104, 27699, 28034, 28067, 28493, 28499, 28537, 28671, 28843, 29151, 29773, 30408, 30438, 30867, 31558, 31702, 31819, 31856, 32156, 32346]","[7415, 9773, 14605, 15584, 18382, 18782, 19312, 20300, 20482, 24666, 29773]","[166, 766, 791, 843, 1727, 1763, 2138, 3070, 3735, 3820, 4925, 5520, 6016, 6257, 6295, 6492, 7475, 7949, 8200, 8690, 8890, 8992, 9823, 10512, 10795, 11183, 11221, 11591, 11765, 11774, 12252, 12347, 12354, 13017, 13087, 14169, 15099, 15896, 16409, 16774, 17237, 17363, 18253, 18464, 18827, 18855, 19019, 19687, 19692, 19921, 19951, 20075, 20118, 20143, 21206, 21593, 21661, 21813, 21867, 22046, 22090, 22140, 22219, 22928, 23463, 24054, 24086, 24767, 25206, 25233, 25246, 25563, 26636, 27104, 27699, 28034, 28067, 28493, 28499, 28537, 28671, 28843, 29151, 30408, 30438, 30867, 31558, 31702, 31819, 31856, 32156, 32346]","[7415, 9773, 14605, 15584, 18382, 18782, 19312, 20300, 20482, 24666, 29773]",32343,103,32240,11,92,32240,0
4.0,HUMLUCT,"[108, 1550, 1877, 2369, 2505, 2861, 3004]","[1550, 2505, 2861]","[108, 1877, 2369, 3004]","[1550, 2505, 2861]",3288,7,3281,3,4,3281,0
4.0,HUMLYTOXBB,"[540, 1097, 1235, 1357, 1395, 2157, 2202, 2657, 2694, 2734, 2934, 3150, 3207, 3229, 3330, 3376, 3631, 4333, 4477, 4504, 4665, 4677, 4948, 5005, 5291, 5345, 5349, 5530, 6032]","[2934, 3376, 3631]","[540, 1097, 1235, 1357, 1395, 2157, 2202, 2657, 2694, 2734, 3150, 3207, 3229, 3330, 4333, 4477, 4504, 4665, 4677, 4948, 5005, 5291, 5345, 5349, 5530, 6032]","[2934, 3376, 3631]",6297,29,6268,3,26,6268,0
4.0,HUMMCHEMP,"[159, 674, 790, 812, 984, 1077, 1590]","[674, 1590]","[159, 790, 812, 984, 1077]","[674, 1590]",2756,7,2749,2,5,2749,0
4.0,HUMMET2,"[615, 866, 1128, 1167, 1233]","[866, 1233]","[615, 1128, 1167]","[866, 1233]",1695,5,1690,2,3,1690,0
4.0,HUMMGPA,"[4, 845, 1050, 1288, 1299, 2295, 2484, 2515, 3137, 3516, 3748, 4493, 5401, 6334, 7349, 7617]","[3516, 6334]","[4, 845, 1050, 1288, 1299, 2295, 2484, 2515, 3137, 3748, 4493, 5401, 7349, 7617]","[3516, 5093, 6334]",7726,16,7710,2,14,7709,1
4.0,HUMMIF,"[700, 753, 912, 1129, 1643]",[1643],"[700, 753, 912, 1129]","[1281, 1643]",2159,5,2154,1,4,2153,1
4.0,HUMMIS,"[623, 669, 778, 1358, 1489, 1639, 1887]","[623, 1358, 1639, 1887]","[669, 778, 1489]","[623, 1358, 1639, 1887]",3092,7,3085,4,3,3085,0
4.0,HUMMKXX,"[870, 1040, 1168, 1264, 1290, 1415, 1574, 1737, 1887, 2019, 2078, 2202, 2463, 2985, 3142, 3172, 3194]","[1415, 1737, 2019]","[870, 1040, 1168, 1264, 1290, 1574, 1887, 2078, 2202, 2463, 2985, 3142, 3172, 3194]","[1415, 1737, 2019]",3300,17,3283,3,14,3283,0
4.0,HUMNKG5PRO,"[214, 298, 345, 843, 964, 1055, 1505, 1644, 1865, 2262, 2639, 2715, 2788, 2915, 2978, 3215, 3283, 3314, 3387, 3580, 3848, 3912, 3982, 4048, 4473, 5323, 5435, 5468, 5480, 6599]","[2262, 3215, 3848, 5468]","[214, 298, 345, 843, 964, 1055, 1505, 1644, 1865, 2639, 2715, 2788, 2915, 2978, 3283, 3314, 3387, 3580, 3912, 3982, 4048, 4473, 5323, 5435, 5480, 6599]","[2262, 3215, 3848, 5468]",6738,30,6708,4,26,6708,0
4.0,HUMNTRI,"[10, 575, 1247, 1483, 1629, 2145, 2342, 2412, 2615, 2802, 3141, 3151]",[2802],"[10, 575, 1247, 1483, 1629, 2145, 2342, 2412, 2615, 3141, 3151]",[2802],3702,12,3690,1,11,3690,0
4.0,HUMNTRIII,"[10, 575, 1247, 1483, 1629, 2145, 2342, 2412, 2615, 2802, 3141, 3151]",[2802],"[10, 575, 1247, 1483, 1629, 2145, 2342, 2412, 2615, 3141, 3151]",[2802],3702,12,3690,1,11,3690,0
4.0,HUMOSTP,"[214, 970, 1581, 2162, 2358, 3054, 3385, 3509, 3657, 3909, 4738, 6004, 6322, 6327, 6420, 6480, 6986, 7813, 7897, 8035, 8349, 8520, 8832, 9372, 10025, 10776]","[3509, 3657, 6986, 8349]","[214, 970, 1581, 2162, 2358, 3054, 3385, 3909, 4738, 6004, 6322, 6327, 6420, 6480, 7813, 7897, 8035, 8520, 8832, 9372, 10025, 10776]","[3509, 3657, 6679, 6986, 8349]",10714,26,10688,4,22,10687,1
4.0,HUMPAP,"[167, 641, 1012, 1410, 1490, 1495, 1737, 1970, 2089, 2115, 3167, 3342, 3477, 4164, 4270, 4478]","[1410, 2089, 3167]","[167, 641, 1012, 1490, 1495, 1737, 1970, 2115, 3342, 3477, 4164, 4270, 4478]","[1410, 2089, 2414, 3167]",4489,16,4473,3,13,4472,1
4.0,HUMPCI,"[284, 308, 312, 511, 1538, 2078, 2124, 2208, 2226, 2298, 2586, 2671, 2784, 2812, 2930, 2957, 3129, 3238, 3307, 3477, 3575, 3636, 3685, 3914, 4332, 4672, 4697, 4859, 5210, 5543, 7199, 7255, 8054, 8156, 8384, 8568, 8664, 8725, 9209, 9603, 9964, 10139, 10819, 10898, 11275, 11483, 12688, 12792, 14117, 14121, 14247, 14264, 14272, 14452, 14982, 15064, 15146]","[8568, 10898, 11483]","[284, 308, 312, 511, 1538, 2078, 2124, 2208, 2226, 2298, 2586, 2671, 2784, 2812, 2930, 2957, 3129, 3238, 3307, 3477, 3575, 3636, 3685, 3914, 4332, 4672, 4697, 4859, 5210, 5543, 7199, 7255, 8054, 8156, 8384, 8664, 8725, 9209, 9603, 9964, 10139, 10819, 11275, 12688, 12792, 14117, 14121, 14247, 14264, 14272, 14452, 14982, 15064, 15146]","[8568, 10898, 11483]",15563,57,15506,3,54,15506,0
4.0,HUMPEM,"[693, 700, 789, 934, 948, 1033, 1537, 2101, 2266, 2421, 2614, 2707, 2973, 3203, 3297, 3314, 3590, 3745, 3904, 3921, 4210]","[934, 2266, 2421, 2707, 2973, 3203]","[693, 700, 789, 948, 1033, 1537, 2101, 2614, 3297, 3314, 3590, 3745, 3904, 3921, 4210]","[934, 2266, 2421, 2707, 2973, 3203]",4235,21,4214,6,15,4214,0
4.0,HUMPEPYYA,"[7, 20, 647, 727, 766, 904, 1201, 1307, 1537, 1658, 1699, 1824, 2196, 2243, 2254]",[1201],"[7, 20, 647, 727, 766, 904, 1307, 1537, 1658, 1699, 1824, 2196, 2243, 2254]","[1201, 1388]",2370,15,2355,1,14,2354,1
4.0,HUMPF4V1A,"[11, 199, 381, 826]","[381, 826]","[11, 199]","[381, 826]",1460,4,1456,2,2,1456,0
4.0,HUMPHOSA,"[87, 233, 312, 425, 604, 850, 1286, 1300, 1494, 1555, 1713, 1810, 2185, 2323, 2469, 2988, 3209, 3729, 4516, 4789]","[233, 850, 1494, 1810, 2323, 2988, 3209, 3729]","[87, 312, 425, 604, 1286, 1300, 1555, 1713, 2185, 2469, 4516, 4789]","[233, 850, 1494, 1810, 2323, 2988, 3209, 3729]",4884,20,4864,8,12,4864,0
4.0,HUMPRCA,"[130, 498, 684, 1048, 1687, 2201, 2304, 2309, 2354, 3181, 3438, 3499, 3631, 3703, 4175, 4778, 5118, 5348, 5452, 5512, 5585, 6604, 6648, 6777, 6827, 7002, 7719, 8396, 8524, 8580, 8584, 9620, 10055, 10977, 10987, 11461]","[2201, 3631, 5118, 5348, 5585, 8396]","[130, 498, 684, 1048, 1687, 2304, 2309, 2354, 3181, 3438, 3499, 3703, 4175, 4778, 5452, 5512, 6604, 6648, 6777, 6827, 7002, 7719, 8524, 8580, 8584, 9620, 10055, 10977, 10987, 11461]","[2201, 3631, 5118, 5348, 5585, 8396, 9387]",11717,36,11681,6,30,11680,1
4.0,HUMPREELAS,"[596, 608, 826, 1070, 1357, 1619, 1724, 1729, 1785, 1802, 1827]",[596],"[608, 826, 1070, 1357, 1619, 1724, 1729, 1785, 1802, 1827]",[596],2291,11,2280,1,10,2280,0
4.0,HUMPRPHX,"[71, 317, 568, 963, 1143, 1475, 1551, 1838, 1911, 2127, 2502, 2523, 2550, 2869, 3173, 3322, 3633, 3719, 3914, 4225, 4319]","[1838, 2127, 2869, 3173, 3322, 3633]","[71, 317, 568, 963, 1143, 1475, 1551, 1911, 2502, 2523, 2550, 3719, 3914, 4225, 4319]","[1346, 1838, 2127, 2652, 2869, 3173, 3322, 3633]",4524,21,4503,6,15,4501,2
4.0,HUMRCC1,"[108, 246, 486, 638, 654, 1017, 1608, 1708, 2437, 2711, 4068, 4304, 4379, 4555, 4654, 4681, 4733, 4737, 5210, 5479, 5545, 5741, 6493, 6765, 7271, 7642, 8620, 8701, 8986, 9297, 9960, 10178, 10252, 10366, 10711, 11120, 11134, 11329, 11415, 12204, 12573, 12616, 12731, 13006, 13360, 13471, 13510, 13805, 13819, 14069, 14112, 14368, 14604, 14697, 14702, 15108, 15324, 15440, 15532, 15704, 15894, 16280, 16316, 16465, 16526, 16574, 16836, 17016, 17556, 17950, 18304, 18348, 18716, 19037, 19296, 19784, 19855, 20442, 20849, 20918, 21036, 21092, 21303, 21774, 22033, 22205, 22579, 22826, 23423, 23681, 23725, 24194, 24201, 25071, 25727, 25857, 26108, 26218, 26579, 26701, 26808, 26989, 27447, 27973, 28010, 28244, 28523, 28793, 28893, 29020, 29247, 29419, 29766, 29965, 30085, 30235, 30648, 31610, 31672, 32040, 33137, 33278, 33503, 34138, 34406, 34481]","[24201, 26218, 26579, 28010, 28244, 28893, 29247, 29766]","[108, 246, 486, 638, 654, 1017, 1608, 1708, 2437, 2711, 4068, 4304, 4379, 4555, 4654, 4681, 4733, 4737, 5210, 5479, 5545, 5741, 6493, 6765, 7271, 7642, 8620, 8701, 8986, 9297, 9960, 10178, 10252, 10366, 10711, 11120, 11134, 11329, 11415, 12204, 12573, 12616, 12731, 13006, 13360, 13471, 13510, 13805, 13819, 14069, 14112, 14368, 14604, 14697, 14702, 15108, 15324, 15440, 15532, 15704, 15894, 16280, 16316, 16465, 16526, 16574, 16836, 17016, 17556, 17950, 18304, 18348, 18716, 19037, 19296, 19784, 19855, 20442, 20849, 20918, 21036, 21092, 21303, 21774, 22033, 22205, 22579, 22826, 23423, 23681, 23725, 24194, 25071, 25727, 25857, 26108, 26701, 26808, 26989, 27447, 27973, 28523, 28793, 29020, 29419, 29965, 30085, 30235, 30648, 31610, 31672, 32040, 33137, 33278, 33503, 34138, 34406, 34481]","[24201, 26218, 26579, 28010, 28244, 28893, 29247, 29766]",34633,126,34507,8,118,34507,0
4.0,HUMREGHOM,"[52, 274, 684, 1170, 1419, 1864, 1909, 2739, 2825]","[684, 1419, 1864, 2739]","[52, 274, 1170, 1909, 2825]","[684, 1419, 1864, 2739]",3403,9,3394,4,5,3394,0
4.0,HUMROD1X,"[454, 1146, 1242, 1876, 2015, 2227, 2343, 2611, 2638, 2695, 2720]","[1242, 1876]","[454, 1146, 2015, 2227, 2343, 2611, 2638, 2695, 2720]","[1242, 1876]",2833,11,2822,2,9,2822,0
4.0,HUMRPIB2,"[310, 356, 435, 472, 510, 622, 899, 1121, 1531, 2017, 2268, 2713, 2758, 3588, 3674]","[1531, 2268, 2713, 3588]","[310, 356, 435, 472, 510, 622, 899, 1121, 2017, 2758, 3674]","[1531, 2268, 2713, 3588]",4329,15,4314,4,11,4314,0
4.0,HUMRPS6B,"[359, 1059, 1101, 1168, 1232, 1721, 1838, 2146, 2178, 2651, 2866, 3072, 3893, 4051, 4432, 4655, 4838]","[359, 1059, 1838, 2178, 4051]","[1101, 1168, 1232, 1721, 2146, 2651, 2866, 3072, 3893, 4432, 4655, 4838]","[359, 1059, 1838, 2178, 4051]",4964,17,4947,5,12,4947,0
4.0,HUMSEMI,"[578, 793, 806, 975, 1583, 1636, 2015, 2394, 2547, 2682, 2979, 3074, 3496, 3849, 3886]",[793],"[578, 806, 975, 1583, 1636, 2015, 2394, 2547, 2682, 2979, 3074, 3496, 3849, 3886]",[793],4156,15,4141,1,14,4141,0
4.0,HUMSEMIIB,"[493, 528, 765, 1274, 1298, 1316, 1389, 1642, 1790, 1889, 1988, 2515, 2616, 3135, 3352, 3769, 4271, 4486, 4499, 4660, 4667, 5275, 5328, 5640, 5820, 6000, 6304, 6446, 6514, 7146, 7527, 7944]",[4486],"[493, 528, 765, 1274, 1298, 1316, 1389, 1642, 1790, 1889, 1988, 2515, 2616, 3135, 3352, 3769, 4271, 4499, 4660, 4667, 5275, 5328, 5640, 5820, 6000, 6304, 6446, 6514, 7146, 7527, 7944]",[4486],8216,32,8184,1,31,8184,0
4.0,HUMSTATH2,"[353, 1140, 1197, 1553, 1675, 1820, 2025, 2131, 2151, 2312, 2322, 2403, 2530, 2627, 2733, 2848, 4592, 4629]","[353, 1553, 1675]","[1140, 1197, 1820, 2025, 2131, 2151, 2312, 2322, 2403, 2530, 2627, 2733, 2848, 4592, 4629]","[353, 1553, 1675]",4715,18,4697,3,15,4697,0
4.0,HUMTBGA,"[377, 451, 460, 854, 1021, 1646, 2099, 2681, 3107, 3355, 4529, 4941, 5164, 5177, 5231, 5236, 5469, 5475, 5530, 5875, 6296, 6314, 6627, 6841, 7144, 7395, 7441, 7960, 8219, 8362]","[4941, 7144]","[377, 451, 460, 854, 1021, 1646, 2099, 2681, 3107, 3355, 4529, 5164, 5177, 5231, 5236, 5469, 5475, 5530, 5875, 6296, 6314, 6627, 6841, 7395, 7441, 7960, 8219, 8362]","[4941, 6265, 7144]",8761,30,8731,2,28,8730,1
4.0,HUMTCRBRA,"[199, 278, 405, 469, 561]",[278],"[199, 405, 469, 561]",[278],728,5,723,1,4,723,0
4.0,HUMTHROMA,"[159, 743, 787, 800, 1277, 1464, 1605, 1696, 1985, 2344, 2384, 2717, 3117, 4222, 4266, 4362, 4394, 4817, 5134, 5715]","[1985, 2344, 2717, 4817]","[159, 743, 787, 800, 1277, 1464, 1605, 1696, 2384, 3117, 4222, 4266, 4362, 4394, 5134, 5715]","[1985, 2344, 2717, 4817]",6155,20,6135,4,16,6135,0
4.0,HUMTNP2SS,"[80, 86, 177, 658, 673, 941]",[658],"[80, 86, 177, 673, 941]",[658],1774,6,1768,1,5,1768,0
4.0,HUMTPALBU,"[313, 722, 1094, 1359, 1621, 1708, 2692, 2741, 2932, 2941, 3377, 3425, 3781, 4153, 4361, 4587, 4707, 4720, 5066, 5992, 6086]","[1094, 1621, 2741, 3425, 4361]","[313, 722, 1359, 1708, 2692, 2932, 2941, 3377, 3781, 4153, 4587, 4707, 4720, 5066, 5992, 6086]","[1094, 1621, 2741, 3425, 4361]",6164,21,6143,5,16,6143,0
4.0,HUMTRHYAL,"[201, 301, 562, 827, 1120, 1645, 1793, 2232, 2340, 2837, 4658, 6019, 6083, 6556, 7415, 8581]",[1645],"[201, 301, 562, 827, 1120, 1793, 2232, 2340, 2837, 4658, 6019, 6083, 6556, 7415, 8581]",[1645],9543,16,9527,1,15,9527,0
4.0,HUMTSHB2,"[187, 780, 872]",[187],"[780, 872]",[187],978,3,975,1,2,975,0
4.0,HUMV2R,"[261, 287, 1366, 1404, 1507, 1815, 2047, 2128]","[261, 1507]","[287, 1366, 1404, 1815, 2047, 2128]","[261, 1507]",2274,8,2266,2,6,2266,0
4.0,HYPSCGH,"[41, 806, 889, 1039, 1252, 1624]","[41, 1039, 1624]","[806, 889, 1252]","[41, 451, 1039, 1624]",2476,6,2470,3,3,2469,1
4.0,LAYEGLOBIN,"[222, 238, 584, 1185, 1197, 1265, 1312, 1373]","[238, 584]","[222, 1185, 1197, 1265, 1312, 1373]","[238, 584]",1694,8,1686,2,6,1686,0
4.0,LEBGLOB,"[94, 142, 157, 662, 1373, 1501, 1539, 1561, 1577, 1663, 1791, 1926, 2206, 2555, 3171, 3565]","[1577, 1926]","[94, 142, 157, 662, 1373, 1501, 1539, 1561, 1663, 1791, 2206, 2555, 3171, 3565]","[1577, 1926]",3638,16,3622,2,14,3622,0
4.0,LNOEGLOBIN,"[220, 236, 345, 587, 603, 1185, 1197, 1312]","[236, 587]","[220, 345, 603, 1185, 1197, 1312]","[236, 587]",1690,8,1682,2,6,1682,0
4.0,MACHBGA1,"[283, 457, 495, 841, 1370]","[495, 841]","[283, 457, 1370]","[495, 841]",2097,5,2092,2,3,2092,0
4.0,MACHBGA2,"[281, 455, 493, 839, 1367]","[493, 839]","[281, 455, 1367]","[493, 839]",2100,5,2095,2,3,2095,0
4.0,MAMGLUTRA,"[34, 424, 484, 657, 663, 1082, 1255, 1627, 1718, 1819, 2152, 2406, 2558, 2745, 2938, 3059, 3175, 4252, 4272, 4967, 4974, 5131, 5213, 5870]","[484, 1255, 1627, 1819, 2745, 2938]","[34, 424, 657, 663, 1082, 1718, 2152, 2406, 2558, 3059, 3175, 4252, 4272, 4967, 4974, 5131, 5213, 5870]","[484, 821, 1255, 1627, 1819, 2745, 2938]",6287,24,6263,6,18,6262,1
4.0,MAU09941,"[11, 613, 778, 1031, 1166, 1480, 1803, 1830, 1846, 2427, 2667, 2932, 2968, 3134, 3521]",[1830],"[11, 613, 778, 1031, 1166, 1480, 1803, 1846, 2427, 2667, 2932, 2968, 3134, 3521]",[1830],3798,15,3783,1,14,3783,0
4.0,MFAPOA2A,"[133, 226, 379, 587, 785, 1422]","[379, 785]","[133, 226, 587, 1422]","[379, 785]",1489,6,1483,2,4,1483,0
4.0,MFAPOC3A,"[115, 232, 642, 913, 1172, 1239, 1715, 1993, 2232, 2384, 2689, 3068, 3213]","[913, 1172]","[115, 232, 642, 1239, 1715, 1993, 2232, 2384, 2689, 3068, 3213]","[913, 1172]",3254,13,3241,2,11,3241,0
4.0,MMA2IXCOA,"[599, 798, 859, 878, 1383, 1439, 1757, 1800, 1812, 1866, 1881, 1925, 2935, 3105, 3132, 3652, 4386, 5665, 5682, 5831, 6014, 6054, 6266, 6355, 6635, 6930, 7102, 7250, 7371, 7472, 7658, 7684, 8064, 8135, 8216, 8255, 8401, 8539, 8882, 9179, 9209, 9322, 9467, 9609, 9626, 9793, 10270, 10282, 10304, 10930, 11077, 11426, 11611, 12074, 12952, 13033, 13111, 13361, 13447, 13726, 13840, 14575, 15021, 15338, 15597, 15933, 16114, 16240, 16522, 16811, 17106, 17275, 17333, 17647, 18032, 18283]","[3132, 4386, 5682, 5831, 7102, 7250, 7371, 7684, 8064, 8216, 8401, 8539, 8882, 9322, 9467, 9626, 13033, 13447, 13726, 14575, 15021, 15338, 15597, 15933, 16114, 16240, 16522, 16811, 17275, 17647]","[599, 798, 859, 878, 1383, 1439, 1757, 1800, 1812, 1866, 1881, 1925, 2935, 3105, 3652, 5665, 6014, 6054, 6266, 6355, 6635, 6930, 7472, 7658, 8135, 8255, 9179, 9209, 9609, 9793, 10270, 10282, 10304, 10930, 11077, 11426, 11611, 12074, 12952, 13111, 13361, 13840, 17106, 17333, 18032, 18283]","[3132, 4386, 5682, 5831, 7102, 7250, 7371, 7684, 8064, 8216, 8401, 8539, 8882, 9322, 9467, 9626, 13033, 13447, 13726, 14575, 15021, 15338, 15597, 15746, 15933, 16114, 16240, 16522, 16811, 17275, 17647]",19471,76,19395,30,46,19394,1
4.0,MMACLGNA,"[474, 499, 553, 918, 1458, 1499, 2537, 2666, 2734, 2923, 2933, 3107, 3178]","[474, 3178]","[499, 553, 918, 1458, 1499, 2537, 2666, 2734, 2923, 2933, 3107]","[474, 3178]",3873,13,3860,2,11,3860,0
4.0,MMAPOG,"[143, 265, 536, 669, 806, 876, 1186, 1456, 1935, 2056, 2146]","[536, 806]","[143, 265, 669, 876, 1186, 1456, 1935, 2056, 2146]","[536, 806]",2168,11,2157,2,9,2157,0
4.0,MMASM1G,"[1088, 1141, 1492, 2065, 2244, 2830, 2928, 3245, 3367, 3599, 3619, 3745, 3749, 4681]","[1088, 2244, 2928, 3245, 3745]","[1141, 1492, 2065, 2830, 3367, 3599, 3619, 3749, 4681]","[1088, 2244, 2928, 3245, 3745]",4767,14,4753,5,9,4753,0
4.0,MMCASEIB,"[15, 1113, 1488, 1889, 2857, 2974, 3141, 3742, 4901, 4916, 5615, 5877, 6252, 6305, 6603, 6611, 6905, 6932, 7023, 7155, 7160, 7964, 8126, 8222, 8252, 8851, 9803, 10443, 10796, 11712, 11758, 11838, 12928, 13000]","[6252, 7023, 7160, 8126, 8252, 9803]","[15, 1113, 1488, 1889, 2857, 2974, 3141, 3742, 4901, 4916, 5615, 5877, 6305, 6603, 6611, 6905, 6932, 7155, 7964, 8222, 8851, 10443, 10796, 11712, 11758, 11838, 12928, 13000]","[6252, 7023, 7160, 8126, 8252, 9803]",13046,34,13012,6,28,13012,0
4.0,MMCD24A,"[233, 274, 287, 477, 1126, 1273, 1660, 1670, 1969, 2195, 2486, 2860, 3693, 3805, 3828, 3949, 4140, 5478, 5793, 6430, 7063, 7475]",[2486],"[233, 274, 287, 477, 1126, 1273, 1660, 1670, 1969, 2195, 2860, 3693, 3805, 3828, 3949, 4140, 5478, 5793, 6430, 7063, 7475]",[2486],7632,22,7610,1,21,7610,0
4.0,MMCFOS,"[99, 844, 1244, 1790, 1850, 2162, 2208, 2363, 3118, 3414]","[844, 1850, 2363]","[99, 1244, 1790, 2162, 2208, 3118, 3414]","[844, 1850, 2363]",3959,10,3949,3,7,3949,0
4.0,MMCOL10A,"[30, 560, 1070, 1193, 1518, 1719, 1802, 1964, 2931, 3292, 3514, 3918, 4222, 4716, 4974, 5105, 5224, 5660, 5729, 5765, 5846, 6146, 6290, 6371, 6389, 6407, 6704, 6833, 7009, 7059, 7101, 7192, 7282, 7335, 7656, 8029, 9050, 9284, 9322]",[1802],"[30, 560, 1070, 1193, 1518, 1719, 1964, 2931, 3292, 3514, 3918, 4222, 4716, 4974, 5105, 5224, 5660, 5729, 5765, 5846, 6146, 6290, 6371, 6389, 6407, 6704, 6833, 7009, 7059, 7101, 7192, 7282, 7335, 7656, 8029, 9050, 9284, 9322]",[1802],9323,39,9284,1,38,9284,0
4.0,MMCRPG,"[375, 523, 929]",[375],"[523, 929]",[375],2132,3,2129,1,2,2129,0
4.0,MMCYTOKNA,"[810, 1089, 1123, 1339, 1580, 1881]",[810],"[1089, 1123, 1339, 1580, 1881]","[810, 1559]",2551,6,2545,1,5,2544,1
4.0,MMDM2RR,"[104, 665, 680, 854, 878, 1305, 1439, 1651, 1846, 2407, 2702, 3262, 3378, 3509, 3526, 3701, 3962, 4028, 4134, 4663, 4925, 5134, 6030, 6048]","[665, 854, 1305, 1651, 2702, 3701, 3962, 4925, 5134]","[104, 680, 878, 1439, 1846, 2407, 3262, 3378, 3509, 3526, 4028, 4134, 4663, 6030, 6048]","[665, 854, 1305, 1651, 2702, 3701, 3962, 4925, 5134]",6632,24,6608,9,15,6608,0
4.0,MMDNAASFA,"[542, 855, 918, 1241, 1497, 1576, 1823, 2135, 2357, 3306, 3517, 3558]","[855, 1241, 1576, 1823, 2135, 2357]","[542, 918, 1497, 3306, 3517, 3558]","[855, 1241, 1576, 1823, 2135, 2357, 2695]",4307,12,4295,6,6,4294,1
4.0,MMEZGL,"[589, 613, 621, 637, 715, 802, 910, 1167, 1276, 1599]","[589, 1599]","[613, 621, 637, 715, 802, 910, 1167, 1276]","[589, 1599]",1945,10,1935,2,8,1935,0
4.0,MMG37,"[265, 348, 381, 788, 1700, 2119, 2570, 2771, 2788]","[788, 2119, 2570]","[265, 348, 381, 1700, 2771, 2788]","[332, 788, 1303, 2119, 2363, 2570]",3065,9,3056,3,6,3053,3
4.0,MMGBCRYA,"[165, 188, 332, 671, 1003, 1412, 1718, 2175, 2261, 2662]","[671, 1003]","[165, 188, 332, 1412, 1718, 2175, 2261, 2662]","[671, 1003]",2653,10,2643,2,8,2643,0
4.0,MMGCCRYA,"[721, 1056, 1430, 1716, 1790, 1807, 2488, 2655]","[721, 1056]","[1430, 1716, 1790, 1807, 2488, 2655]","[721, 1056]",2884,8,2876,2,6,2876,0
4.0,MMGFAPD,"[108, 713, 976, 1298, 1624, 1901, 2277, 2449, 2760, 2995, 3351, 3473, 3660, 4335, 4868, 5452, 7117, 7253, 7902, 7907, 8227, 8409, 8598, 9093, 9788]","[713, 1624, 1901, 2995, 4335, 5452, 7907]","[108, 976, 1298, 2277, 2449, 2760, 3351, 3473, 3660, 4868, 7117, 7253, 7902, 8227, 8409, 8598, 9093, 9788]","[713, 1624, 1901, 2995, 3906, 4335, 5452, 7907]",9963,25,9938,7,18,9937,1
4.0,MMGGLINE,"[204, 279, 441, 1487, 1787, 2076, 2250, 2288, 2634, 3162, 3948, 4417, 4813, 4824, 4883, 5624, 6374, 6664, 6955, 7129, 7167, 7513, 8041, 8852, 9096, 9162, 9179, 9263, 9567, 9578, 9641, 9714, 10407, 11052]","[7167, 7513]","[204, 279, 441, 1487, 1787, 2076, 2250, 2288, 2634, 3162, 3948, 4417, 4813, 4824, 4883, 5624, 6374, 6664, 6955, 7129, 8041, 8852, 9096, 9162, 9179, 9263, 9567, 9578, 9641, 9714, 10407, 11052]","[7167, 7513]",11278,34,11244,2,32,11244,0
4.0,MMGK5,"[244, 695, 1690, 1805, 1809, 1890, 2626, 2768, 2825, 2845, 2850, 3287, 3525]","[695, 1805, 2825]","[244, 1690, 1809, 1890, 2626, 2768, 2845, 2850, 3287, 3525]","[695, 1805, 2595, 2825]",3602,13,3589,3,10,3588,1
4.0,MMH2D4Q5,"[159, 644, 1055]","[159, 644]",[1055],"[159, 644]",1100,3,1097,2,1,1097,0
4.0,MMHOX13,"[325, 369, 492, 800, 1037, 1147, 1455, 1570, 1647, 1651, 1716, 2076, 2407, 2504, 2583, 2658, 2798]",[800],"[325, 369, 492, 1037, 1147, 1455, 1570, 1647, 1651, 1716, 2076, 2407, 2504, 2583, 2658, 2798]",[800],2827,17,2810,1,16,2810,0
4.0,MMHOX24I,"[705, 837, 896, 1160, 1264, 1719]",[837],"[705, 896, 1160, 1264, 1719]",[837],1915,6,1909,1,5,1909,0
4.0,MMIL1BG,"[121, 572, 1356, 1567, 1803, 1938, 2470, 3239, 3249, 3680, 4398, 4988, 5080, 5679, 6172]","[1356, 1938, 3680, 4398, 5679]","[121, 572, 1567, 1803, 2470, 3239, 3249, 4988, 5080, 6172]","[1356, 1938, 3680, 4398, 5679]",7092,15,7077,5,10,7077,0
4.0,MMIL3G,"[129, 188, 469, 686, 745, 824, 1913, 2090, 2583]","[686, 824, 1913, 2090]","[129, 188, 469, 745, 2583]","[686, 824, 1913, 2090]",3482,9,3473,4,5,3473,0
4.0,MMIL5G,"[151, 731, 818, 980, 1473, 1593, 1625, 1971, 2262, 2448, 2708, 3597, 4702, 4806, 5303, 5318, 5441, 5742, 6478, 6608]","[731, 1593, 3597]","[151, 818, 980, 1473, 1625, 1971, 2262, 2448, 2708, 4702, 4806, 5303, 5318, 5441, 5742, 6478, 6608]","[731, 1593, 3597]",6719,20,6699,3,17,6699,0
4.0,MMKFGF,"[493, 542, 693, 976, 1045, 1086, 1259, 1337, 1556, 1624, 2484, 2561, 2886, 3185]","[542, 1045]","[493, 693, 976, 1086, 1259, 1337, 1556, 1624, 2484, 2561, 2886, 3185]","[542, 1045]",3981,14,3967,2,12,3967,0
4.0,MMLDHAG,"[105, 1012, 1180, 1782, 1906, 2132, 2186, 2429, 2616, 2774, 2978, 4167, 4377, 4577, 4824, 5138, 5333, 5919, 6038, 6123, 7171, 7208, 7338, 7668, 7780, 7959, 8206, 8280, 8315, 8402, 8414, 8597, 8833, 8981, 9652, 9999, 10037, 10503, 10704, 10855, 11308, 11532, 11655, 11977, 12155, 12262]","[4577, 5919, 7171, 7668, 8597, 10704]","[105, 1012, 1180, 1782, 1906, 2132, 2186, 2429, 2616, 2774, 2978, 4167, 4377, 4824, 5138, 5333, 6038, 6123, 7208, 7338, 7780, 7959, 8206, 8280, 8315, 8402, 8414, 8833, 8981, 9652, 9999, 10037, 10503, 10855, 11308, 11532, 11655, 11977, 12155, 12262]","[4577, 5919, 7171, 7668, 8597, 10704]",12843,46,12797,6,40,12797,0
4.0,MMMMP9A,"[11, 70, 1476, 1890, 2008, 2375, 2781, 3064, 3418, 3945, 4206, 4321, 4851, 4864, 5695, 5716, 6087, 6282, 6356, 6564, 7049, 7374, 7752, 7770, 7791, 7954]","[2008, 2375, 2781, 3064, 3418, 3945, 4206, 5695, 6356, 6564]","[11, 70, 1476, 1890, 4321, 4851, 4864, 5716, 6087, 6282, 7049, 7374, 7752, 7770, 7791, 7954]","[1341, 2008, 2375, 2781, 3064, 3418, 3945, 4206, 5695, 5936, 6356, 6564]",8182,26,8156,10,16,8154,2
4.0,MMMRPS24,"[353, 404, 645, 670, 836, 1106, 1196, 1460, 1994, 2253, 2669, 2987, 3095, 3137, 3263, 3713, 3934, 5070, 5091]","[404, 1460, 3137]","[353, 645, 670, 836, 1106, 1196, 1994, 2253, 2669, 2987, 3095, 3263, 3713, 3934, 5070, 5091]","[404, 1460, 1761, 3137]",5491,19,5472,3,16,5471,1
4.0,MMMTIX,"[402, 706, 758, 951, 1355]","[402, 951]","[706, 758, 1355]","[402, 951]",1552,5,1547,2,3,1547,0
4.0,MMMUPBS6,"[731, 792, 861, 1203, 1246, 1451, 1614, 2045, 2425, 2793, 3236, 3445, 4527]","[731, 1203, 2045, 2793, 3236]","[792, 861, 1246, 1451, 1614, 2425, 3445, 4527]","[731, 1203, 2045, 2793, 3236]",4614,13,4601,5,8,4601,0
4.0,MMMYCL,"[580, 806, 919, 1615, 1787, 1951, 2042, 2419, 2554, 2785, 3292, 3810, 4161, 4673, 4744, 4970, 5883, 6468, 6484, 6619, 6752, 7477, 7560, 7565, 8161]",[1787],"[580, 806, 919, 1615, 1951, 2042, 2419, 2554, 2785, 3292, 3810, 4161, 4673, 4744, 4970, 5883, 6468, 6484, 6619, 6752, 7477, 7560, 7565, 8161]",[1787],8308,25,8283,1,24,8283,0
4.0,MMNFMG,"[50, 97, 120, 421, 638, 1553, 1634, 1791, 2540, 3175, 3339, 3793, 4040, 4409, 4448, 4619, 4798, 4804, 4855, 4886, 5044]","[1634, 2540]","[50, 97, 120, 421, 638, 1553, 1791, 3175, 3339, 3793, 4040, 4409, 4448, 4619, 4798, 4804, 4855, 4886, 5044]","[1634, 2540]",5463,21,5442,2,19,5442,0
4.0,MMNMYC,"[749, 869, 1163, 1210, 1355, 1609, 3549, 3661, 4261]",[1163],"[749, 869, 1210, 1355, 1609, 3549, 3661, 4261]",[1163],4799,9,4790,1,8,4790,0
4.0,MMNUCLEO,"[784, 863, 1033, 1160, 2027, 2042, 2680, 3040, 3141, 3456, 3984, 4071, 4293, 4464, 4694, 4879, 5198, 5351, 5605, 5879, 6230, 6530, 6879, 7203, 7215, 8122, 8304, 8614, 8794, 8928, 9050, 9572, 9781, 9881, 10179, 10436, 10506, 11016]","[2042, 3141, 4293, 4694, 4879, 5198, 6230, 8122, 9050, 9881, 10436]","[784, 863, 1033, 1160, 2027, 2680, 3040, 3456, 3984, 4071, 4464, 5351, 5605, 5879, 6530, 6879, 7203, 7215, 8304, 8614, 8794, 8928, 9572, 9781, 10179, 10506, 11016]","[2042, 3141, 4293, 4694, 4879, 5198, 6230, 7517, 8122, 8738, 9050, 9881, 10436]",11470,38,11432,11,27,11430,2
4.0,MMODC2,"[124, 331, 737, 1053, 1374, 1557, 1801, 2508, 2523, 2702, 2999, 3433, 4219]","[331, 737, 1053, 1374, 1557, 1801, 2508, 2702, 2999]","[124, 2523, 3433, 4219]","[331, 737, 1053, 1374, 1557, 1801, 2508, 2702, 2999]",4252,13,4239,9,4,4239,0
4.0,MMOESTEOP,"[510, 993, 1091, 1127, 1662, 1666, 2283, 2605, 2609, 2742, 2821, 4101, 4452, 4834, 5104, 5456, 5607]","[993, 1127, 2283, 2821, 4101]","[510, 1091, 1662, 1666, 2605, 2609, 2742, 4452, 4834, 5104, 5456, 5607]","[993, 1127, 2283, 2821, 4101]",5774,17,5757,5,12,5757,0
4.0,MMPO,"[324, 475, 561, 825, 857, 1709, 1800, 1950, 2193, 2446, 2553, 2860, 2948, 3054, 3336, 3503, 3728, 3749, 4385, 4769, 4831, 5312, 5641, 5673, 6250, 6805, 6833, 6901, 6982, 7167, 7842, 8043, 8109, 8440, 8907, 9079, 9464, 9716, 9809, 9903, 9938, 10001, 10055, 10756, 10894, 10983, 11076, 11636, 11901]","[2193, 2446, 2948, 3503, 3728, 4769, 7167, 8440, 8907, 9903]","[324, 475, 561, 825, 857, 1709, 1800, 1950, 2553, 2860, 3054, 3336, 3749, 4385, 4831, 5312, 5641, 5673, 6250, 6805, 6833, 6901, 6982, 7842, 8043, 8109, 9079, 9464, 9716, 9809, 9938, 10001, 10055, 10756, 10894, 10983, 11076, 11636, 11901]","[2193, 2446, 2948, 3503, 3728, 4018, 4769, 7167, 8440, 8907, 9903]",11905,49,11856,10,39,11855,1
4.0,MMPPSOMA,"[251, 411, 447, 562, 706, 722, 1034, 1208, 1248, 2049, 2491]",[1034],"[251, 411, 447, 562, 706, 722, 1208, 1248, 2049, 2491]",[1034],2556,11,2545,1,10,2545,0
4.0,MMPROP2,[631],[],[631],[289],712,1,711,0,1,710,1
4.0,MMPROT1,"[312, 478, 759, 937]",[759],"[312, 478, 937]",[759],1178,4,1174,1,3,1174,0
4.0,MMPROT2,"[361, 508, 615, 880, 915, 987, 1128, 1218, 1357, 1469]",[1218],"[361, 508, 615, 880, 915, 987, 1128, 1357, 1469]",[1218],1568,10,1558,1,9,1558,0
4.0,MMSAP,"[441, 1550, 1558]",[441],"[1550, 1558]",[441],1868,3,1865,1,2,1865,0
4.0,MMSCIMIP,"[415, 600, 1017, 1054, 1153, 1946]","[415, 1017]","[600, 1054, 1153, 1946]","[415, 1017]",1980,6,1974,2,4,1974,0
4.0,MMSYNDE1A,"[190, 526, 762, 816, 1054, 1345, 1483, 1992, 2151, 2623, 3132, 3570, 3706, 3831, 4826, 4867, 5018, 5616, 5772, 5923, 6256, 6275, 6622, 6741, 7075, 7622, 7683, 7733, 7805, 7828, 7931, 8043, 8442, 9076, 9182, 9320, 9867, 10122, 10340, 10903, 11397, 11495, 11583, 11858, 11900, 11930, 12132, 12515, 12803, 13095, 13426, 13599, 13723, 13851, 14080, 14113, 14254, 14623, 14634, 14843, 14948, 15172, 15203, 15299, 15696, 15845, 15929, 15955, 16427, 16639, 16744, 16770, 17647, 17663, 17701, 17717, 18655, 18754, 18837, 19009, 19057, 19424, 19440, 19542, 19726, 19767, 20385, 20460, 20515, 20657, 20735, 20942, 21888, 22081, 22120, 22488, 22707, 22802, 23203]","[1345, 19009, 20385, 20942]","[190, 526, 762, 816, 1054, 1483, 1992, 2151, 2623, 3132, 3570, 3706, 3831, 4826, 4867, 5018, 5616, 5772, 5923, 6256, 6275, 6622, 6741, 7075, 7622, 7683, 7733, 7805, 7828, 7931, 8043, 8442, 9076, 9182, 9320, 9867, 10122, 10340, 10903, 11397, 11495, 11583, 11858, 11900, 11930, 12132, 12515, 12803, 13095, 13426, 13599, 13723, 13851, 14080, 14113, 14254, 14623, 14634, 14843, 14948, 15172, 15203, 15299, 15696, 15845, 15929, 15955, 16427, 16639, 16744, 16770, 17647, 17663, 17701, 17717, 18655, 18754, 18837, 19057, 19424, 19440, 19542, 19726, 19767, 20460, 20515, 20657, 20735, 21888, 22081, 22120, 22488, 22707, 22802, 23203]","[1345, 19009, 20385, 20942]",23592,99,23493,4,95,23493,0
4.0,MMTHY1G,"[80, 183, 616, 696, 1009, 1156, 1833, 2181]","[80, 1009]","[183, 616, 696, 1156, 1833, 2181]","[80, 1009]",2682,8,2674,2,6,2674,0
4.0,MMTLAC,"[140, 299, 494, 748, 912, 925, 1171, 1335, 2858, 3092, 3338, 3509, 3836, 4297, 4373, 4591, 4783, 5339]","[299, 748, 1171, 3092, 3338]","[140, 494, 912, 925, 1335, 2858, 3509, 3836, 4297, 4373, 4591, 4783, 5339]","[299, 748, 1171, 3092, 3338]",5239,18,5221,5,13,5221,0
4.0,MMTNFBG,"[315, 524, 734, 813, 1196, 1553, 1558, 1728, 2456]",[1728],"[315, 524, 734, 813, 1196, 1553, 1558, 2456]","[1728, 1911]",3211,9,3202,1,8,3201,1
4.0,MMTROPIB,"[183, 1744, 1749, 1832, 1932, 1939, 2033, 2185, 2522, 2656, 3037, 3564, 3690, 4493, 4580, 4604, 4620, 4748, 4950, 5561]","[1932, 2185, 2656, 3037, 3564, 4604]","[183, 1744, 1749, 1832, 1939, 2033, 2522, 3690, 4493, 4580, 4620, 4748, 4950, 5561]","[1697, 1932, 2185, 2656, 3037, 3564, 4604]",5683,20,5663,6,14,5662,1
4.0,MMTUM198,"[120, 347, 709, 1084, 1729, 1750, 1849, 2808, 2818, 2899, 3098, 3313, 3338, 3587, 3818, 4180, 4220]","[2818, 3098, 3313, 3587, 3818, 4180]","[120, 347, 709, 1084, 1729, 1750, 1849, 2808, 2899, 3338, 4220]","[1692, 2818, 3098, 3313, 3587, 3818, 4180]",4376,17,4359,6,11,4358,1
4.0,MMU01530,"[358, 636, 891, 924, 1080, 1164, 1180, 1357, 1576, 1589, 2027, 2244, 2269, 3188, 3231, 3729, 3803, 4412, 4904, 5405, 5885, 6039, 6229, 6394, 6423, 6546]",[3231],"[358, 636, 891, 924, 1080, 1164, 1180, 1357, 1576, 1589, 2027, 2244, 2269, 3188, 3729, 3803, 4412, 4904, 5405, 5885, 6039, 6229, 6394, 6423, 6546]","[3094, 3231]",6694,26,6668,1,25,6667,1
4.0,MMU02278,"[75, 342, 1041, 1638, 1858, 2312, 2344, 3368, 3669, 3873]",[1638],"[75, 342, 1041, 1858, 2312, 2344, 3368, 3669, 3873]",[1638],3973,10,3963,1,9,3963,0
4.0,MMU02298,"[475, 603, 1180, 2102, 2413, 2874, 3047, 3116, 3911, 3920, 4270, 4351, 4749, 4794, 4897, 5502]","[1180, 2413]","[475, 603, 2102, 2874, 3047, 3116, 3911, 3920, 4270, 4351, 4749, 4794, 4897, 5502]","[1180, 2413]",5851,16,5835,2,14,5835,0
4.0,MMU02884,"[214, 220, 512, 668, 814, 875, 1630, 1761, 2107, 2382, 2484, 3386, 3665, 3669, 3865, 4798, 5217, 5244, 5291, 5517, 5806, 6022, 6642, 6836, 7527, 7562, 7567, 7708, 7973, 8590, 8612]","[1630, 5244, 6836]","[214, 220, 512, 668, 814, 875, 1761, 2107, 2382, 2484, 3386, 3665, 3669, 3865, 4798, 5217, 5291, 5517, 5806, 6022, 6642, 7527, 7562, 7567, 7708, 7973, 8590, 8612]","[1630, 5244, 6836]",8757,31,8726,3,28,8726,0
4.0,MMU04056,"[186, 231, 321, 901, 1382, 1450, 1461, 1472, 1502, 1857, 1865, 2046, 2135, 2183, 2377, 2490, 2509, 2667, 2711, 2747, 2902, 2960, 3291, 3530, 4688, 5218, 5459, 6264, 6477, 7683, 7710, 7979, 8501, 8633, 8664, 8680, 8895, 10317, 10794, 10876, 10998, 11259, 11441, 11797, 12088, 12211, 13211, 13933, 14104, 14478, 14615, 14896, 15214, 15270, 15417, 15506, 15545, 15620, 15870, 16157, 16230, 16348, 16561, 16710, 16734, 16994, 17245, 17992, 18100, 19860, 20025, 20243, 20314, 20602, 20804, 21185, 21351, 21514, 21625, 21633]","[1382, 3530, 4688, 7979, 8895, 10317, 10876, 11259, 12211, 16230, 16561]","[186, 231, 321, 901, 1450, 1461, 1472, 1502, 1857, 1865, 2046, 2135, 2183, 2377, 2490, 2509, 2667, 2711, 2747, 2902, 2960, 3291, 5218, 5459, 6264, 6477, 7683, 7710, 8501, 8633, 8664, 8680, 10794, 10998, 11441, 11797, 12088, 13211, 13933, 14104, 14478, 14615, 14896, 15214, 15270, 15417, 15506, 15545, 15620, 15870, 16157, 16348, 16710, 16734, 16994, 17245, 17992, 18100, 19860, 20025, 20243, 20314, 20602, 20804, 21185, 21351, 21514, 21625, 21633]","[1382, 3530, 4688, 7979, 8895, 10317, 10876, 11259, 12211, 13491, 16230, 16561]",21710,80,21630,11,69,21629,1
4.0,MMU04827,"[105, 1299, 1649, 2179, 2246, 2280, 2512, 2767, 2828, 3551, 3555, 3684, 4276, 4281, 4301, 4969, 5286, 5444, 5675, 6145, 7133, 7369, 7592]","[3684, 4281, 4969]","[105, 1299, 1649, 2179, 2246, 2280, 2512, 2767, 2828, 3551, 3555, 4276, 4301, 5286, 5444, 5675, 6145, 7133, 7369, 7592]","[3684, 4281, 4969]",7600,23,7577,3,20,7577,0
4.0,MMU07568,"[84, 267, 482, 527]","[84, 267, 482]",[527],"[84, 267, 482]",743,4,739,3,1,739,0
4.0,MMU07808,"[61, 183, 404, 542, 547, 664, 673, 987, 1019, 1179, 1208, 1697, 1762, 1918, 2384]","[673, 1697]","[61, 183, 404, 542, 547, 664, 987, 1019, 1179, 1208, 1762, 1918, 2384]","[673, 1697]",2840,15,2825,2,13,2825,0
4.0,MMU09741,"[245, 1076, 1094, 1230, 1655, 2034]","[245, 1230]","[1076, 1094, 1655, 2034]","[245, 1230]",2844,6,2838,2,4,2838,0
4.0,MMU09964,"[26, 375, 510, 803, 857, 1295, 1299, 1305, 1968, 2317, 2490, 2671, 2680, 2697, 2970, 3428, 3448, 3779, 3796, 4303, 4607, 5091, 5726, 5730, 5747, 5754, 5793, 5816, 5820, 5824, 5828, 5832, 5836, 5840, 5844, 5977, 6240, 6447, 6524, 6890, 7044, 7434, 7525, 7760, 7962, 8162, 8455, 8460, 8601, 9017, 9311, 9898, 9952, 9980, 10001, 10372, 10378, 10429, 10875, 10991, 11050, 11127, 11186, 11246]","[1968, 3428, 4303, 4607, 7962, 8162, 8601, 9017, 9311, 10875]","[26, 375, 510, 803, 857, 1295, 1299, 1305, 2317, 2490, 2671, 2680, 2697, 2970, 3448, 3779, 3796, 5091, 5726, 5730, 5747, 5754, 5793, 5816, 5820, 5824, 5828, 5832, 5836, 5840, 5844, 5977, 6240, 6447, 6524, 6890, 7044, 7434, 7525, 7760, 8455, 8460, 9898, 9952, 9980, 10001, 10372, 10378, 10429, 10991, 11050, 11127, 11186, 11246]","[1968, 3428, 4303, 4607, 7962, 8162, 8601, 9017, 9311, 10875]",11454,64,11390,10,54,11390,0
4.0,MMU10098,"[593, 1098, 1155, 1165, 1173, 1425, 1624, 3270, 3509, 3596, 5292, 5565, 5593, 5609, 5695, 5812]","[1173, 3509]","[593, 1098, 1155, 1165, 1425, 1624, 3270, 3596, 5292, 5565, 5593, 5609, 5695, 5812]","[1173, 3509]",6117,16,6101,2,14,6101,0
4.0,MMU11054,"[185, 204, 383, 1996, 2250, 2515]",[1996],"[185, 204, 383, 2250, 2515]","[457, 1418, 1996]",2564,6,2558,1,5,2556,2
4.0,MMU11713,"[250, 288, 634]","[288, 634]",[250],"[288, 634]",1759,3,1756,2,1,1756,0
4.0,MMU12029,"[17, 51, 297, 342, 381, 582, 879, 1264, 1309, 1385, 1410, 1897, 2030, 2082]","[582, 1264]","[17, 51, 297, 342, 381, 879, 1309, 1385, 1410, 1897, 2030, 2082]","[582, 1264]",2255,14,2241,2,12,2241,0
4.0,MMU12273,"[38, 358, 389, 680, 769, 915, 1085, 1434, 1740, 1940]","[680, 1085, 1740]","[38, 358, 389, 769, 915, 1434, 1940]","[680, 1085, 1740]",2575,10,2565,3,7,2565,0
4.0,MMU12559,"[62, 247, 822]",[247],"[62, 822]",[247],918,3,915,1,2,915,0
4.0,MMU12560,"[62, 247, 257]",[247],"[62, 257]",[247],920,3,917,1,2,917,0
4.0,MMU12561,"[62, 247, 384, 420, 820]",[247],"[62, 384, 420, 820]",[247],916,5,911,1,4,911,0
4.0,MMU12562,"[62, 247]",[247],[62],[247],918,2,916,1,1,916,0
4.0,MMU12565,"[62, 247, 396, 630]",[247],"[62, 396, 630]",[247],1043,4,1039,1,3,1039,0
4.0,MMU13921,"[10, 162, 289, 329, 820, 856, 952, 1034, 1862, 1867, 2003, 2197, 2354, 2693, 3036, 3132, 3401, 3525, 3990, 4034]","[952, 2003, 2354, 2693, 3990]","[10, 162, 289, 329, 820, 856, 1034, 1862, 1867, 2197, 3036, 3132, 3401, 3525, 4034]","[952, 2003, 2354, 2693, 2930, 3241, 3990]",4670,20,4650,5,15,4648,2
4.0,MMU14421,"[1089, 1322, 1867, 1887, 2041, 2454, 3681, 3799, 3848, 3867, 3920, 4195, 4470, 4528, 4560, 5034, 5599, 5864]",[],"[1089, 1322, 1867, 1887, 2041, 2454, 3681, 3799, 3848, 3867, 3920, 4195, 4470, 4528, 4560, 5034, 5599, 5864]","[3668, 4237, 4502, 4814]",6254,18,6236,0,18,6232,4
4.0,MMVITRO,"[8, 689, 725, 788, 1025, 1425, 1845, 1861, 2054, 2071, 2474, 2585, 2693, 2718, 2783, 2826, 3279, 3703, 3733, 3755, 3812, 3820, 3855, 3863, 4355, 4941, 4985, 4996]","[1845, 2054, 2474, 2693, 3279, 4355]","[8, 689, 725, 788, 1025, 1425, 1861, 2071, 2585, 2718, 2783, 2826, 3703, 3733, 3755, 3812, 3820, 3855, 3863, 4941, 4985, 4996]","[1845, 2054, 2474, 2693, 3017, 3279, 4355]",4996,28,4968,6,22,4967,1
4.0,MMVPREB2,"[172, 214, 379, 908, 930]",[379],"[172, 214, 908, 930]",[379],1045,5,1040,1,4,1040,0
4.0,MMVPREB3,"[172, 214, 379, 908]",[379],"[172, 214, 908]",[379],1045,4,1041,1,3,1041,0
4.0,MNKEGLOBIM,"[221, 237, 583, 1184, 1196]","[237, 583]","[221, 1184, 1196]","[237, 583]",1693,5,1688,2,3,1688,0
4.0,MNKEGLOBIN,"[221, 237, 583, 1182, 1194]","[237, 583]","[221, 1182, 1194]","[237, 583]",1691,5,1686,2,3,1686,0
4.0,MNKHGBGGAG,"[75, 92, 249, 287, 633, 1064, 1338]","[287, 633]","[75, 92, 249, 1064, 1338]","[287, 633]",1697,7,1690,2,5,1690,0
4.0,MNPROP2,[620],[],[620],[278],696,1,695,0,1,694,1
4.0,MUS8HS20,"[257, 271, 280, 329, 503, 545, 638, 940, 962, 1015, 1360, 1625, 2133, 2530, 2562]",[940],"[257, 271, 280, 329, 503, 545, 638, 962, 1015, 1360, 1625, 2133, 2530, 2562]",[940],2622,15,2607,1,14,2607,0
4.0,MUSAP,"[110, 499, 810, 931, 1012, 2291, 2551, 2656, 2686, 3186, 3264, 3574, 3815, 4034, 4160, 4509, 4539, 4740, 4927, 4971, 5211, 5230, 5290, 5369, 5529, 5547, 5619, 5952, 6013, 6067, 6406, 6494, 6554, 6709, 6929, 7201, 7890, 8019]","[3574, 3815, 4034, 4509, 4740, 4971, 5290, 5619, 5952, 6406, 6709]","[110, 499, 810, 931, 1012, 2291, 2551, 2656, 2686, 3186, 3264, 4160, 4539, 4927, 5211, 5230, 5369, 5529, 5547, 6013, 6067, 6494, 6554, 6929, 7201, 7890, 8019]","[3574, 3815, 4034, 4509, 4740, 4971, 5290, 5619, 5952, 6406, 6709]",8086,38,8048,11,27,8048,0
4.0,MUSAP5A,"[259, 354, 551, 651, 697, 786, 853, 1768, 2064, 2222, 2428, 2454, 2463, 2681, 2759, 3332, 3355, 3744, 3852, 4614, 4657, 4709, 5253, 5266, 5825, 6195, 6254, 6685, 6816]","[2428, 2759, 4614]","[259, 354, 551, 651, 697, 786, 853, 1768, 2064, 2222, 2454, 2463, 2681, 3332, 3355, 3744, 3852, 4657, 4709, 5253, 5266, 5825, 6195, 6254, 6685, 6816]","[2428, 2759, 4614]",6821,29,6792,3,26,6792,0
4.0,MUSAPEX,"[300, 372, 412, 768, 1042, 1363, 1394, 1684, 1773, 1919, 2089, 2436, 2742, 2942]","[1684, 2089, 2742]","[300, 372, 412, 768, 1042, 1363, 1394, 1773, 1919, 2436, 2942]","[1684, 2089, 2742]",4034,14,4020,3,11,4020,0
4.0,MUSAPOAII,"[112, 474, 559, 723, 1155, 1543, 2621]","[723, 1155]","[112, 474, 559, 1543, 2621]","[723, 1155]",2952,7,2945,2,5,2945,0
4.0,MUSAPOIVA,"[63, 470, 529, 588, 975, 1029, 1226, 1256, 1385, 2149, 2299, 2629, 2774, 2898, 2914, 2929]","[588, 975]","[63, 470, 529, 1029, 1226, 1256, 1385, 2149, 2299, 2629, 2774, 2898, 2914, 2929]","[588, 975]",3012,16,2996,2,14,2996,0
4.0,MUSBMP4,"[336, 441, 510, 664, 768, 1064, 1068, 1080, 2095, 2149, 2413, 2473, 2683, 2820, 2888, 2960, 3208, 3697, 3967, 4135, 4471, 4495, 4594, 4806, 5289, 5497, 5725, 5890, 6380, 7157, 7179, 7951, 8211, 8446, 8462, 8525, 9626]",[7179],"[336, 441, 510, 664, 768, 1064, 1068, 1080, 2095, 2149, 2413, 2473, 2683, 2820, 2888, 2960, 3208, 3697, 3967, 4135, 4471, 4495, 4594, 4806, 5289, 5497, 5725, 5890, 6380, 7157, 7951, 8211, 8446, 8462, 8525, 9626]",[7179],9660,37,9623,1,36,9623,0
4.0,MUSBNP,"[336, 412, 488, 680, 753, 903, 1057, 1449]","[336, 753]","[412, 488, 680, 903, 1057, 1449]","[336, 753]",1460,8,1452,2,6,1452,0
4.0,MUSCD14A,"[176, 543, 639, 777, 1122, 1454]",[176],"[543, 639, 777, 1122, 1454]",[176],1865,6,1859,1,5,1859,0
4.0,MUSCRKNB,"[96, 460, 815, 1440, 1904, 1989, 2058, 2245, 2455, 2658, 2796, 2829, 2879, 3505, 3842, 3862, 3949]","[1904, 2245, 2455, 2796, 3505, 3842]","[96, 460, 815, 1440, 1989, 2058, 2658, 2829, 2879, 3862, 3949]","[1904, 2245, 2455, 2796, 3505, 3842]",4513,17,4496,6,11,4496,0
4.0,MUSCYTCOVB,"[48, 724, 928, 1064, 1081, 1319, 1585, 1679, 1808, 1925, 1946, 2066, 2168, 2234]","[724, 1319, 1585]","[48, 928, 1064, 1081, 1679, 1808, 1925, 1946, 2066, 2168, 2234]","[724, 1319, 1585]",2532,14,2518,3,11,2518,0
4.0,MUSENDOBA,"[135, 807, 1066, 1276, 1500, 1507, 2117, 2130, 2462, 2614, 2743, 3027, 3115, 3350, 3618, 3892, 4049, 4342, 4371, 4430, 4853, 4898, 5090, 5527, 5589, 5616, 5660, 5696, 5700, 5721, 5817, 5969, 6258, 6358, 6929, 6980, 7007, 7151, 7548, 7585]","[2743, 3618, 4049, 4853, 5090, 5589]","[135, 807, 1066, 1276, 1500, 1507, 2117, 2130, 2462, 2614, 3027, 3115, 3350, 3892, 4342, 4371, 4430, 4898, 5527, 5616, 5660, 5696, 5700, 5721, 5817, 5969, 6258, 6358, 6929, 6980, 7007, 7151, 7548, 7585]","[2743, 3618, 4049, 4853, 5090, 5589]",7871,40,7831,6,34,7831,0
4.0,MUSFAUA,"[506, 544, 760, 783, 846, 925, 1216, 1249, 1496, 1535, 2068, 2103, 2124, 2650]","[1249, 1496, 2124]","[506, 544, 760, 783, 846, 925, 1216, 1535, 2068, 2103, 2650]","[1249, 1496, 2124]",2842,14,2828,3,11,2828,0
4.0,MUSFERHC,"[483, 526, 1103, 1827, 2185, 2319, 2428]","[483, 1827, 2185]","[526, 1103, 2319, 2428]","[483, 1827, 2185]",2782,7,2775,3,4,2775,0
4.0,MUSFKBP13X,"[321, 736, 904, 928, 1247, 1282, 1556]","[321, 736, 904, 1282]","[928, 1247, 1556]","[321, 736, 904, 1282]",1573,7,1566,4,3,1566,0
4.0,MUSGAD45,"[559, 935, 1034, 1126, 1458, 1542, 1595, 1898, 2472, 2647, 3023]","[935, 1126, 1458]","[559, 1034, 1542, 1595, 1898, 2472, 2647, 3023]","[935, 1126, 1458]",3092,11,3081,3,8,3081,0
4.0,MUSGFJE,"[624, 709, 1098, 1194, 1323, 1489, 2167, 2275]","[624, 1489]","[709, 1098, 1194, 1323, 2167, 2275]","[624, 1489]",2403,8,2395,2,6,2395,0
4.0,MUSGPOAD,"[890, 1044, 1048, 1169, 1324, 1737, 2306, 2538, 2898, 3046, 3337, 4023, 4403, 4816, 4916, 5083, 5250, 5342, 5400, 5859, 6573, 7850, 7929]","[1044, 2306, 4403, 4916]","[890, 1048, 1169, 1324, 1737, 2538, 2898, 3046, 3337, 4023, 4816, 5083, 5250, 5342, 5400, 5859, 6573, 7850, 7929]","[1044, 2306, 4403, 4916]",8068,23,8045,4,19,8045,0
4.0,MUSHBBH0,"[163, 365, 914, 1012, 1112, 1265, 1566, 2081]","[365, 914]","[163, 1012, 1112, 1265, 1566, 2081]","[365, 914]",2127,8,2119,2,6,2119,0
4.0,MUSHBBH1,"[249, 451, 780, 1417, 1493]","[451, 780]","[249, 1417, 1493]","[451, 780]",1918,5,1913,2,3,1913,0
4.0,MUSHES1,"[355, 556, 784, 1108, 1121, 1351, 1367, 1400, 1488, 1797, 1819, 1839, 2208]","[556, 784, 1108]","[355, 1121, 1351, 1367, 1400, 1488, 1797, 1819, 1839, 2208]","[556, 784, 1108]",2817,13,2804,3,10,2804,0
4.0,MUSHOX35A,"[232, 612, 1308, 1715, 2007, 2577, 2661, 3150, 3519, 3545]",[1308],"[232, 612, 1715, 2007, 2577, 2661, 3150, 3519, 3545]",[1308],3847,10,3837,1,9,3837,0
4.0,MUSIL1RN,"[168, 512, 886, 1676, 1922, 2186, 2224, 2289, 2483, 2552, 2789, 3116, 3549, 3883, 3938, 4482, 5269, 6210]","[512, 2483, 3549]","[168, 886, 1676, 1922, 2186, 2224, 2289, 2552, 2789, 3116, 3883, 3938, 4482, 5269, 6210]","[512, 2483, 3549]",6342,18,6324,3,15,6324,0
4.0,MUSKE3A,"[21, 340, 544, 657, 788, 840, 981, 1088, 1328, 1562, 1569, 1604, 1620, 1881, 1948, 2052, 2194, 2794, 3218, 3339, 3400, 3405]","[21, 544, 3218, 3400]","[340, 657, 788, 840, 981, 1088, 1328, 1562, 1569, 1604, 1620, 1881, 1948, 2052, 2194, 2794, 3339, 3405]","[21, 544, 3218, 3400]",3612,22,3590,4,18,3590,0
4.0,MUSLMP7A,"[287, 429, 487, 535, 1318, 1354, 1364, 1407, 2293, 2454, 3029, 3046, 3178, 3674, 4005]","[1318, 2454, 3029, 3674]","[287, 429, 487, 535, 1354, 1364, 1407, 2293, 3046, 3178, 4005]","[1318, 2153, 2454, 3029, 3674]",4259,15,4244,4,11,4243,1
4.0,MUSLTA,"[530, 830, 1207, 1632, 1637, 1807, 2537]",[1807],"[530, 830, 1207, 1632, 1637, 2537]","[1807, 1990]",3286,7,3279,1,6,3278,1
4.0,MUSMC26,"[155, 816, 843, 1581, 1906, 2071, 2419, 2475, 3046, 3075, 3190, 3415, 3666, 3682, 3716, 3964, 3982, 4144, 4182]","[2419, 3190, 4144]","[155, 816, 843, 1581, 1906, 2071, 2475, 3046, 3075, 3415, 3666, 3682, 3716, 3964, 3982, 4182]","[2419, 3190, 4144]",5386,19,5367,3,16,5367,0
4.0,MUSOGC,"[113, 290, 489]","[113, 290, 489]",[],"[113, 290, 489]",941,3,938,3,0,938,0
4.0,MUSOGCA,"[214, 285, 356, 866, 1043, 1242]","[866, 1043, 1242]","[214, 285, 356]","[866, 1043, 1242]",1694,6,1688,3,3,1688,0
4.0,MUSOGCB,"[113, 290, 490]","[113, 290, 490]",[],"[113, 290, 490]",942,3,939,3,0,939,0
4.0,MUSPNMT,"[547, 694, 955, 1076, 1665, 1881, 2135, 2343, 2450, 2599, 2755, 2890]","[1665, 2343]","[547, 694, 955, 1076, 1881, 2135, 2450, 2599, 2755, 2890]","[1665, 2343]",3136,12,3124,2,10,3124,0
4.0,MUSPROTA,"[421, 585, 1945, 2033, 2530, 2585, 2604, 3119, 3224, 3555, 3663, 4024, 4600]","[1945, 2585, 3224, 3663]","[421, 585, 2033, 2530, 2604, 3119, 3555, 4024, 4600]","[1945, 2585, 3224, 3663]",4636,13,4623,4,9,4623,0
4.0,MUSPROTEB,"[337, 496, 594, 647, 749, 765, 803, 993, 1024, 1482, 1920, 1988, 2130]","[337, 594, 993, 1988]","[496, 647, 749, 765, 803, 1024, 1482, 1920, 2130]","[337, 594, 993, 1988]",2389,13,2376,4,9,2376,0
4.0,MUSPRPC2,"[652, 801, 2455, 2470, 2740, 3019, 3778, 3833, 4186, 5493, 6607, 6797]",[801],"[652, 2455, 2470, 2740, 3019, 3778, 3833, 4186, 5493, 6607, 6797]",[801],7298,12,7286,1,11,7286,0
4.0,MUSPRPMPB,"[651, 801, 1480, 2974]",[801],"[651, 1480, 2974]",[801],3566,4,3562,1,3,3562,0
4.0,MUSREGI,"[325, 632, 775, 1159, 1258, 1316, 1799, 1965, 2230, 2450, 2993]","[1159, 1799, 2230, 2993]","[325, 632, 775, 1258, 1316, 1965, 2450]","[1159, 1799, 2230, 2993]",3748,11,3737,4,7,3737,0
4.0,MUSREGII,"[530, 927, 1626, 1988, 2023, 2526, 2543, 2927, 3091, 3233, 3308, 3463]","[927, 1626, 1988, 3091]","[530, 2023, 2526, 2543, 2927, 3233, 3308, 3463]","[927, 1626, 1988, 3091]",3924,12,3912,4,8,3912,0
4.0,MUSROM1X,"[115, 219, 983, 1030, 1146, 1242, 1848, 2169, 2555, 2616, 2640]","[1242, 1848]","[115, 219, 983, 1030, 1146, 2169, 2555, 2616, 2640]","[1242, 1848]",2779,11,2768,2,9,2768,0
4.0,MUSRPL30,"[84, 500, 660, 960, 1050, 1331, 1679, 2459, 2654, 3124, 3243, 3441]","[660, 1050, 2459]","[84, 500, 960, 1331, 1679, 2654, 3124, 3243, 3441]","[660, 1050, 2459]",3468,12,3456,3,9,3456,0
4.0,MUSRPS16,"[17, 475, 636, 758, 1210, 1311, 1491, 1728, 1868, 2005, 2355]","[1868, 2005]","[17, 475, 636, 758, 1210, 1311, 1491, 1728, 2355]","[450, 687, 1868, 2005]",2641,11,2630,2,9,2628,2
4.0,MUSS100B,"[213, 342, 1034, 1710, 1721, 1778, 2162, 2757, 3151, 3660, 4672, 4920, 5082, 5219, 5329, 5786, 6291, 6880, 6965, 7045, 8033, 8061, 8146, 8612, 8671, 8736]",[4920],"[213, 342, 1034, 1710, 1721, 1778, 2162, 2757, 3151, 3660, 4672, 5082, 5219, 5329, 5786, 6291, 6880, 6965, 7045, 8033, 8061, 8146, 8612, 8671, 8736]",[4920],8865,26,8839,1,25,8839,0
4.0,MUSSERPROA,"[217, 1034, 1449, 1831, 2037, 2092, 2114, 2341, 2739, 3178, 3371, 3997]","[1449, 2092, 2739, 3178]","[217, 1034, 1831, 2037, 2114, 2341, 3371, 3997]","[1449, 2092, 2739, 3178]",4449,12,4437,4,8,4437,0
4.0,MUSSSATGN,"[29, 613, 840, 1162, 1346, 1774, 1825, 2102, 2165, 2190, 2516, 2905, 2929, 3039, 3233, 3612, 3706, 3892]","[840, 1162, 1346, 2905, 3039]","[29, 613, 1774, 1825, 2102, 2165, 2190, 2516, 2929, 3233, 3612, 3706, 3892]","[840, 1162, 1346, 2905, 3039]",4058,18,4040,5,13,4040,0
4.0,MUSTCP,"[453, 470, 624, 908, 1005, 1329, 1705, 1993, 2164, 2427, 2463, 2496, 2781, 3172, 3270, 3576, 3642, 4019, 4278, 4687, 6098, 6552, 6567, 7230, 7274, 7512, 7562]","[453, 1705, 1993, 3270, 4278, 4687, 6098, 6552, 7230, 7512]","[470, 624, 908, 1005, 1329, 2164, 2427, 2463, 2496, 2781, 3172, 3576, 3642, 4019, 6567, 7274, 7562]","[453, 1705, 1993, 3270, 3746, 4278, 4687, 6098, 6552, 7230, 7512]",9253,27,9226,10,17,9225,1
4.0,MUSTHY1,"[80, 183, 616, 696, 1009, 1156, 1833, 2181]","[80, 1009]","[183, 616, 696, 1156, 1833, 2181]","[80, 1009]",2682,8,2674,2,6,2674,0
4.0,MUSTLAG,"[153, 261, 269, 547, 705, 901, 1155, 1314, 1327, 1573, 1733, 2128, 3260, 3494, 3740, 4237, 4788, 5009, 5201]","[705, 1155, 1573, 3494, 3740]","[153, 261, 269, 547, 901, 1314, 1327, 1733, 2128, 3260, 4237, 4788, 5009, 5201]","[705, 1155, 1573, 3494, 3740]",5412,19,5393,5,14,5393,0
4.0,MUSTSHBA2,"[69, 388, 464, 830, 1045]",[464],"[69, 388, 830, 1045]",[464],1283,5,1278,1,4,1278,0
4.0,MUSY1GLOB,"[354, 377, 690, 829, 1066, 1224, 1249]","[377, 690]","[354, 829, 1066, 1224, 1249]","[377, 690]",1745,7,1738,2,5,1738,0
4.0,OABBGLOB,"[33, 192, 525, 692, 920, 958, 1174, 1309, 1987, 2701]","[958, 1309]","[33, 192, 525, 692, 920, 1174, 1987, 2701]","[958, 1309]",3241,10,3231,2,8,3231,0
4.0,OABCGLOB,"[33, 193, 919, 957, 1011, 1177, 1312, 1352, 2648]","[957, 1312]","[33, 193, 919, 1011, 1177, 1352, 2648]","[957, 1312]",3192,9,3183,2,7,3183,0
4.0,OAINIGFII1,"[740, 1022, 1165, 1588, 2106, 2199]",[740],"[1022, 1165, 1588, 2106, 2199]",[740],2385,6,2379,1,5,2379,0
4.0,OAINTL3,"[115, 134, 674, 813, 850, 1909, 2072, 2099]","[674, 813, 1909, 2072]","[115, 134, 850, 2099]","[674, 813, 1909, 2072]",2793,8,2785,4,4,2785,0
4.0,OAKRT213,"[144, 1088, 1215, 1228, 1328, 1593, 1714, 1992, 2641, 2852, 3198, 3333, 3357, 3938, 4147, 4213, 4642, 4752, 4813, 5258, 5288, 5377, 5487, 5584, 5684, 6077, 6474, 6548, 6914, 7393, 7427, 7455, 7752, 7896, 7911, 8453, 8502, 8931, 9063, 9083, 9294, 9316, 9454]","[3198, 4147, 4813, 5288, 5684, 6077, 6548, 7393]","[144, 1088, 1215, 1228, 1328, 1593, 1714, 1992, 2641, 2852, 3333, 3357, 3938, 4213, 4642, 4752, 5258, 5377, 5487, 5584, 6474, 6914, 7427, 7455, 7752, 7896, 7911, 8453, 8502, 8931, 9063, 9083, 9294, 9316, 9454]","[3198, 4147, 4813, 5288, 5684, 6077, 6548, 7393]",9521,43,9478,8,35,9478,0
4.0,OALGB,"[109, 123, 374, 955, 959, 1216, 1459, 1682, 2432, 2438, 2660, 2939, 3336, 3500, 3557, 3883, 4204, 4250, 4387, 4656, 4886, 4911, 5008, 5895, 7320]","[2660, 3883, 4656]","[109, 123, 374, 955, 959, 1216, 1459, 1682, 2432, 2438, 2939, 3336, 3500, 3557, 4204, 4250, 4387, 4886, 4911, 5008, 5895, 7320]","[938, 1742, 2660, 3883, 4656]",7371,25,7346,3,22,7344,2
4.0,OAMETIAG,"[9, 205, 438, 701, 1136, 1479, 1674, 2726]","[701, 1479]","[9, 205, 438, 1136, 1674, 2726]","[701, 1479]",2792,8,2784,2,6,2784,0
4.0,OAMTIB,"[338, 444, 1721, 2041, 2170, 2554, 2983, 3016, 3175]",[1721],"[338, 444, 2041, 2170, 2554, 2983, 3016, 3175]","[965, 1721]",3211,9,3202,1,8,3201,1
4.0,OAMTIC,"[65, 381, 621, 707, 1295]","[621, 1295]","[65, 381, 707]","[621, 1295]",2375,5,2370,2,3,2370,0
4.0,OAMTII,"[326, 799, 1023, 1312, 1378, 1976]","[1023, 1378]","[326, 799, 1312, 1976]","[1023, 1378]",2047,6,2041,2,4,2041,0
4.0,OAPROTP1,[],[],[],[212],524,0,524,0,0,523,1
4.0,OATRICH,"[146, 152, 1183, 2328, 3157, 3309, 4055, 4062, 4772, 4947, 5498, 5721, 5825, 6075, 6612, 6681, 6750, 7050, 7119, 7209, 7368, 7437, 7506, 7575]",[3157],"[146, 152, 1183, 2328, 3309, 4055, 4062, 4772, 4947, 5498, 5721, 5825, 6075, 6612, 6681, 6750, 7050, 7119, 7209, 7368, 7437, 7506, 7575]",[3157],9336,24,9312,1,23,9312,0
4.0,OCAPOAIG,"[361, 553, 777, 855, 1152, 1159, 1239, 1467, 1916]","[553, 855]","[361, 777, 1152, 1159, 1239, 1467, 1916]","[553, 855]",1986,9,1977,2,7,1977,0
4.0,OCTNFBETA,"[68, 202, 390, 577]",[577],"[68, 202, 390]","[577, 766]",1963,4,1959,1,3,1958,1
4.0,OCUTGLOB,"[1576, 2050, 2144, 2162, 2281, 2680, 2700, 3077, 3172, 3357, 3424, 3496, 4176, 4265, 4529, 4900, 4912, 5062, 5072, 5207, 5317, 5831]","[3357, 5831]","[1576, 2050, 2144, 2162, 2281, 2680, 2700, 3077, 3172, 3424, 3496, 4176, 4265, 4529, 4900, 4912, 5062, 5072, 5207, 5317]","[3357, 5831]",6560,22,6538,2,20,6538,0
4.0,OOGH,"[200, 333, 768, 849, 914, 946, 1084, 1475]","[333, 1084, 1475]","[200, 768, 849, 914, 946]","[333, 740, 1084, 1475]",2154,8,2146,3,5,2145,1
4.0,OPOP1,[249],[249],[],[249],616,1,615,1,0,615,0
4.0,ORAPROTP1A,"[59, 163, 276]",[163],"[59, 276]",[163],409,3,406,1,2,406,0
4.0,PAA1GL,"[155, 185, 204, 513, 752]","[204, 513]","[155, 185, 752]","[204, 513]",872,5,867,2,3,867,0
4.0,PAAFPG,[214],[214],[],[214],1087,1,1086,1,0,1086,0
4.0,PAU03674,"[361, 1194, 1710, 1853, 2100, 2414, 3171, 3574, 4013, 4171, 4611, 4741, 5237]","[3171, 3574, 4013, 4611]","[361, 1194, 1710, 1853, 2100, 2414, 4171, 4741, 5237]","[3171, 3574, 3773, 4013, 4294, 4611]",5437,13,5424,4,9,5422,2
4.0,PIGAPAI,"[35, 62, 107, 449, 562, 794, 1031, 1051, 1129, 1156, 1819, 1823, 1918, 2317, 2367, 2693, 2917, 3317]","[794, 1129]","[35, 62, 107, 449, 562, 1031, 1051, 1156, 1819, 1823, 1918, 2317, 2367, 2693, 2917, 3317]","[794, 1129]",3325,18,3307,2,16,3307,0
4.0,PIGAPCIII,"[27, 45, 148, 620, 682, 736, 867, 944, 1141, 1432, 1711, 2031, 2083, 2639]","[1432, 1711]","[27, 45, 148, 620, 682, 736, 867, 944, 1141, 2031, 2083, 2639]","[1432, 1711]",3268,14,3254,2,12,3254,0
4.0,PIGCNP,"[400, 429, 528, 1150, 1416, 1430, 1622, 1662]",[400],"[429, 528, 1150, 1416, 1430, 1622, 1662]",[400],1886,8,1878,1,7,1878,0
4.0,PIGFSB,"[515, 589, 1598, 1801, 1849, 1885]",[515],"[589, 1598, 1801, 1849, 1885]","[515, 1042]",2043,6,2037,1,5,2036,1
4.0,PIKEGLOBIN,"[221, 237, 588, 1011, 1193, 1319]","[237, 588]","[221, 1011, 1193, 1319]","[237, 588]",1701,6,1695,2,4,1695,0
4.0,PPGLTG,"[373, 527, 662, 715, 747, 907]","[373, 662]","[527, 715, 747, 907]","[373, 662]",1064,6,1058,2,4,1058,0
4.0,PPPROP2,"[63, 576, 661]",[],"[63, 576, 661]",[319],739,3,736,0,3,735,1
4.0,PPYPROP2,"[530, 615]",[],"[530, 615]",[272],688,2,686,0,2,685,1
4.0,PTAZGLO,"[441, 840, 943, 965, 974, 1062, 1086, 1603, 1648, 1652, 1679, 1707, 1721, 1749, 1791, 1833, 1947, 1991, 2120, 2162, 2176, 2244, 2253, 2987, 3077]","[1603, 3077]","[441, 840, 943, 965, 974, 1062, 1086, 1648, 1652, 1679, 1707, 1721, 1749, 1791, 1833, 1947, 1991, 2120, 2162, 2176, 2244, 2253, 2987]","[1603, 3077]",3609,25,3584,2,23,3584,0
4.0,PTGGGLOG,"[162, 200, 545, 641, 1064, 1076]","[200, 545]","[162, 641, 1064, 1076]","[200, 545]",1814,6,1808,2,4,1808,0
4.0,PTPPINS,"[688, 728, 933, 1028, 1054, 1140, 1410, 1985, 2010]",[1410],"[688, 728, 933, 1028, 1054, 1140, 1985, 2010]",[1410],2475,9,2466,1,8,2466,0
4.0,PTPROP2,"[74, 588, 673]",[],"[74, 588, 673]",[330],750,3,747,0,3,746,1
4.0,PVU11715,"[250, 288, 633, 1021, 1340, 1368]","[288, 633]","[250, 1021, 1340, 1368]","[288, 633]",1781,6,1775,2,4,1775,0
4.0,QULNFLW,"[15, 260, 867, 961, 1222, 1548, 1667, 2169, 2301, 2364, 2405, 2425, 2461, 2703, 3329, 3794, 4139, 4443, 4656, 4817, 5192, 5612, 5849, 5873, 5894, 5921, 5972, 6211, 6672, 6808, 7385]","[3794, 4656, 5921]","[15, 260, 867, 961, 1222, 1548, 1667, 2169, 2301, 2364, 2405, 2425, 2461, 2703, 3329, 4139, 4443, 4817, 5192, 5612, 5849, 5873, 5894, 5972, 6211, 6672, 6808, 7385]","[3794, 4656, 5921]",7925,31,7894,3,28,7894,0
4.0,QULTROPIA,"[67, 240, 469, 591, 678, 689, 694, 1449, 1858, 1998, 2156, 2186, 2210, 2360, 2707, 3004, 3033, 3149, 3437, 3638, 4007, 4020, 4047, 4225, 4229, 4336, 4544, 4565, 4823]","[2186, 2360, 3004, 3437, 4047, 4336]","[67, 240, 469, 591, 678, 689, 694, 1449, 1858, 1998, 2156, 2210, 2707, 3033, 3149, 3638, 4007, 4020, 4225, 4229, 4544, 4565, 4823]","[2186, 2360, 3004, 3437, 4047, 4336]",4956,29,4927,6,23,4927,0
4.0,RABCRP,"[397, 416, 990, 1221]",[397],"[416, 990, 1221]",[397],1430,4,1426,1,3,1426,0
4.0,RABDNP3AA,"[370, 654, 742, 816, 906, 924, 995, 1030, 1865, 2156, 2435, 2483, 2540]",[2156],"[370, 654, 742, 816, 906, 924, 995, 1030, 1865, 2435, 2483, 2540]",[2156],3082,13,3069,1,12,3069,0
4.0,RABSURFA,"[378, 471, 503, 530, 636, 679, 780, 795, 928, 1038, 1431, 1539, 1642, 2209, 3239, 3423, 3443, 3447, 3550, 4033, 4361, 4584, 4636, 4857, 4987, 5088, 5622, 5899, 6219, 6359, 6529, 7268, 7344, 7760]","[4033, 4361, 5088]","[378, 471, 503, 530, 636, 679, 780, 795, 928, 1038, 1431, 1539, 1642, 2209, 3239, 3423, 3443, 3447, 3550, 4584, 4636, 4857, 4987, 5622, 5899, 6219, 6359, 6529, 7268, 7344, 7760]","[4033, 4361, 5088]",8089,34,8055,3,31,8055,0
4.0,RABTNF,"[261, 851, 1355, 1481, 1563, 1761, 1792, 2139, 2268, 3034]","[851, 1355, 1563]","[261, 1481, 1761, 1792, 2139, 2268, 3034]","[851, 1355, 1563]",3192,10,3182,3,7,3182,0
4.0,RATCYC,"[70, 362, 572, 1333, 2350]",[1333],"[70, 362, 572, 2350]",[1333],2520,5,2515,1,4,2515,0
4.0,RATCYSS,"[81, 356, 1006, 1119, 1217, 1221, 1268, 1630, 1686, 2500, 4026, 4083, 4200, 4283]","[1006, 4026]","[81, 356, 1119, 1217, 1221, 1268, 1630, 1686, 2500, 4083, 4200, 4283]","[1006, 4026]",5555,14,5541,2,12,5541,0
4.0,RATDCCOVB,"[788, 880, 1545, 1559, 1599, 1943, 2267, 2292, 2471, 2864, 3126, 3498, 3716, 3782, 4349, 5129]","[2267, 2864, 3126]","[788, 880, 1545, 1559, 1599, 1943, 2292, 2471, 3498, 3716, 3782, 4349, 5129]","[2267, 2864, 3126]",5323,16,5307,3,13,5307,0
4.0,RATGRG,"[83, 204, 286, 719, 1291, 1494, 1622, 1696, 1732, 1942, 2187, 2319, 2392, 2546, 2616, 2994, 3290, 3552, 3715, 3763]","[83, 286, 1291, 1494, 1696, 1942, 2187, 2319, 2616, 2994, 3290]","[204, 719, 1622, 1732, 2392, 2546, 3552, 3715, 3763]","[83, 286, 1291, 1494, 1696, 1942, 2187, 2319, 2616, 2994, 3290]",3880,20,3860,11,9,3860,0
4.0,RATGROS,"[621, 746, 1178, 1219, 1349, 1390, 1482, 1587, 2001, 2131]","[1178, 1390, 1587]","[621, 746, 1219, 1349, 1482, 2001, 2131]","[1178, 1390, 1587]",2488,10,2478,3,7,2478,0
4.0,RATGSTY,"[659, 718, 1310, 1495, 1862, 1959, 2060, 2086, 2830, 3003, 3022, 3180, 3225, 3376, 3576, 3804, 3854, 3958, 4115, 4691, 5009, 5214, 5813, 5926, 5995]","[659, 1495, 1862, 2060, 3180, 3376]","[718, 1310, 1959, 2086, 2830, 3003, 3022, 3225, 3576, 3804, 3854, 3958, 4115, 4691, 5009, 5214, 5813, 5926, 5995]","[659, 996, 1495, 1862, 2060, 3180, 3376]",6286,25,6261,6,19,6260,1
4.0,RATIGFBA,"[526, 850, 1002, 1242, 1381, 1455, 1788, 1948, 2034, 2203, 2240, 3002, 3105, 3828, 3873, 3924, 4362, 4512, 4546, 4620]","[526, 2034, 3002]","[850, 1002, 1242, 1381, 1455, 1788, 1948, 2203, 2240, 3105, 3828, 3873, 3924, 4362, 4512, 4546, 4620]","[526, 2034, 3002]",4992,20,4972,3,17,4972,0
4.0,RATJE,"[417, 682, 1191, 1299, 1816, 1989, 2417, 2777, 2986]","[1191, 1989]","[417, 682, 1299, 1816, 2417, 2777, 2986]","[1191, 1989]",3097,9,3088,2,7,3088,0
4.0,RATKALA,"[225, 618, 945, 992, 1062, 1275, 3167, 3282, 3753, 4061, 4424, 4476, 4652, 4709, 4729, 4734, 4826, 4915, 5334, 5689, 5818, 6007]","[1275, 3282, 4476, 4709]","[225, 618, 945, 992, 1062, 3167, 3753, 4061, 4424, 4652, 4729, 4734, 4826, 4915, 5334, 5689, 5818, 6007]","[1275, 3282, 4476, 4709]",6249,22,6227,4,18,6227,0
4.0,RATLHB,"[784, 793, 817, 825, 837, 934, 1028, 1230, 1247, 1293, 1359, 1510]","[817, 1230]","[784, 793, 825, 837, 934, 1028, 1247, 1293, 1359, 1510]","[817, 1230]",1790,12,1778,2,10,1778,0
4.0,RATLITHOST,"[2013, 2464, 2496, 2847, 3117, 3471, 3475, 3902, 4229, 4652, 4715]","[2847, 3471, 3902, 4652]","[2013, 2464, 2496, 3117, 3475, 4229, 4715]","[2847, 3471, 3902, 4652]",5399,11,5388,4,7,5388,0
4.0,RATLYSOZYM,"[38, 960, 1561, 1736, 2210, 2220, 3255, 3588, 3999, 4497, 4558, 4907, 5174, 5339, 5443, 6270, 6404, 6539]","[1561, 3255, 5174]","[38, 960, 1736, 2210, 2220, 3588, 3999, 4497, 4558, 4907, 5339, 5443, 6270, 6404, 6539]","[1561, 3255, 5174]",6732,18,6714,3,15,6714,0
4.0,RATLYSZYM,"[6, 113, 306, 323, 508, 574, 749, 1007, 1099, 1108, 1392, 1667, 2912, 3840, 4290, 4624, 5036, 5553, 5614, 5963, 6230, 6395, 6499, 7325, 7461, 7596]","[574, 4290, 6230]","[6, 113, 306, 323, 508, 749, 1007, 1099, 1108, 1392, 1667, 2912, 3840, 4624, 5036, 5553, 5614, 5963, 6395, 6499, 7325, 7461, 7596]","[574, 4290, 6230]",7943,26,7917,3,23,7917,0
4.0,RATOSCAL,"[261, 1072, 1192, 1373, 1540, 1586, 1828]","[1192, 1373, 1586]","[261, 1072, 1540, 1828]","[1192, 1373, 1586]",2119,7,2112,3,4,2112,0
4.0,RATPAP,"[624, 633, 863, 921, 1048, 1308, 1648, 1737, 1795, 2295, 3305, 3570]","[1308, 1648, 2295, 3305]","[624, 633, 863, 921, 1048, 1737, 1795, 3570]","[1308, 1648, 2295, 2604, 3305]",4863,12,4851,4,8,4850,1
4.0,RATPAPIIB,"[1916, 2291, 2298, 2332, 2532, 2701, 2751, 3021, 3387, 3473, 3587, 3817, 3834, 4107]","[2298, 3473, 4107]","[1916, 2291, 2332, 2532, 2701, 2751, 3021, 3387, 3587, 3817, 3834]","[2298, 3140, 3473, 4107]",4717,14,4703,3,11,4702,1
4.0,RATPPP,"[118, 740, 1406, 1497, 1538, 1893, 1983, 2002, 2451, 2521, 2718, 2927, 3065, 3500, 4400]",[],"[118, 740, 1406, 1497, 1538, 1893, 1983, 2002, 2451, 2521, 2718, 2927, 3065, 3500, 4400]",[2261],4534,15,4519,0,15,4518,1
4.0,RATPTBZR02,"[224, 326, 669, 673, 727, 871, 909, 1206, 1222, 1306, 1535, 1927, 2066, 2123, 2200, 2598, 2719, 2988, 3110, 3232]","[1306, 2066]","[224, 326, 669, 673, 727, 871, 909, 1206, 1222, 1535, 1927, 2123, 2200, 2598, 2719, 2988, 3110, 3232]","[1306, 2066]",3426,20,3406,2,18,3406,0
4.0,RATRGPI,"[1879, 2329, 2361, 2712, 2984, 3339, 3343, 3770, 4097, 4521, 4584]","[2712, 3339, 3770, 4521]","[1879, 2329, 2361, 2984, 3343, 4097, 4584]","[2712, 3339, 3770, 4521]",5237,11,5226,4,7,5226,0
4.0,RATRPIII,"[1226, 1601, 1608, 1642, 2017, 2067, 2337, 2456, 2704, 2790, 2905, 3135, 3152, 3426, 4044]","[1608, 2456, 2790, 3426]","[1226, 1601, 1642, 2017, 2067, 2337, 2704, 2905, 3135, 3152, 4044]","[1608, 2456, 2790, 3426]",4133,15,4118,4,11,4118,0
4.0,RATSVSIV1,"[72, 244, 659, 814, 892]",[244],"[72, 659, 814, 892]",[244],972,5,967,1,4,967,0
4.0,RATTSHB,"[260, 265, 435, 1758, 2177, 2183, 2711, 3999, 4299, 4375, 4781]",[4375],"[260, 265, 435, 1758, 2177, 2183, 2711, 3999, 4299, 4781]",[4375],5159,11,5148,1,10,5148,0
4.0,RN0B2GLOB,"[9, 31, 84, 316, 500, 558, 579, 693, 796, 1134, 1702, 1766]",[693],"[9, 31, 84, 316, 500, 558, 579, 796, 1134, 1702, 1766]","[354, 693]",1789,12,1777,1,11,1776,1
4.0,RN2BGLOB,"[264, 394, 432, 571, 629, 650, 764, 1217, 1710, 1760, 1769]","[432, 764]","[264, 394, 571, 629, 650, 1217, 1710, 1760, 1769]","[432, 764]",1876,11,1865,2,9,1865,0
4.0,RN3B2GLOB,"[84, 122, 267, 325, 346, 460, 867, 1360, 1421]","[122, 460]","[84, 267, 325, 346, 867, 1360, 1421]","[122, 460]",1436,9,1427,2,7,1427,0
4.0,RN3B3GLOB,"[75, 129, 365, 403, 546, 604, 625, 739, 1146, 1642]","[403, 739]","[75, 129, 365, 546, 604, 625, 1146, 1642]","[403, 739]",1738,10,1728,2,8,1728,0
4.0,RN3BGLOB,"[250, 288, 433, 491, 512, 626, 1028, 1522]","[288, 626]","[250, 433, 491, 512, 1028, 1522]","[288, 626]",1526,8,1518,2,6,1518,0
4.0,RNAC01,"[127, 309, 374, 513, 582, 844, 1367, 1463, 1467, 1694, 2190, 2597, 2631, 2685, 2867, 3335, 3556, 3767, 3850, 3984, 4000]","[1367, 1694, 2597, 2867]","[127, 309, 374, 513, 582, 844, 1463, 1467, 2190, 2631, 2685, 3335, 3556, 3767, 3850, 3984, 4000]","[1367, 1694, 2597, 2867]",4083,21,4062,4,17,4062,0
4.0,RNAC02,"[251, 262, 480, 636, 1368, 1475, 1787, 1820, 2138, 2180, 2243, 2561, 2681, 2759]","[1368, 1787, 2138]","[251, 262, 480, 636, 1475, 1820, 2180, 2243, 2561, 2681, 2759]","[1368, 1787, 2138, 2429, 2743]",3192,14,3178,3,11,3176,2
4.0,RNANTANT,"[62, 88, 236, 1017, 1339, 1524, 1808, 3119, 3263, 3420, 3609, 3646, 3883, 3993, 4213, 4532]","[1524, 3263, 3883]","[62, 88, 236, 1017, 1339, 1808, 3119, 3420, 3609, 3646, 3993, 4213, 4532]","[1524, 3263, 3883]",5117,16,5101,3,13,5101,0
4.0,RNAPOEG,"[459, 499, 615, 620, 1077, 1152, 1293, 1746, 1812, 1955, 2536, 2692, 2705, 2863, 2867, 2884, 3203]","[1293, 1955]","[459, 499, 615, 620, 1077, 1152, 1746, 1812, 2536, 2692, 2705, 2863, 2867, 2884, 3203]","[1293, 1955]",3229,17,3212,2,15,3212,0
4.0,RNCALBD9,"[161, 373, 469, 596, 984, 1041, 1399, 1532, 1621, 1739, 1779, 1831, 2285, 2499, 2736, 3508, 4062, 4310, 4587, 4711]",[2736],"[161, 373, 469, 596, 984, 1041, 1399, 1532, 1621, 1739, 1779, 1831, 2285, 2499, 3508, 4062, 4310, 4587, 4711]",[2736],4883,20,4863,1,19,4863,0
4.0,RNGAMT,"[497, 799, 1531, 1552, 3141, 3319, 3760, 3802, 4003, 4441, 4635, 4704, 4715, 4876]","[3141, 3319, 3760, 4003]","[497, 799, 1531, 1552, 3802, 4441, 4635, 4704, 4715, 4876]","[2173, 3141, 3319, 3760, 4003]",4956,14,4942,4,10,4941,1
4.0,RNGMTG,"[92, 440, 620, 741, 1011, 1267, 1406, 1682, 1818, 2067, 2117, 2433, 2443, 2987, 3249, 3428, 3481, 3555, 3918, 4048, 4063, 4120, 4158, 4432, 4463, 4548, 5122, 5252, 5306]","[1682, 3249, 3918, 4463]","[92, 440, 620, 741, 1011, 1267, 1406, 1818, 2067, 2117, 2433, 2443, 2987, 3428, 3481, 3555, 4048, 4063, 4120, 4158, 4432, 4548, 5122, 5252, 5306]","[1682, 3249, 3918, 4254, 4463]",5391,29,5362,4,25,5361,1
4.0,RNGROW3,"[216, 365, 471, 817, 1652, 1751, 1973]","[471, 817, 1652, 1973]","[216, 365, 1751]","[471, 817, 1652, 1973]",2549,7,2542,4,3,2542,0
4.0,RNHSC73,"[498, 522, 570, 954, 1244, 1528, 1713, 1982, 2062, 2297, 2506, 2618, 2664, 3034, 3259, 3448, 3542, 3766]","[1244, 1713, 1982, 2618, 3034, 3448, 3766]","[498, 522, 570, 954, 1528, 2062, 2297, 2506, 2664, 3259, 3542]","[1244, 1713, 1982, 2618, 3034, 3448, 3766]",4312,18,4294,7,11,4294,0
4.0,RNLALB01,"[347, 1101, 1237, 1242, 1354, 1414, 1914, 2096, 2419, 2897, 3297, 3482]","[1414, 1914, 2419]","[347, 1101, 1237, 1242, 1354, 2096, 2897, 3297, 3482]","[1414, 1914, 2419]",3812,12,3800,3,9,3800,0
4.0,RNLPKG,"[33, 102, 1729, 1911, 2062, 2169, 2183, 2847, 3195, 3374, 3634, 3949, 4321, 5806, 6284, 6457, 6605, 6805, 7192, 7321, 7818, 8078, 8286, 8465, 9121, 9142, 9414, 9480, 9838, 10935, 11648, 12180, 12937]","[3949, 6284, 6605, 7192, 7818, 8078, 9480]","[33, 102, 1729, 1911, 2062, 2169, 2183, 2847, 3195, 3374, 3634, 4321, 5806, 6457, 6805, 7321, 8286, 8465, 9121, 9142, 9414, 9838, 10935, 11648, 12180, 12937]","[3219, 3949, 6009, 6284, 6605, 7192, 7453, 7818, 8078, 9480]",13003,33,12970,7,26,12967,3
4.0,RNODC,"[115, 1097, 1279, 1339, 1344, 1554, 1568, 3174, 3305, 3525, 3618, 3918, 4182, 4517, 4698, 4953, 4982, 5631, 5650, 5825, 5851, 6291, 6350, 6412, 6582, 6692, 7326, 7755]","[3525, 3918, 4182, 4517, 4698, 4953, 5631, 5825, 6291]","[115, 1097, 1279, 1339, 1344, 1554, 1568, 3174, 3305, 3618, 4982, 5650, 5851, 6350, 6412, 6582, 6692, 7326, 7755]","[3525, 3918, 4182, 4517, 4698, 4953, 5631, 5825, 6291]",7768,28,7740,9,19,7740,0
4.0,RNP9KA,"[22, 30, 207, 248, 723, 727, 823, 910, 1227, 1612, 2118, 2220, 2224, 2311]",[1227],"[22, 30, 207, 248, 723, 727, 823, 910, 1612, 2118, 2220, 2224, 2311]",[1227],2332,14,2318,1,13,2318,0
4.0,RNPBPG,"[980, 1117, 1155, 1180, 2592, 2638, 2950, 3190, 4056]","[1117, 2950]","[980, 1155, 1180, 2592, 2638, 3190, 4056]","[1117, 2950]",6021,9,6012,2,7,6012,0
4.0,RNPGMUT,"[32, 63, 370, 1216, 1515, 1596, 1605, 1734, 1912, 2242, 2287, 2291]",[1596],"[32, 63, 370, 1216, 1515, 1605, 1734, 1912, 2242, 2287, 2291]","[1596, 1872]",2420,12,2408,1,11,2407,1
4.0,RNPROST22,"[45, 237, 438, 444, 499, 528, 733, 876, 1262, 2200, 2321, 3647, 3835, 3841, 3916, 4048, 4526, 4727, 4820, 5680, 6009, 6680, 7004, 7412]","[876, 3647, 4526]","[45, 237, 438, 444, 499, 528, 733, 1262, 2200, 2321, 3835, 3841, 3916, 4048, 4727, 4820, 5680, 6009, 6680, 7004, 7412]","[876, 3647, 4526]",7667,24,7643,3,21,7643,0
4.0,RNREVSV2A,"[12, 67, 121, 290, 848, 1201, 1341]",[67],"[12, 121, 290, 848, 1201, 1341]","[67, 1304]",1730,7,1723,1,6,1722,1
4.0,RNSDHG,"[177, 199, 285, 290, 379, 1376, 1536, 1777, 1993, 2205, 2697, 3035, 3480, 3554, 4077, 4179, 4705, 5079, 5590, 5691, 5866, 6052, 6095, 6253, 6479, 6576, 6877, 6984, 7081, 7600, 8014, 8314, 8671, 9541]","[5691, 6052, 6253, 6984, 8671]","[177, 199, 285, 290, 379, 1376, 1536, 1777, 1993, 2205, 2697, 3035, 3480, 3554, 4077, 4179, 4705, 5079, 5590, 5866, 6095, 6479, 6576, 6877, 7081, 7600, 8014, 8314, 9541]","[4640, 5691, 6052, 6253, 6984, 8671]",9570,34,9536,5,29,9535,1
4.0,RNSVFG,"[213, 500, 636, 670, 1018, 1250, 1267, 1347]",[500],"[213, 636, 670, 1018, 1250, 1267, 1347]",[500],1841,8,1833,1,7,1833,0
4.0,RNTHYCSG,"[68, 318, 326, 355, 679, 1071, 1906, 2271]","[68, 1071]","[318, 326, 355, 679, 1906, 2271]","[68, 1071]",2855,8,2847,2,6,2847,0
4.0,RNU03551,"[64, 219, 584, 715, 766, 832, 1545, 1969, 2115, 2183, 2263, 2418, 3083, 3176, 3226, 3360]","[832, 2418, 3083]","[64, 219, 584, 715, 766, 1545, 1969, 2115, 2183, 2263, 3176, 3226, 3360]","[832, 2418, 3083]",3590,16,3574,3,13,3574,0
4.0,RNU09193,"[402, 438, 469, 1727, 2084, 2295, 2630, 2749, 3084, 3600, 3612, 3787, 3899, 3910]","[2084, 2749, 3084, 3787]","[402, 438, 469, 1727, 2295, 2630, 3600, 3612, 3899, 3910]","[2084, 2749, 3084, 3787]",4187,14,4173,4,10,4173,0
4.0,RNU12250,"[293, 325, 473, 1704, 1708]","[293, 473]","[325, 1704, 1708]","[293, 473]",1863,5,1858,2,3,1858,0
4.0,RNUCPG,"[112, 255, 848, 1396, 1663, 1834, 1881, 2382, 2428, 2812, 3539, 3598, 3801, 4187, 4310, 4818, 4822, 4896, 4965, 5157, 5677, 5744, 6018, 6121, 6426, 6470, 6660, 6983, 7395, 7852, 8157, 8180, 9172, 9441, 10198, 10292, 10300, 10603, 10871, 11061, 11092, 11481, 11722]","[4310, 5157, 8157]","[112, 255, 848, 1396, 1663, 1834, 1881, 2382, 2428, 2812, 3539, 3598, 3801, 4187, 4818, 4822, 4896, 4965, 5677, 5744, 6018, 6121, 6426, 6470, 6660, 6983, 7395, 7852, 8180, 9172, 9441, 10198, 10292, 10300, 10603, 10871, 11061, 11092, 11481, 11722]","[4310, 5157, 7964, 8157, 9401]",12496,43,12453,3,40,12451,2
4.0,RNVEGP1,"[305, 926, 1043, 1156, 1262, 1286, 1629, 1635, 1834, 1994, 2076, 2108, 2777, 3032, 3940, 4037, 4126, 4140, 4452, 4844, 4962, 5195, 5630, 5948]","[1262, 1834, 3032, 4037]","[305, 926, 1043, 1156, 1286, 1629, 1635, 1994, 2076, 2108, 2777, 3940, 4126, 4140, 4452, 4844, 4962, 5195, 5630, 5948]","[1262, 1834, 3032, 4037, 4611]",5948,24,5924,4,20,5923,1
4.0,RNVEGP2C,"[430, 1041, 1159, 1272, 1378, 1402, 1745, 1751, 1950, 2105, 2182, 2213, 2875, 3128, 4146, 4671, 4960, 5078, 5566]","[1378, 1950, 3128, 4146]","[430, 1041, 1159, 1272, 1402, 1745, 1751, 2105, 2182, 2213, 2875, 4671, 4960, 5078, 5566]","[1378, 1950, 3128, 4146, 4723]",5742,19,5723,4,15,5722,1
4.0,RRU04320,"[838, 1077, 1105, 1126, 1538, 2008, 2107, 2118, 2500, 2592, 2606, 3080, 3301, 3412, 3643, 4216, 5366, 5456]","[2500, 3643]","[838, 1077, 1105, 1126, 1538, 2008, 2107, 2118, 2592, 2606, 3080, 3301, 3412, 4216, 5366, 5456]","[2500, 3643]",6798,18,6780,2,16,6780,0
4.0,S46763,"[186, 479, 535, 777, 1235, 1252, 1406, 1690, 1787, 2111, 2487, 2775, 2946, 3209, 3245, 3278, 3563, 3954, 4052, 4358, 4424, 4801, 5060, 5469, 6880, 7334, 7349, 8012, 8056, 8294, 8344]","[1235, 2487, 2775, 4052, 5060, 5469, 6880, 7334, 8012, 8294]","[186, 479, 535, 777, 1252, 1406, 1690, 1787, 2111, 2946, 3209, 3245, 3278, 3563, 3954, 4358, 4424, 4801, 7349, 8056, 8344]","[1235, 2487, 2775, 4052, 4528, 5060, 5469, 6880, 7334, 8012, 8294]",10035,31,10004,10,21,10003,1
4.0,S49651,"[246, 471, 823, 1117, 1652, 2378, 2476, 3255, 3571, 3856, 4137, 4577]","[1652, 3255, 4137]","[246, 471, 823, 1117, 2378, 2476, 3571, 3856, 4577]","[1652, 2786, 3255, 4137]",5440,12,5428,3,9,5427,1
4.0,S57980,"[44, 236, 437, 443, 498, 527, 732, 875, 1261, 2198, 2319, 3645, 3833, 3839, 3914, 4046, 4524, 4725, 4818, 5678, 6007, 6678, 7002, 7410]","[875, 3645, 4524]","[44, 236, 437, 443, 498, 527, 732, 1261, 2198, 2319, 3833, 3839, 3914, 4046, 4725, 4818, 5678, 6007, 6678, 7002, 7410]","[875, 3645, 4524]",7665,24,7641,3,21,7641,0
4.0,S62287,"[190, 570, 1266, 1673, 1965, 2535, 2619, 3108]",[1266],"[190, 570, 1673, 1965, 2535, 2619, 3108]",[1266],3425,8,3417,1,7,3417,0
4.0,S63697,"[280, 829]","[280, 829]",[],"[280, 829]",1331,2,1329,2,0,1329,0
4.0,S66606,"[152, 238, 340, 1076, 1875, 2506, 2706, 3675, 3723, 3899, 3982, 4067, 4530, 4598, 4706, 5644, 5958, 6167]","[2506, 2706, 3899, 4598]","[152, 238, 340, 1076, 1875, 3675, 3723, 3982, 4067, 4530, 4706, 5644, 5958, 6167]","[2506, 2706, 3899, 4598]",6359,18,6341,4,14,6341,0
4.0,S67057,"[83, 98, 322, 840]",[840],"[83, 98, 322]",[840],1746,4,1742,1,3,1742,0
4.0,S69277,"[142, 207, 1706, 1967, 2058, 2074, 2103, 3098, 3229, 3316, 3521, 3723, 3839, 4103, 4385, 4556, 4726, 4852]","[3098, 3316, 3521, 3839, 4103]","[142, 207, 1706, 1967, 2058, 2074, 2103, 3229, 3723, 4385, 4556, 4726, 4852]","[3098, 3316, 3521, 3839, 4103]",5516,18,5498,5,13,5498,0
4.0,S69278,"[84, 279, 323, 547, 846, 861, 1184, 1402, 1500, 1529, 2590, 2739, 2826, 3031, 3231, 3347, 3561, 3832, 4174, 4236]","[2590, 2826, 3031, 3347, 3561]","[84, 279, 323, 547, 846, 861, 1184, 1402, 1500, 1529, 2739, 3231, 3832, 4174, 4236]","[2590, 2826, 3031, 3347, 3561]",5015,20,4995,5,15,4995,0
4.0,S69350,"[235, 566, 1866, 2149]",[235],"[566, 1866, 2149]",[235],2152,4,2148,1,3,2148,0
4.0,SAIEGLOBIM,"[221, 237, 346, 588, 604, 983, 1317, 1329, 1444]","[237, 588]","[221, 346, 604, 983, 1317, 1329, 1444]","[237, 588]",1826,9,1817,2,7,1817,0
4.0,SMIGCU,"[696, 799, 911, 1233, 1631, 1779, 1946, 2139, 2173, 2624]","[799, 1233, 1631]","[696, 911, 1779, 1946, 2139, 2173, 2624]","[799, 1233, 1631]",2833,10,2823,3,7,2823,0
4.0,SMNPRP1A,[215],[215],[],[215],623,1,622,1,0,622,0
4.0,SOEEGLOBIN,"[17, 220, 236, 344, 586, 602, 1183, 1195, 1310]","[236, 586]","[17, 220, 344, 602, 1183, 1195, 1310]","[236, 586]",1688,9,1679,2,7,1679,0
4.0,SSBAT1G,"[260, 482, 518, 1316, 1344, 1471, 1681, 1843, 2215, 2323, 2425, 2582, 2592, 2610, 2616, 2716, 2814, 2990, 3837, 4001, 4538, 4875, 5527, 6021, 6104, 6390, 6533, 6678, 6735, 6908, 7799, 8238, 8708, 8767, 9144, 9674]","[1316, 2215, 2582, 4538, 8238, 9144, 9674]","[260, 482, 518, 1344, 1471, 1681, 1843, 2323, 2425, 2592, 2610, 2616, 2716, 2814, 2990, 3837, 4001, 4875, 5527, 6021, 6104, 6390, 6533, 6678, 6735, 6908, 7799, 8708, 8767]","[1316, 2215, 2582, 4538, 5771, 8238, 9144, 9388, 9674]",10666,36,10630,7,29,10628,2
4.0,SSIKBAGE,"[60, 788, 956, 1247, 1729, 2377, 2469, 2528, 3151, 3334, 3620, 3713, 3766, 3954, 4091, 4470, 5251, 5628]","[2469, 3151, 3713, 4091, 4470]","[60, 788, 956, 1247, 1729, 2377, 2528, 3334, 3620, 3766, 3954, 5251, 5628]","[2469, 3151, 3713, 4091, 4470]",5756,18,5738,5,13,5738,0
4.0,SSPINT1B,"[88, 185, 1081, 1615, 1933, 2127, 2551, 2673, 2759, 3399, 3407, 3903, 4582, 4793, 5245, 6247, 6605, 6609, 6774, 6790, 7761, 8049, 8246, 8448, 8541, 8611]","[2551, 3903, 5245, 6605]","[88, 185, 1081, 1615, 1933, 2127, 2673, 2759, 3399, 3407, 4582, 4793, 6247, 6609, 6774, 6790, 7761, 8049, 8246, 8448, 8541, 8611]","[1971, 2551, 3903, 5245, 6605]",8743,26,8717,4,22,8716,1
4.0,TAPROTP1,[],[],[],[230],547,0,547,0,0,546,1
4.0,TARHBE,"[76, 103, 119, 400, 465]","[119, 465]","[76, 103, 400]","[119, 465]",1682,5,1677,2,3,1677,0
4.0,TARHBG,"[58, 227, 265, 608, 704, 1032, 1217, 1488, 1822, 2059, 2072]",[265],"[58, 227, 608, 704, 1032, 1217, 1488, 1822, 2059, 2072]","[265, 612]",2139,11,2128,1,10,2127,1
4.0,TFLPA2P1,"[266, 272, 374, 596, 650, 972, 1293, 1311, 1749, 1848, 2035, 2108, 2495]","[596, 972, 1749]","[266, 272, 374, 650, 1293, 1311, 1848, 2035, 2108, 2495]","[596, 972, 1749]",2708,13,2695,3,10,2695,0
4.0,TFLPA2P2,"[266, 368, 590, 644, 900, 935, 966, 1017, 1286, 1304, 1565, 1783, 1882, 2072]","[590, 966, 1783]","[266, 368, 644, 900, 935, 1017, 1286, 1304, 1565, 1882, 2072]","[590, 966, 1783]",2431,14,2417,3,11,2417,0
4.0,TFLPA2P3,"[266, 272, 374, 596, 650, 972, 1293, 1311, 1749, 1848, 2035, 2108, 2495]","[596, 972, 1749]","[266, 272, 374, 650, 1293, 1311, 1848, 2035, 2108, 2495]","[596, 972, 1749]",2708,13,2695,3,10,2695,0
4.0,TFLPA2P4,"[266, 368, 590, 644, 900, 935, 966, 1017, 1286, 1304, 1565, 1783, 1882, 2072]","[590, 966, 1783]","[266, 368, 644, 900, 935, 1017, 1286, 1304, 1565, 1882, 2072]","[590, 966, 1783]",2431,14,2417,3,11,2417,0
4.0,TGLHBB,"[155, 519, 888, 1106, 1256, 1742, 2034, 2233]","[519, 888]","[155, 1106, 1256, 1742, 2034, 2233]","[519, 888]",2300,8,2292,2,6,2292,0
4.0,TIOPRP1A,"[212, 233]",[212],[233],[212],556,2,554,1,1,554,0
4.0,U00432,"[237, 793, 975, 1101, 1203, 1312, 1459]","[237, 793, 1101, 1312]","[975, 1203, 1459]","[83, 237, 793, 1101, 1312]",1575,7,1568,4,3,1567,1
4.0,U00433,"[83, 267, 752, 936, 1245, 1270, 1424]","[83, 267, 752, 1270]","[936, 1245, 1424]","[83, 267, 752, 1062, 1270]",1545,7,1538,4,3,1537,1
4.0,U00454,"[131, 772, 849, 1031, 1062, 1090, 1263, 1598, 1631, 1749, 1967, 2071, 2382, 2781, 3464, 3905, 4179, 4328, 4529, 4824, 4862, 5011, 5303, 5625, 5820, 6782, 6800, 6887, 7057]","[1598, 4862]","[131, 772, 849, 1031, 1062, 1090, 1263, 1631, 1749, 1967, 2071, 2382, 2781, 3464, 3905, 4179, 4328, 4529, 4824, 5011, 5303, 5625, 5820, 6782, 6800, 6887, 7057]","[1598, 4862]",7192,29,7163,2,27,7163,0
4.0,U00938,"[60, 71, 102, 247, 556, 832, 912, 1169, 1454, 1465, 2179, 2207, 2611, 2715, 2719, 2824, 3017, 3079, 3311, 3617, 3702, 4070, 5155, 5202, 5261, 5640, 5809, 5962, 6482]","[1169, 4070, 5155]","[60, 71, 102, 247, 556, 832, 912, 1454, 1465, 2179, 2207, 2611, 2715, 2719, 2824, 3017, 3079, 3311, 3617, 3702, 5202, 5261, 5640, 5809, 5962, 6482]","[1169, 4070, 5155]",6780,29,6751,3,26,6751,0
4.0,U01026,"[52, 492, 1153, 1364, 1419, 1746, 1927, 2071, 2316, 2537, 2636, 2760, 2826]","[1364, 1746, 2537]","[52, 492, 1153, 1419, 1927, 2071, 2316, 2636, 2760, 2826]","[1364, 1746, 2537]",3216,13,3203,3,10,3203,0
4.0,U01027,"[248, 357, 571, 625, 947, 1128, 1272, 1290, 1710, 1809, 1999, 2740]","[571, 947, 1710]","[248, 357, 625, 1128, 1272, 1290, 1809, 1999, 2740]","[571, 947, 1710]",2761,12,2749,3,9,2749,0
4.0,U01844,"[64, 476, 623, 684, 1307, 1472, 1559, 1589, 1770, 1919, 1986, 2090, 2395, 2474, 2585, 2653, 3211, 3256, 3403, 3781, 3843]","[1986, 2474, 2653, 3211]","[64, 476, 623, 684, 1307, 1472, 1559, 1589, 1770, 1919, 2090, 2395, 2585, 3256, 3403, 3781, 3843]","[1986, 2141, 2474, 2653, 3211]",4219,21,4198,4,17,4197,1
4.0,XELCRPGA,"[285, 726, 842, 892, 1096, 1871, 2377, 2504, 2961, 3338, 3794]",[1096],"[285, 726, 842, 892, 1871, 2377, 2504, 2961, 3338, 3794]",[1096],3891,11,3880,1,10,3880,0
4.0,XELCRYB,"[162, 196, 592, 605, 706, 945, 1326, 1500]","[706, 1326]","[162, 196, 592, 605, 945, 1500]","[706, 1326]",2049,8,2041,2,6,2041,0
4.0,XELHBBC,"[263, 678, 715, 1418, 1832, 1844]","[263, 678]","[715, 1418, 1832, 1844]","[263, 678]",1981,6,1975,2,4,1975,0
4.0,XLACTA,"[553, 1260, 1349, 2591, 3422, 3815, 3868, 4138, 4592, 4845, 4946, 4961, 5128, 5338, 5509, 5898]","[2591, 3868, 4138, 4845, 5128]","[553, 1260, 1349, 3422, 3815, 4592, 4946, 4961, 5338, 5509, 5898]","[2591, 3868, 4138, 4845, 5128]",5946,16,5930,5,11,5930,0
4.0,XLACTCAG,"[831, 855, 1600, 1638, 2094, 2473, 3023, 3128, 3298, 3302, 3561, 3614, 4769, 4931, 5562, 6279, 6461, 7511, 7853, 8347, 8410, 8892]","[2473, 3614, 4931, 5562, 6461]","[831, 855, 1600, 1638, 2094, 3023, 3128, 3298, 3302, 3561, 4769, 6279, 7511, 7853, 8347, 8410, 8892]","[2473, 3614, 4931, 5562, 6461]",8900,22,8878,5,17,8878,0
4.0,XLBGL3,"[388, 1175, 1851, 2443]","[388, 1175]","[1851, 2443]","[388, 1175]",2964,4,2960,2,2,2960,0
4.0,XLGLAA1,"[137, 502, 559, 590]","[137, 502]","[559, 590]","[137, 502]",1192,4,1188,2,2,1188,0
4.0,XLGLAA2,"[138, 519, 586, 601, 1163]","[138, 519]","[586, 601, 1163]","[138, 519]",1192,5,1187,2,3,1187,0
4.0,XLK81A1G,"[1517, 1618, 1671, 2294, 2734, 2900, 3026, 3145, 3240, 3409, 3531, 3647, 3849, 4127, 4170, 4425, 4769, 5223, 5318, 5672]","[2294, 2734, 3026, 3531, 3849, 4170]","[1517, 1618, 1671, 2900, 3145, 3240, 3409, 3647, 4127, 4425, 4769, 5223, 5318, 5672]","[1759, 2294, 2734, 3026, 3531, 3849, 4170]",5892,20,5872,6,14,5871,1
4.0,XLRPL14,"[912, 1292, 1499, 1601, 1837, 2087, 2140, 2145, 2624, 3051, 3085, 3651, 3897, 5232, 5356, 5856, 6146, 6485, 6804, 7158, 7239, 7618, 7840, 7904, 8659, 9072]","[912, 2087, 5356, 7904]","[1292, 1499, 1601, 1837, 2140, 2145, 2624, 3051, 3085, 3651, 3897, 5232, 5856, 6146, 6485, 6804, 7158, 7239, 7618, 7840, 8659, 9072]","[912, 1891, 2087, 4978, 5356, 7904]",9116,26,9090,4,22,9088,2
4.0,XLRPL1AG,"[308, 339, 512, 634, 1078, 2105, 2121, 2638, 2695, 2818, 3735, 3831, 3844, 4433, 4573, 4994, 5179, 5232, 5303, 5643, 5757, 6206, 6451]","[512, 2121, 2818, 3831, 4573, 5179, 5757]","[308, 339, 634, 1078, 2105, 2638, 2695, 3735, 3844, 4433, 4994, 5232, 5303, 5643, 6206, 6451]","[512, 2121, 2438, 2818, 3137, 3831, 4573, 5179, 5757]",6949,23,6926,7,16,6924,2
4.0,XLS8,"[164, 692, 804, 1006, 1530, 1867, 1874, 2032, 2326, 2865, 2893, 3505, 3938, 3963, 4181, 4856, 5432, 5708, 5849, 5912, 6119, 6325, 6381, 6468, 6931, 7181, 7381, 8071, 8411, 8542, 9259, 9832, 9886, 10366, 10822, 12388, 12527, 12978]","[2032, 3938, 5912, 7381]","[164, 692, 804, 1006, 1530, 1867, 1874, 2326, 2865, 2893, 3505, 3963, 4181, 4856, 5432, 5708, 5849, 6119, 6325, 6381, 6468, 6931, 7181, 8071, 8411, 8542, 9259, 9832, 9886, 10366, 10822, 12388, 12527, 12978]","[2032, 3938, 5912, 7381, 12177]",13512,38,13474,4,34,13473,1
4.0,XLTUBAG,"[272, 591, 595, 678, 1280, 1323, 1541, 1613, 2006, 2020, 2440, 2610, 3094, 3268, 4024, 4179, 4224, 4401, 4775, 4898, 5039, 5214, 5431, 5575, 6312, 6604, 6612, 6618, 6630, 6686]","[678, 4401, 5575]","[272, 591, 595, 1280, 1323, 1541, 1613, 2006, 2020, 2440, 2610, 3094, 3268, 4024, 4179, 4224, 4775, 4898, 5039, 5214, 5431, 6312, 6604, 6612, 6618, 6630, 6686]","[678, 4401, 5575]",6888,30,6858,3,27,6858,0
4.0,XLXANF1A,"[1460, 1960, 2647, 2706, 4595]","[1460, 1960, 2706]","[2647, 4595]","[1460, 1960, 2706]",4878,5,4873,3,2,4873,0
4.0,XTGLA,"[235, 419, 731, 1323, 1752, 2034, 2838, 2861, 3340, 3493, 4013, 4344, 4437]","[731, 2838]","[235, 419, 1323, 1752, 2034, 2861, 3340, 3493, 4013, 4344, 4437]","[731, 2838]",4838,13,4825,2,11,4825,0
4.0,XTGLAA,"[416, 541, 1036, 1411]","[1036, 1411]","[416, 541]","[1036, 1411]",1992,4,1988,2,2,1988,0
4.0,XTGLB,"[21, 212, 389, 1823, 2384, 2643, 2836, 3539, 4034]","[2384, 2836]","[21, 212, 389, 1823, 2643, 3539, 4034]","[2384, 2836]",4043,9,4034,2,7,4034,0
4.0,ZEFB2MICB,"[304, 1187, 1345]","[304, 1187]",[1345],"[304, 1187]",2193,3,2190,2,1,2190,0
