Threshold,Locus,Predict Sites,Positive Sites,Negative Sites,Actual Donor Sites,Predict Num,Predict Positive Num,Predict Negative Num,TP,FP,TN,FN
3.5,ACU08131,"[322, 463, 642, 710, 845, 1024, 1255, 1363, 1603, 1735, 2029, 2179, 2245, 2350, 2498, 2598, 2803, 2840, 3042, 3336, 3798, 3914, 4038, 4306, 4512, 5170, 5176, 5313, 5324]","[642, 1363, 2029, 2803, 3798]","[322, 463, 710, 845, 1024, 1255, 1603, 1735, 2179, 2245, 2350, 2498, 2598, 2840, 3042, 3336, 3914, 4038, 4306, 4512, 5170, 5176, 5313, 5324]","[642, 1363, 2029, 2803, 3798]",5384,29,5355,5,24,5355,0
3.5,AGGGLINE,"[32, 70, 805, 869, 935, 1571, 2325, 2347, 2658, 2946, 2963, 3120, 3158, 3390, 3457, 3504, 3600, 3850, 4035, 4253, 4309, 4685, 5259, 5585, 5648, 6262, 6387, 6421, 7054]","[3158, 3504]","[32, 70, 805, 869, 935, 1571, 2325, 2347, 2658, 2946, 2963, 3120, 3390, 3457, 3600, 3850, 4035, 4253, 4309, 4685, 5259, 5585, 5648, 6262, 6387, 6421, 7054]","[3158, 3504]",7220,29,7191,2,27,7191,0
3.5,AGU04852,"[86, 183, 491, 536, 631, 653, 734, 1104, 1464, 2073, 2117, 2302, 2478, 2972, 3116, 3176, 3402, 3693, 3788, 3877, 3956, 4566, 4701, 4809, 4863, 4906, 5517, 5529, 5533, 5876, 5912, 6224, 6383, 6740, 7509, 7636, 7927, 7960, 8085, 8252, 8301, 8354, 8358, 8635, 8694, 8817, 8877, 8934, 8961, 9261, 9622, 9856, 10812, 10820, 10961]","[3956, 5517, 5912, 6740]","[86, 183, 491, 536, 631, 653, 734, 1104, 1464, 2073, 2117, 2302, 2478, 2972, 3116, 3176, 3402, 3693, 3788, 3877, 4566, 4701, 4809, 4863, 4906, 5529, 5533, 5876, 6224, 6383, 7509, 7636, 7927, 7960, 8085, 8252, 8301, 8354, 8358, 8635, 8694, 8817, 8877, 8934, 8961, 9261, 9622, 9856, 10812, 10820, 10961]","[3956, 5517, 5912, 6740]",10976,55,10921,4,51,10921,0
3.5,ALOEGLOBIM,"[221, 237, 469, 583, 599, 1049, 1170, 1182, 1250, 1297]","[237, 583]","[221, 469, 599, 1049, 1170, 1182, 1250, 1297]","[237, 583]",1683,10,1673,2,8,1673,0
3.5,ALOEGLOBIN,"[221, 237, 469, 583, 599, 1049, 1170, 1182, 1250, 1297]","[237, 583]","[221, 469, 599, 1049, 1170, 1182, 1250, 1297]","[237, 583]",1683,10,1673,2,8,1673,0
3.5,ALOPROTP1A,"[59, 166, 267]",[166],"[59, 267]",[166],410,3,407,1,2,407,0
3.5,AMU12024,"[257, 632, 667, 872, 1583, 1594, 1695, 1864, 1960, 2013, 2126, 2482, 2605, 2685, 3458, 3606]","[257, 667, 1864, 2126, 2482]","[632, 872, 1583, 1594, 1695, 1960, 2013, 2605, 2685, 3458, 3606]","[257, 667, 1864, 2126, 2482]",3644,16,3628,5,11,3628,0
3.5,AMU12025,"[271, 527, 859, 1080, 1412, 1830, 2010, 2485, 2654, 2689, 2705, 2736, 2789, 2902, 3278, 3313, 3343, 4481]","[1412, 1830, 2654, 2902, 3278]","[271, 527, 859, 1080, 2010, 2485, 2689, 2705, 2736, 2789, 3313, 3343, 4481]","[1412, 1830, 2654, 2902, 3278]",5375,18,5357,5,13,5357,0
3.5,AOIRHODOPS,"[141, 255, 620, 894, 1314, 1702, 1749, 1953, 1969, 2025, 2754, 3012, 4005, 4067, 4336, 4385, 4430, 4479, 4840, 4953, 5116, 5373, 5452, 6243, 6372, 7039, 7056, 7580, 7600, 7622, 7630, 7800, 8003, 8308, 8837, 9057, 9133, 9304]","[1702, 4067, 5373, 6243]","[141, 255, 620, 894, 1314, 1749, 1953, 1969, 2025, 2754, 3012, 4005, 4336, 4385, 4430, 4479, 4840, 4953, 5116, 5452, 6372, 7039, 7056, 7580, 7600, 7622, 7630, 7800, 8003, 8308, 8837, 9057, 9133, 9304]","[1702, 4067, 5373, 6243]",9915,38,9877,4,34,9877,0
3.5,ASPROP2,"[75, 589]",[],"[75, 589]",[325],664,2,662,0,2,661,1
3.5,ASYRVISP,"[99, 260, 625, 634, 656, 1042, 1166, 1305, 1335, 1419, 1585, 1916, 2021]","[625, 1042, 1335, 1585, 1916]","[99, 260, 634, 656, 1166, 1305, 1419, 2021]","[625, 1042, 1335, 1585, 1916]",2221,13,2208,5,8,2208,0
3.5,ATREGLOBIN,"[221, 237, 474, 588, 604, 1187, 1267, 1295, 1314]","[237, 588]","[221, 474, 604, 1187, 1267, 1295, 1314]","[237, 588]",1691,9,1682,2,7,1682,0
3.5,BABAPOE,"[33, 60, 198, 267, 481, 550, 897, 1080, 1374, 1702, 1953, 2109, 2262, 2803, 2847, 2881, 3852, 3916, 3978, 3999, 4131]","[897, 2847]","[33, 60, 198, 267, 481, 550, 1080, 1374, 1702, 1953, 2109, 2262, 2803, 2881, 3852, 3916, 3978, 3999, 4131]","[897, 2847]",4754,21,4733,2,19,4733,0
3.5,BATROX,"[222, 341, 875, 1839, 2032, 2078, 2428, 2446, 2890, 2959, 3011, 3556, 3593, 3849, 3924, 3967, 3975, 4110, 4276, 4495, 4705, 4836, 5035, 5085, 5123, 5790, 6449, 6789, 6874, 6955, 7378, 7567, 7655, 7992]","[341, 3011, 5035, 6955]","[222, 875, 1839, 2032, 2078, 2428, 2446, 2890, 2959, 3556, 3593, 3849, 3924, 3967, 3975, 4110, 4276, 4495, 4705, 4836, 5085, 5123, 5790, 6449, 6789, 6874, 7378, 7567, 7655, 7992]","[341, 3011, 5035, 6955]",8092,34,8058,4,30,8058,0
3.5,BCHEGLOBIN,"[221, 237, 469, 583, 599, 1060, 1184, 1196, 1264, 1311]","[237, 583]","[221, 469, 599, 1060, 1184, 1196, 1264, 1311]","[237, 583]",1697,10,1687,2,8,1687,0
3.5,BOVANPA,"[334, 433, 858]","[433, 858]",[334],"[433, 858]",1761,3,1758,2,1,1758,0
3.5,BOVCOX7AL,"[679, 936, 1056, 1484, 1497, 1501, 1540, 1826, 2141, 2351, 2432, 2470, 2630, 2812, 2867, 2874, 3003, 3328, 3627, 3721, 3969, 4284, 4555, 5049, 5521, 5934, 6089, 6167]","[1540, 2812, 5049]","[679, 936, 1056, 1484, 1497, 1501, 1826, 2141, 2351, 2432, 2470, 2630, 2867, 2874, 3003, 3328, 3627, 3721, 3969, 4284, 4555, 5521, 5934, 6089, 6167]","[1540, 2812, 5049]",6848,28,6820,3,25,6820,0
3.5,BOVGAS,"[192, 406, 751, 806, 996]",[751],"[192, 406, 806, 996]",[751],1058,5,1053,1,4,1053,0
3.5,BOVIAP,"[174, 437, 457, 533, 602, 926, 1116, 1318, 1568, 1764, 1835, 1895, 1994, 2033, 2057, 2107, 2159, 2200, 2269, 2354, 2504, 2756, 2784, 2793, 2864, 2999, 3092, 3352, 3392, 3440, 3535, 3667, 3782, 3844, 3996, 4024, 4731, 5074, 5262]","[1568, 1764, 1994, 2354, 2999, 3392, 3667, 3996]","[174, 437, 457, 533, 602, 926, 1116, 1318, 1835, 1895, 2033, 2057, 2107, 2159, 2200, 2269, 2504, 2756, 2784, 2793, 2864, 3092, 3352, 3440, 3535, 3782, 3844, 4024, 4731, 5074, 5262]","[1568, 1764, 1994, 2354, 2606, 2999, 3157, 3392, 3667, 3996]",5391,39,5352,8,31,5350,2
3.5,BOVIRBP,"[129, 552, 936, 994, 1284, 1509, 1812, 2388, 2586, 2649, 2769, 2928, 3090, 3174, 3723, 3801, 4176, 4212, 4571, 4806, 4970, 4983, 5048, 5349, 5507, 5595, 5643, 5761, 6214, 6494, 6540, 6779, 7416, 7669, 7699, 7773, 8920, 8937, 9190, 9309, 9959, 10082, 10443, 10749, 10841, 10997, 11020]","[3174, 5595, 7699]","[129, 552, 936, 994, 1284, 1509, 1812, 2388, 2586, 2649, 2769, 2928, 3090, 3723, 3801, 4176, 4212, 4571, 4806, 4970, 4983, 5048, 5349, 5507, 5643, 5761, 6214, 6494, 6540, 6779, 7416, 7669, 7773, 8920, 8937, 9190, 9309, 9959, 10082, 10443, 10749, 10841, 10997, 11020]","[3174, 5595, 7699]",11785,47,11738,3,44,11738,0
3.5,BOVLHB,"[244, 592, 749, 761, 803, 875, 944, 1062, 1272, 1401, 1460]","[803, 1272]","[244, 592, 749, 761, 875, 944, 1062, 1401, 1460]","[803, 1272]",1856,11,1845,2,9,1845,0
3.5,BOVLYSOZMA,"[70, 322, 397, 944, 2115, 2268, 2374, 2819, 2872, 2973, 3039, 3078, 3208, 3255, 3424, 3672, 4100, 4372, 4417, 4694, 5256, 5771, 5955, 6973, 7260, 7512, 7928, 8632, 8654, 9247, 9304, 9453, 9603, 10062, 10777, 10799]","[3039, 5771, 8654]","[70, 322, 397, 944, 2115, 2268, 2374, 2819, 2872, 2973, 3078, 3208, 3255, 3424, 3672, 4100, 4372, 4417, 4694, 5256, 5955, 6973, 7260, 7512, 7928, 8632, 9247, 9304, 9453, 9603, 10062, 10777, 10799]","[3039, 5771, 8654]",12214,36,12178,3,33,12178,0
3.5,BOVLYSOZMB,"[140, 461, 646, 739, 1229, 1662, 1890, 1993, 2453, 2506, 2607, 2673, 2843, 3007, 3717, 3743, 4005, 4135, 4797, 5148, 5241, 5594, 5708, 5732, 6190, 6212, 6807, 6895, 6917, 6928, 7058, 7511, 8354, 9580, 10002]","[2673, 4005, 6212]","[140, 461, 646, 739, 1229, 1662, 1890, 1993, 2453, 2506, 2607, 2843, 3007, 3717, 3743, 4135, 4797, 5148, 5241, 5594, 5708, 5732, 6190, 6807, 6895, 6917, 6928, 7058, 7511, 8354, 9580, 10002]","[2673, 4005, 6212]",10204,35,10169,3,32,10169,0
3.5,BOVLYSOZMC,"[304, 685, 738, 839, 905, 1086, 1274, 2107, 2323, 2933, 3388, 4172, 4194, 4908, 4941, 4964, 5325, 6235, 6245, 6302]","[905, 2323, 4194]","[304, 685, 738, 839, 1086, 1274, 2107, 2933, 3388, 4172, 4908, 4941, 4964, 5325, 6235, 6245, 6302]","[905, 2323, 4194]",8043,20,8023,3,17,8023,0
3.5,BOVMYF5A,"[273, 698, 1398, 1433, 1446, 1463, 1625, 1824, 1852, 2273, 2895, 3199, 3272, 3947, 4171, 4402, 4583, 4629, 4851]","[698, 1625]","[273, 1398, 1433, 1446, 1463, 1824, 1852, 2273, 2895, 3199, 3272, 3947, 4171, 4402, 4583, 4629, 4851]","[698, 1625]",5211,19,5192,2,17,5192,0
3.5,BRHOX22,"[530, 600, 843, 1431, 1815, 2301, 2493, 2572, 3122, 3304]",[1431],"[530, 600, 843, 1815, 2301, 2493, 2572, 3122, 3304]",[1431],3434,10,3424,1,9,3424,0
3.5,BRHOX34A,"[460, 588, 613, 981, 1190, 1359, 1791, 1819, 2191, 2313, 2441, 2675, 2963, 3491]",[981],"[460, 588, 613, 1190, 1359, 1791, 1819, 2191, 2313, 2441, 2675, 2963, 3491]",[981],3490,14,3476,1,13,3476,0
3.5,BRU12895,"[793, 799, 1135, 1526, 1986, 1998, 2140, 2232, 2341, 2827]",[1135],"[793, 799, 1526, 1986, 1998, 2140, 2232, 2341, 2827]",[1135],3232,10,3222,1,9,3222,0
3.5,BTATPAAA,"[55, 296, 565, 740, 826, 1111, 1146, 1166, 1200, 1229, 2314, 2377, 2501, 2615, 2761, 2777, 2912, 3383, 3707, 4106, 4183, 4188, 4511, 5345, 5556, 5729, 5886, 5953, 5984, 6155, 6337, 6472, 6975, 6990, 7098, 7151, 7693, 7770, 7885, 7915, 8023, 8311, 8831, 9129, 9733, 9844]","[740, 2314, 3707, 5729, 5984, 6337, 7151, 7770, 8023, 9129]","[55, 296, 565, 826, 1111, 1146, 1166, 1200, 1229, 2377, 2501, 2615, 2761, 2777, 2912, 3383, 4106, 4183, 4188, 4511, 5345, 5556, 5886, 5953, 6155, 6472, 6975, 6990, 7098, 7693, 7885, 7915, 8311, 8831, 9733, 9844]","[740, 2314, 3707, 5729, 5984, 6337, 6827, 7151, 7770, 8023, 9129]",9907,46,9861,10,36,9860,1
3.5,BTEBGL2,"[201, 294, 310, 327, 414, 658, 766, 920, 1129, 1171, 1254]","[310, 658]","[201, 294, 327, 414, 766, 920, 1129, 1171, 1254]","[310, 658]",1833,11,1822,2,9,1822,0
3.5,BTEBGL4,"[4, 201, 294, 310, 327, 544, 658, 763, 815, 1128]","[310, 658]","[4, 201, 294, 327, 544, 763, 815, 1128]","[310, 658]",1828,10,1818,2,8,1818,0
3.5,BTGL01,"[98, 176, 327, 349, 365, 711, 873, 894, 910, 961, 1008]","[365, 1008]","[98, 176, 327, 349, 711, 873, 894, 910, 961]","[365, 1008]",2040,11,2029,2,9,2029,0
3.5,BTHOR02,"[16, 169, 484, 939, 1123, 1230, 1268, 1920, 1936]","[484, 1920]","[16, 169, 939, 1123, 1230, 1268, 1936]","[484, 1920]",2419,9,2410,2,7,2410,0
3.5,BTKER6B,"[826, 1008, 1355, 1593, 1678, 1820, 1830, 1925, 2044, 2171, 2219, 2346, 2559, 2913, 2926, 3070, 3184, 3530, 3626, 4056, 4335, 4666, 5608, 5686]","[1678, 2559, 3070, 3530, 4056, 4666]","[826, 1008, 1355, 1593, 1820, 1830, 1925, 2044, 2171, 2219, 2346, 2913, 2926, 3184, 3626, 4335, 5608, 5686]","[1678, 2559, 3070, 3315, 3530, 4056, 4666]",5718,24,5694,6,18,5693,1
3.5,BTSPDNA,"[84, 648, 685, 960, 1054, 1546, 1713, 2123]",[],"[84, 648, 685, 960, 1054, 1546, 1713, 2123]",[1541],2148,8,2140,0,8,2139,1
3.5,BTSVSP109,"[52, 554, 799, 1122, 1357, 1452, 1604, 2189, 2258, 2359, 2387, 2555, 2834, 2853, 2863, 3573, 5292, 5315, 5643, 6096, 6131, 6200, 6240, 6451, 6730]","[2359, 5292]","[52, 554, 799, 1122, 1357, 1452, 1604, 2189, 2258, 2387, 2555, 2834, 2853, 2863, 3573, 5315, 5643, 6096, 6131, 6200, 6240, 6451, 6730]","[2359, 3984, 5292]",6948,25,6923,2,23,6922,1
3.5,BTTNP2G,"[24, 125, 710, 774, 847, 852, 1029, 1115, 1326, 1342]",[774],"[24, 125, 710, 847, 852, 1029, 1115, 1326, 1342]",[774],1841,10,1831,1,9,1831,0
3.5,BTU02285,"[21, 248, 434, 996, 1139, 1476, 1620, 1858, 2118, 2131, 2334, 2367, 2438, 2481, 2825, 2873, 2936, 2980, 3792, 3866, 3906, 4169, 4222, 4325, 4487, 4711, 4780, 4950, 5056, 5087, 5654, 6075]","[3792, 4222, 4487, 4780, 5056]","[21, 248, 434, 996, 1139, 1476, 1620, 1858, 2118, 2131, 2334, 2367, 2438, 2481, 2825, 2873, 2936, 2980, 3866, 3906, 4169, 4325, 4711, 4950, 5087, 5654, 6075]","[3792, 4222, 4487, 4780, 5056]",6388,32,6356,5,27,6356,0
3.5,CALEGLOBIM,"[220, 236, 345, 473, 587, 603, 1062, 1185, 1197, 1265, 1293, 1312]","[236, 587]","[220, 345, 473, 603, 1062, 1185, 1197, 1265, 1293, 1312]","[236, 587]",1690,12,1678,2,10,1678,0
3.5,CBUEGLOBIM,"[220, 236, 345, 473, 587, 603, 874, 1062, 1185, 1197, 1265, 1293, 1312]","[236, 587]","[220, 345, 473, 603, 874, 1062, 1185, 1197, 1265, 1293, 1312]","[236, 587]",1690,13,1677,2,11,1677,0
3.5,CCALAC,"[436, 797, 932, 997, 1128, 1178, 1252, 1358, 1798, 1852, 2409, 2916, 2973, 3275, 3279, 3333, 3397]","[1358, 1852, 2409]","[436, 797, 932, 997, 1128, 1178, 1252, 1798, 2916, 2973, 3275, 3279, 3333, 3397]","[1358, 1852, 2409]",3619,17,3602,3,14,3602,0
3.5,CCBEGLOBIM,"[221, 237, 473, 587, 603, 1191, 1203, 1271, 1318]","[237, 587]","[221, 473, 603, 1191, 1203, 1271, 1318]","[237, 587]",1695,9,1686,2,7,1686,0
3.5,CCBEGLOBIN,"[222, 238, 475, 589, 605, 1070, 1194, 1206, 1274, 1321]","[238, 589]","[222, 475, 605, 1070, 1194, 1206, 1274, 1321]","[238, 589]",1698,10,1688,2,8,1688,0
3.5,CCGHG,"[283, 592, 863, 1051, 1281, 1389, 1778, 1818, 2305]","[283, 1051, 1778]","[592, 863, 1281, 1389, 1818, 2305]","[283, 706, 1051, 1778]",2830,9,2821,3,6,2820,1
3.5,CCGONBS1,"[197, 317, 1649, 1767, 1974, 2286, 2688]",[1767],"[197, 317, 1649, 1974, 2286, 2688]","[1767, 2072]",3463,7,3456,1,6,3455,1
3.5,CCGONBS2,"[192, 313, 1667, 1785, 1993, 2344, 2707]",[1785],"[192, 313, 1667, 1993, 2344, 2707]","[1785, 2091]",3482,7,3475,1,6,3474,1
3.5,CCGTHA1,"[26, 166, 302, 390, 572, 644]","[302, 572]","[26, 166, 390, 644]","[302, 572]",1144,6,1138,2,4,1138,0
3.5,CCT64CLU,"[274, 516, 563, 1644, 1664, 1822, 1873, 2757, 2761, 2766, 2993, 3005, 3496, 4436, 4510, 4514, 4518, 4565, 4572, 4577, 4600, 4643, 5272, 5337, 5528, 5659, 5939, 6121, 6277]","[1644, 2757, 3005, 3496, 4514, 5272, 5659]","[274, 516, 563, 1664, 1822, 1873, 2761, 2766, 2993, 4436, 4510, 4518, 4565, 4572, 4577, 4600, 4643, 5337, 5528, 5939, 6121, 6277]","[1644, 2757, 3005, 3496, 4514, 5272, 5659]",6276,29,6247,7,22,6247,0
3.5,CEPPINS,"[464, 490, 858, 1399, 1487, 1509, 1513, 1615, 1760]",[858],"[464, 490, 1399, 1487, 1509, 1513, 1615, 1760]",[858],1901,9,1892,1,8,1892,0
3.5,CHBLG,"[166, 698, 928, 932, 1465, 1472, 1638, 2301, 2308, 2564, 2807, 3030, 3090, 3390, 3640, 3788, 3794, 4019, 4266, 4298, 4357, 4700, 4861, 4919, 5246, 5461, 5573, 5619, 5756, 6025, 6255, 6280, 6376, 6555, 6629]","[3090, 4019, 5246, 6025]","[166, 698, 928, 932, 1465, 1472, 1638, 2301, 2308, 2564, 2807, 3030, 3390, 3640, 3788, 3794, 4266, 4298, 4357, 4700, 4861, 4919, 5461, 5573, 5619, 5756, 6255, 6280, 6376, 6555, 6629]","[2285, 3090, 4019, 5246, 6025]",8080,35,8045,4,31,8044,1
3.5,CHEBGLI,"[456, 795, 844, 862, 909, 1213]",[909],"[456, 795, 844, 862, 1213]","[570, 909]",2204,6,2198,1,5,2197,1
3.5,CHEBGLII,"[217, 454, 547, 563, 580, 798, 912, 923, 1020, 1049, 1383, 1426]","[563, 912]","[217, 454, 547, 580, 798, 923, 1020, 1049, 1383, 1426]","[563, 912]",2258,12,2246,2,10,2246,0
3.5,CHKALDB,"[535, 606, 1062, 1452, 1506, 1912, 1922, 1927, 2460, 2874, 2878, 2952, 3077, 3115, 4004, 4046, 4388, 4462, 4802, 4853, 5731, 5748, 6172, 6392, 6664, 6955, 6960, 6983, 7265, 7360, 7487, 7504, 7523, 8170, 8186, 8617, 9185, 9313, 9626, 10415, 10577, 10705, 10844]","[6172, 6664, 6955, 7265, 8186, 9185]","[535, 606, 1062, 1452, 1506, 1912, 1922, 1927, 2460, 2874, 2878, 2952, 3077, 3115, 4004, 4046, 4388, 4462, 4802, 4853, 5731, 5748, 6392, 6960, 6983, 7360, 7487, 7504, 7523, 8170, 8617, 9313, 9626, 10415, 10577, 10705, 10844]","[6172, 6664, 6955, 7265, 8186, 8842, 9185]",11643,43,11600,6,37,11599,1
3.5,CHKAPOII,"[64, 282, 1000, 1246, 1328, 1339, 1626, 1839, 1891, 1901, 2131, 2320, 2620, 2798, 3317, 3381, 3509, 3771, 3820, 3906, 3946, 3975, 4026, 4047, 4340, 4488]","[3317, 3820]","[64, 282, 1000, 1246, 1328, 1339, 1626, 1839, 1891, 1901, 2131, 2320, 2620, 2798, 3381, 3509, 3771, 3906, 3946, 3975, 4026, 4047, 4340, 4488]","[3317, 3820]",4953,26,4927,2,24,4927,0
3.5,CHKDPCP,"[347, 637, 1624, 1878]",[637],"[347, 1624, 1878]",[637],1902,4,1898,1,3,1898,0
3.5,CHKMAX,"[27, 281, 517, 632, 727, 789, 978, 1236, 1299, 1816, 2127, 2291, 2712, 2882, 2958, 3172, 3189, 3273, 3400, 3764, 3928, 4295, 4931, 5037, 5130, 5173, 5407]","[2127, 2291, 3928, 4295]","[27, 281, 517, 632, 727, 789, 978, 1236, 1299, 1816, 2712, 2882, 2958, 3172, 3189, 3273, 3400, 3764, 4931, 5037, 5130, 5173, 5407]","[2127, 2291, 3928, 4295]",5690,27,5663,4,23,5663,0
3.5,CHKMYOD,"[131, 316, 984, 1268, 1738, 2106, 3066, 3379, 3468, 3990, 4038, 4281, 4596, 4849, 4941, 5065, 5145, 5517, 5592, 5660, 6150, 6284, 6456, 6527]","[4941, 6150]","[131, 316, 984, 1268, 1738, 2106, 3066, 3379, 3468, 3990, 4038, 4281, 4596, 4849, 5065, 5145, 5517, 5592, 5660, 6284, 6456, 6527]","[4941, 6150]",7381,24,7357,2,22,7357,0
3.5,CHKOVAL,"[434, 779, 1293, 1390, 1492, 1923, 2449, 2657, 3164, 3466, 3812, 3915, 4176, 4694, 4890, 4915, 5144, 5170, 6282, 6975, 7079, 7148, 7355, 7691, 8125, 8334, 8410, 8791, 9028]","[3164, 3466, 4176, 4694, 6282]","[434, 779, 1293, 1390, 1492, 1923, 2449, 2657, 3812, 3915, 4890, 4915, 5144, 5170, 6975, 7079, 7148, 7355, 7691, 8125, 8334, 8410, 8791, 9028]","[3164, 3466, 4176, 4694, 5795, 6282]",9198,29,9169,5,24,9168,1
3.5,CHKRPL30,"[527, 545, 571, 671, 749, 801, 916, 1471, 1541, 1684, 1765, 1778, 1872, 1918, 1957, 2113, 2158, 2753, 2816, 2850, 3403, 3478, 3799, 3838]","[801, 1872, 2753]","[527, 545, 571, 671, 749, 916, 1471, 1541, 1684, 1765, 1778, 1918, 1957, 2113, 2158, 2816, 2850, 3403, 3478, 3799, 3838]","[801, 1872, 2753]",3884,24,3860,3,21,3860,0
3.5,CHKRPL37A,"[16, 201, 691, 798, 996, 1265, 1376, 1558, 1618, 1946, 2125, 2255, 2386, 2739, 3052, 3179, 3376]","[798, 1376, 2386]","[16, 201, 691, 996, 1265, 1558, 1618, 1946, 2125, 2255, 2739, 3052, 3179, 3376]","[798, 1376, 2386]",3465,17,3448,3,14,3448,0
3.5,CHKRPL5G,"[99, 153, 300, 498, 512, 1227, 1419, 1540, 1632, 1637, 2017, 2138, 2397, 2428, 2473, 2618, 2974, 3157, 3433, 4062, 4259, 4309, 4746, 5165, 5562, 6060, 6064, 6690, 6897, 7986]","[498, 1419, 1632, 3157, 5165, 6897]","[99, 153, 300, 512, 1227, 1540, 1637, 2017, 2138, 2397, 2428, 2473, 2618, 2974, 3433, 4062, 4259, 4309, 4746, 5562, 6060, 6064, 6690, 7986]","[498, 1419, 1632, 3157, 3955, 5165, 6897]",8313,30,8283,6,24,8282,1
3.5,CHKTUB4B,"[243, 264, 323, 340, 437, 762, 779, 849, 949, 1150, 1188, 1199, 1469, 1573, 1710, 1803, 1895, 3110]","[437, 949, 1573]","[243, 264, 323, 340, 762, 779, 849, 1150, 1188, 1199, 1469, 1710, 1803, 1895, 3110]","[437, 949, 1573]",3145,18,3127,3,15,3127,0
3.5,CHKY,"[214, 319, 641, 691, 794, 1112, 1650, 1664, 2096, 2197, 2692, 2725, 2730, 2858, 3082, 3577, 3603, 3953, 4199, 4683, 4709, 4750, 5049, 5186, 5213, 5648, 6012, 6249, 6383, 6473, 7072, 8349, 8361]","[3603, 4199, 4683, 5648, 6012, 6249]","[214, 319, 641, 691, 794, 1112, 1650, 1664, 2096, 2197, 2692, 2725, 2730, 2858, 3082, 3577, 3953, 4709, 4750, 5049, 5186, 5213, 6383, 6473, 7072, 8349, 8361]","[3603, 4199, 4683, 5648, 6012, 6249]",8364,33,8331,6,27,8331,0
3.5,CHPPHYGEN,"[22, 370, 543, 555, 1341, 1664, 1736, 1802, 1818, 2214, 2284, 2485, 3020, 3516, 3764, 3786, 4096, 4387, 4561, 4599, 4831, 4945, 5286, 5459, 5471, 5521, 6592, 6609, 6693, 7000, 7011, 7072, 7138, 7830, 8472, 8746, 8823, 8841, 8862, 9244, 9306, 9395, 9894, 9910, 9995, 10066, 10416, 10818, 10833, 10849, 10873, 11000, 11079, 11193, 11645, 11811, 11828, 11903, 11936, 12560, 12575, 12603, 13318, 13493, 13548]","[4599, 4945]","[22, 370, 543, 555, 1341, 1664, 1736, 1802, 1818, 2214, 2284, 2485, 3020, 3516, 3764, 3786, 4096, 4387, 4561, 4831, 5286, 5459, 5471, 5521, 6592, 6609, 6693, 7000, 7011, 7072, 7138, 7830, 8472, 8746, 8823, 8841, 8862, 9244, 9306, 9395, 9894, 9910, 9995, 10066, 10416, 10818, 10833, 10849, 10873, 11000, 11079, 11193, 11645, 11811, 11828, 11903, 11936, 12560, 12575, 12603, 13318, 13493, 13548]","[4599, 4945]",13689,65,13624,2,63,13624,0
3.5,CHPPROTP1A,"[58, 159]",[159],[58],[159],397,2,395,1,1,395,0
3.5,CHPPROTP1B,"[56, 160]",[160],[56],[160],396,2,394,1,1,394,0
3.5,CHWEGLOBIM,"[221, 237, 474, 588, 604, 1069, 1193, 1319]","[237, 588]","[221, 474, 604, 1069, 1193, 1319]","[237, 588]",1701,8,1693,2,6,1693,0
3.5,CIGH,"[457, 1249, 1281, 1577, 2029, 2130, 2280, 2536, 2593, 2889]","[1281, 2280, 2889]","[457, 1249, 1577, 2029, 2130, 2536, 2593]","[1281, 1691, 2280, 2889]",3967,10,3957,3,7,3956,1
3.5,CITEGLOBIM,"[220, 236, 345, 473, 587, 603, 890, 1062, 1186, 1198, 1266, 1294, 1313]","[236, 587]","[220, 345, 473, 603, 890, 1062, 1186, 1198, 1266, 1294, 1313]","[236, 587]",1691,13,1678,2,11,1678,0
3.5,CJAEGLOBIN,"[221, 237, 474, 588, 604, 1069, 1193, 1272, 1319]","[237, 588]","[221, 474, 604, 1069, 1193, 1272, 1319]","[237, 588]",1702,9,1693,2,7,1693,0
3.5,CJINTERFG,"[191, 512, 862, 1143, 1860, 2428, 2635, 2881, 3126, 3158, 3303, 3607, 4125, 4187, 4465, 4702, 4730, 4750, 5524, 5822, 6036, 6127, 6397, 6760, 7468, 8152, 8324, 8352, 8486]","[2881, 4187, 4465]","[191, 512, 862, 1143, 1860, 2428, 2635, 3126, 3158, 3303, 3607, 4125, 4702, 4730, 4750, 5524, 5822, 6036, 6127, 6397, 6760, 7468, 8152, 8324, 8352, 8486]","[2881, 4187, 4465]",8519,29,8490,3,26,8490,0
3.5,CL54K,"[119, 141, 183, 408, 512, 535, 543, 649, 706, 771, 959, 1177, 1186, 1190, 1238, 1294, 1538, 1926, 2581, 2696, 2715, 2726, 2954, 3218]",[512],"[119, 141, 183, 408, 535, 543, 649, 706, 771, 959, 1177, 1186, 1190, 1238, 1294, 1538, 1926, 2581, 2696, 2715, 2726, 2954, 3218]",[512],3407,24,3383,1,23,3383,0
3.5,CMBGA2B2,"[383, 718, 810, 989, 1597]","[383, 718]","[810, 989, 1597]","[383, 718]",2684,5,2679,2,3,2679,0
3.5,CMEGA2E2,"[416, 486, 492, 718, 753, 873, 1075]","[416, 753]","[486, 492, 718, 873, 1075]","[416, 753]",2046,7,2039,2,5,2039,0
3.5,CMU11711,"[15, 204, 589, 790, 826, 906, 1018, 1647, 1685, 1984, 2031, 2627, 2669]","[1685, 2031]","[15, 204, 589, 790, 826, 906, 1018, 1647, 1984, 2627, 2669]","[1685, 2031]",3163,13,3150,2,11,3150,0
3.5,CPPROT1GN,"[102, 164, 255]",[164],"[102, 255]",[164],390,3,387,1,2,387,0
3.5,CRASEQB,"[79, 669, 783, 1920, 2123, 2825, 3434, 3452, 3464, 3482, 3593, 3635, 3641, 3647, 3812, 4825, 4931]","[1920, 2825]","[79, 669, 783, 2123, 3434, 3452, 3464, 3482, 3593, 3635, 3641, 3647, 3812, 4825, 4931]","[1920, 2825]",5120,17,5103,2,15,5103,0
3.5,CRUCH7AHYD,"[1205, 1339, 1731, 1887, 2690, 2827, 2936, 2941, 3016, 3418, 3651, 3792, 3841, 4121, 4201, 4774, 5283, 5559, 6819, 6963, 7866, 7901, 8924, 9375, 9626, 9849, 10243, 10316, 10564]","[1731, 3651, 7866]","[1205, 1339, 1887, 2690, 2827, 2936, 2941, 3016, 3418, 3792, 3841, 4121, 4201, 4774, 5283, 5559, 6819, 6963, 7901, 8924, 9375, 9626, 9849, 10243, 10316, 10564]","[1731, 3651, 4938, 6076, 7866]",10606,29,10577,3,26,10575,2
3.5,CRUGAD45A,"[208, 215, 691, 760, 859, 902, 929, 1744, 1811, 1877, 1971, 2063, 2411, 2417, 2500, 2553, 2759, 3148, 3428, 3555, 3605, 4003, 4368]","[1877, 2063, 2417]","[208, 215, 691, 760, 859, 902, 929, 1744, 1811, 1971, 2411, 2500, 2553, 2759, 3148, 3428, 3555, 3605, 4003, 4368]","[1877, 2063, 2417]",4427,23,4404,3,20,4404,0
3.5,DMPROTP1,"[33, 249]",[249],[33],[249],616,2,614,1,1,614,0
3.5,DMU11712,"[16, 592, 792, 1405, 1667, 1705, 1929, 1996, 2043, 2685, 2781]","[1705, 2043]","[16, 592, 792, 1405, 1667, 1929, 1996, 2685, 2781]","[1705, 2043]",3019,11,3008,2,9,3008,0
3.5,DOGCOLIP,"[224, 249, 416, 789, 817, 1108, 1343, 1411, 1602, 1747, 2114, 2378, 2503, 2508, 2694, 2821, 2839, 3119]","[1108, 2378]","[224, 249, 416, 789, 817, 1343, 1411, 1602, 1747, 2114, 2503, 2508, 2694, 2821, 2839, 3119]","[1108, 2378]",3156,18,3138,2,16,3138,0
3.5,DOGIL8T,"[118, 434, 475, 577, 671, 1206, 1406, 1710, 1769, 1918]","[118, 1406, 1769]","[434, 475, 577, 671, 1206, 1710, 1918]","[118, 1406, 1769]",2229,10,2219,3,7,2219,0
3.5,ECGLOAP1,"[363, 657, 725, 889, 962, 968, 995]","[363, 657]","[725, 889, 962, 968, 995]","[363, 657]",1133,7,1126,2,5,1126,0
3.5,ECPZA2GL,"[19, 193, 767, 954, 1055, 1560, 1585, 1600, 1623, 1648, 1675, 1728, 2012, 2153, 2166, 2613, 3269, 3527, 3576, 3650, 3945, 4059, 4140, 4304, 5046, 5060, 5077]","[3576, 4059]","[19, 193, 767, 954, 1055, 1560, 1585, 1600, 1623, 1648, 1675, 1728, 2012, 2153, 2166, 2613, 3269, 3527, 3650, 3945, 4140, 4304, 5046, 5060, 5077]","[3576, 4059]",5081,27,5054,2,25,5054,0
3.5,ECZGL1,"[66, 213, 700, 725, 740, 763, 845, 874, 1033, 1534]","[700, 1534]","[66, 213, 725, 740, 763, 845, 874, 1033]","[700, 1534]",1993,10,1983,2,8,1983,0
3.5,ECZGL2,"[255, 280, 295, 318, 400, 429, 588, 1084]","[255, 1084]","[280, 295, 318, 400, 429, 588]","[255, 1084]",1555,8,1547,2,6,1547,0
3.5,ELMETL,"[29, 1097, 1120, 1291, 1518]","[1097, 1291]","[29, 1120, 1518]","[1097, 1291]",1865,5,1860,2,3,1860,0
3.5,FDFELDI2,"[276, 571, 641, 678, 703, 1070, 1643, 1882, 2011, 2015, 2149]",[276],"[571, 641, 678, 703, 1070, 1643, 1882, 2011, 2015, 2149]","[276, 970]",2417,11,2406,1,10,2405,1
3.5,FDTNFA,"[187, 273, 291, 547, 790, 885, 972, 1396, 1590]","[187, 790, 972]","[273, 291, 547, 885, 1396, 1590]","[187, 790, 972]",1714,9,1705,3,6,1705,0
3.5,GDMYF5G,"[138, 524, 561, 639, 655, 860, 1036, 1104]","[639, 1036]","[138, 524, 561, 655, 860, 1104]","[639, 1036]",1601,8,1593,2,6,1593,0
3.5,GGAC01,"[22, 116, 273, 443, 634, 774, 778, 808, 833, 914, 970, 1057, 1119, 1343, 1586, 1666, 1716, 1903, 1999, 2050, 2226, 2261, 2585, 2602, 2687, 2698, 2782, 2853, 3154, 3189, 3276, 3330, 3338, 3431, 3495, 3561, 3677, 3831, 3857, 4055, 4309, 4499, 4695]","[1666, 2226, 3189, 3677]","[22, 116, 273, 443, 634, 774, 778, 808, 833, 914, 970, 1057, 1119, 1343, 1586, 1716, 1903, 1999, 2050, 2261, 2585, 2602, 2687, 2698, 2782, 2853, 3154, 3276, 3330, 3338, 3431, 3495, 3561, 3831, 3857, 4055, 4309, 4499, 4695]","[1666, 2226, 3189, 3677]",5038,43,4995,4,39,4995,0
3.5,GGACTAC,"[311, 339, 351, 533, 614, 791, 970, 1472, 1554, 1811, 1815, 1866, 2127, 2277, 2520, 2752, 2770, 2914, 3032, 3218, 3948, 4216, 4282, 4398, 5278]","[970, 2127, 2914, 3218, 4398]","[311, 339, 351, 533, 614, 791, 1472, 1554, 1811, 1815, 1866, 2277, 2520, 2752, 2770, 3032, 3948, 4216, 4282, 5278]","[970, 2127, 2914, 3218, 4398]",5455,25,5430,5,20,5430,0
3.5,GGACTI,"[153, 404, 525, 529, 580, 788, 841, 929, 975, 1030, 1368, 1554, 1659, 1779, 1841, 2279]","[404, 841, 1554, 1841]","[153, 525, 529, 580, 788, 929, 975, 1030, 1368, 1659, 1779, 2279]","[404, 841, 1137, 1554, 1841]",2418,16,2402,4,12,2401,1
3.5,GGCALB,"[288, 386, 398, 416, 421, 520, 589, 596, 866, 889, 944, 1016, 1292, 1358, 1514, 1542, 1863, 2289, 2549, 2791, 2993, 3062, 3467, 3509, 3617, 3629, 3793, 4235, 4414, 4894, 5205, 5262, 5524, 5867, 5933, 6149, 6321, 6673, 6694, 6784, 7035, 7824, 7865, 8249, 8667, 8718, 8739, 8776, 9052, 9394, 9685, 9916, 10030, 10195, 10530, 10551]","[386, 1863, 2289, 3467, 3793, 4235, 4894, 5205, 5933, 6784, 7035, 7824, 8718, 9052, 9685, 10195]","[288, 398, 416, 421, 520, 589, 596, 866, 889, 944, 1016, 1292, 1358, 1514, 1542, 2549, 2791, 2993, 3062, 3509, 3617, 3629, 4414, 5262, 5524, 5867, 6149, 6321, 6673, 6694, 7865, 8249, 8667, 8739, 8776, 9394, 9916, 10030, 10530, 10551]","[386, 1863, 2289, 3467, 3793, 4235, 4894, 5205, 5933, 6784, 7035, 7824, 8718, 9052, 9685, 10195]",11060,56,11004,16,40,11004,0
3.5,GGCRYD1,"[217, 267, 388, 441, 910, 1734, 2077, 2085, 2090, 2539, 2742, 3150, 3516, 3944, 4036, 4297, 4332, 4528, 4889, 4907, 5234, 5498, 5899, 6003, 6138, 6395, 6734, 6791, 6829, 6835, 7213, 7373, 7424, 7435, 7529, 7779, 8021]","[441, 1734, 2742, 3150, 3516, 3944, 4332, 4528, 4907, 5234, 5899, 6138, 6395, 6734, 7213]","[217, 267, 388, 910, 2077, 2085, 2090, 2539, 4036, 4297, 4889, 5498, 6003, 6791, 6829, 6835, 7373, 7424, 7435, 7529, 7779, 8021]","[441, 1734, 2742, 3150, 3516, 3944, 4332, 4528, 4907, 5234, 5899, 6138, 6395, 6734, 7213]",8152,37,8115,15,22,8115,0
3.5,GGGL03,"[432, 768, 1160]","[432, 768]",[1160],"[432, 768]",1199,3,1196,2,1,1196,0
3.5,GGGNRHIA,"[338, 1661, 1684, 1950, 2315, 2577, 2787, 2822, 2951, 3048, 3380, 3422, 3627, 3820, 4195, 4392, 4472, 4544, 5111, 5447, 5575, 5640, 5885, 6120]","[3627, 4392]","[338, 1661, 1684, 1950, 2315, 2577, 2787, 2822, 2951, 3048, 3380, 3422, 3820, 4195, 4472, 4544, 5111, 5447, 5575, 5640, 5885, 6120]","[3627, 4392]",6274,24,6250,2,22,6250,0
3.5,GGNFM1D,"[789, 859, 874, 932, 1295, 1541, 1721, 2051, 2224, 2228, 2285, 2451, 3184, 3354, 3448, 3595, 4194, 4284, 4395, 4596, 4656, 4663, 4746, 4768, 4851, 5057, 5509]",[2451],"[789, 859, 874, 932, 1295, 1541, 1721, 2051, 2224, 2228, 2285, 3184, 3354, 3448, 3595, 4194, 4284, 4395, 4596, 4656, 4663, 4746, 4768, 4851, 5057, 5509]","[2132, 2451]",5630,27,5603,1,26,5602,1
3.5,GGPROP2,"[51, 564]",[],"[51, 564]",[307],640,2,638,0,2,637,1
3.5,GGRIHBGEN,"[202, 219, 254, 676, 712, 961, 981, 990, 1038, 1237, 1973, 2050, 2450, 2863, 2982, 2998, 3219, 3317, 3394, 3454]","[2982, 3219, 3454]","[202, 219, 254, 676, 712, 961, 981, 990, 1038, 1237, 1973, 2050, 2450, 2863, 2998, 3317, 3394]","[2982, 3219, 3454]",3878,20,3858,3,17,3858,0
3.5,GGVITIIG,"[54, 190, 442, 567, 830, 1146, 1318, 1596, 1740, 2021, 2351, 2561, 2694, 2948, 2952, 3056, 3064, 3138, 3145, 3267, 3543, 3791, 4295, 4818, 4876, 5129, 5441, 5848, 6011, 6062, 6229, 6408, 6443, 7045, 7123, 7268, 7393, 7740, 8026, 8302, 8481, 8597, 9149, 9439, 9467, 10448, 10618, 10703, 10714, 10930, 10951, 10971, 11663, 11667, 12272, 12547, 12750, 12791, 13186, 13267, 13505, 13819, 14077, 14139, 14252, 14386, 14413, 14589, 14704, 15283, 15348, 15710, 15771, 15880, 16552, 16955, 17013, 17019, 17193, 17299, 17447, 17481, 17492, 17815, 17864, 17913, 18132, 18829, 18851, 18882, 19081, 19128, 19337, 19348, 19513, 19933, 20096, 20126]","[54, 190, 442, 2021, 2694, 2948, 3267, 3543, 3791, 4818, 5441, 6229, 6443, 7045, 7268, 8026, 8302, 9149, 9467, 10448, 10714, 12272, 13267, 13505, 14704, 15348, 15771, 16955, 17864, 19081]","[567, 830, 1146, 1318, 1596, 1740, 2351, 2561, 2952, 3056, 3064, 3138, 3145, 4295, 4876, 5129, 5848, 6011, 6062, 6408, 7123, 7393, 7740, 8481, 8597, 9439, 10618, 10703, 10930, 10951, 10971, 11663, 11667, 12547, 12750, 12791, 13186, 13819, 14077, 14139, 14252, 14386, 14413, 14589, 15283, 15710, 15880, 16552, 17013, 17019, 17193, 17299, 17447, 17481, 17492, 17815, 17913, 18132, 18829, 18851, 18882, 19128, 19337, 19348, 19513, 19933, 20096, 20126]","[54, 190, 442, 2021, 2694, 2948, 3267, 3543, 3791, 4818, 5441, 6229, 6443, 7045, 7268, 8026, 8302, 9149, 9467, 10104, 10448, 10714, 11757, 12272, 12615, 13267, 13505, 14028, 14704, 15348, 15771, 16955, 17864, 19081]",20335,98,20237,30,68,20233,4
3.5,GIBPROTP1A,"[56, 160, 260]",[160],"[56, 260]",[160],393,3,390,1,2,390,0
3.5,GORAFPA,"[75, 699, 999, 1243, 1860, 1939, 2163, 2268, 2395, 2455, 2784, 2871, 2955, 3434, 3684, 3924, 4151, 4192, 4363, 4369, 4522, 4564, 4744, 5295, 5457, 5550, 5602, 6121, 6220, 6760, 6976, 7046, 7156, 7445, 7766, 7795, 8370, 8836, 9548, 10041, 10408, 10422, 10727, 10807, 10903, 11145, 11629, 11823, 12575, 12941, 13421, 14087, 14183, 14424, 14496, 14672, 14707, 15555, 15952, 16581, 17064, 17195, 17207, 17576, 17601, 17834, 18115, 18940, 19231, 20297, 20326, 20427, 20434, 20474, 20478, 20617, 20718, 21186, 21207, 22550, 22828, 22937, 23096, 23229, 23233, 23613, 23937, 24387]","[999, 1860, 2955, 5457, 6760, 7766, 11629, 13421, 14087, 14707, 16581, 17834]","[75, 699, 1243, 1939, 2163, 2268, 2395, 2455, 2784, 2871, 3434, 3684, 3924, 4151, 4192, 4363, 4369, 4522, 4564, 4744, 5295, 5550, 5602, 6121, 6220, 6976, 7046, 7156, 7445, 7795, 8370, 8836, 9548, 10041, 10408, 10422, 10727, 10807, 10903, 11145, 11823, 12575, 12941, 14183, 14424, 14496, 14672, 15555, 15952, 17064, 17195, 17207, 17576, 17601, 18115, 18940, 19231, 20297, 20326, 20427, 20434, 20474, 20478, 20617, 20718, 21186, 21207, 22550, 22828, 22937, 23096, 23229, 23233, 23613, 23937, 24387]","[999, 1860, 2955, 5457, 6760, 7766, 9445, 11629, 13421, 14087, 14707, 16581, 17834]",24599,88,24511,12,76,24510,1
3.5,GORPROTP1A,"[60, 164]",[164],[60],[164],404,2,402,1,1,402,0
3.5,GPIINS,"[203, 526, 696, 950, 1023]",[526],"[203, 696, 950, 1023]",[526],1464,5,1459,1,4,1459,0
3.5,HAMAMYLP,"[48, 446, 618, 735, 1394, 1473, 1549, 1794, 2308, 2419, 3934, 4561, 5045, 5424, 5541]",[2308],"[48, 446, 618, 735, 1394, 1473, 1549, 1794, 2419, 3934, 4561, 5045, 5424, 5541]",[2308],5947,15,5932,1,14,5932,0
3.5,HAMHG5,"[615, 640, 781, 1333, 1373, 1385, 1640, 1817, 1919, 2464, 2817, 3433, 3461, 3620, 3950, 4319, 4662, 4856, 5439, 5517, 5603, 5637, 6188, 6597, 7156, 7240, 7287, 7441, 7668, 7956, 8108, 8258, 8295, 8396, 8881, 9223, 9231, 9260]","[4856, 5517, 6188, 6597, 7441]","[615, 640, 781, 1333, 1373, 1385, 1640, 1817, 1919, 2464, 2817, 3433, 3461, 3620, 3950, 4319, 4662, 5439, 5603, 5637, 7156, 7240, 7287, 7668, 7956, 8108, 8258, 8295, 8396, 8881, 9223, 9231, 9260]","[4856, 5517, 6188, 6597, 7441]",9711,38,9673,5,33,9673,0
3.5,HROAMD1,"[237, 289, 1072, 1585, 2687, 3357, 3486, 3494, 3830, 3928, 4700, 4795, 4816, 5311, 5413, 5962, 6863, 6983]","[2687, 3486, 4700]","[237, 289, 1072, 1585, 3357, 3494, 3830, 3928, 4795, 4816, 5311, 5413, 5962, 6863, 6983]","[2687, 3486, 4700]",7091,18,7073,3,15,7073,0
3.5,HROMA2,"[292, 358, 423, 427, 686, 739, 838, 1174, 1285, 1351, 1640]","[739, 1174]","[292, 358, 423, 427, 686, 838, 1285, 1351, 1640]","[739, 1174]",1779,11,1768,2,9,1768,0
3.5,HROMA4A,"[411, 661, 727, 1055, 1108, 1334, 1670, 1774, 1840, 2129, 2287]","[1108, 1670]","[411, 661, 727, 1055, 1334, 1774, 1840, 2129, 2287]","[1108, 1670]",2331,11,2320,2,9,2320,0
3.5,HRSPRMI,"[247, 416, 551, 722, 1211, 1245, 1605, 1880, 2047, 2197]",[722],"[247, 416, 551, 1211, 1245, 1605, 1880, 2047, 2197]",[722],2198,10,2188,1,9,2188,0
3.5,HS1D3HLH,"[173, 185, 467, 757, 1039, 1231, 1634, 1750, 2003, 2146]",[1039],"[173, 185, 467, 757, 1231, 1634, 1750, 2003, 2146]",[1039],2473,10,2463,1,9,2463,0
3.5,HS2OXOC,"[116, 755, 1095, 1162, 1421, 1451, 1694, 1719, 1825, 1878, 1894, 2227]","[116, 1162, 1421, 1694, 1825]","[755, 1095, 1451, 1719, 1878, 1894, 2227]","[116, 871, 1162, 1421, 1694, 1825]",2510,12,2498,5,7,2497,1
3.5,HSABLGR1,"[371, 749, 860, 902, 1080, 1236, 1279, 1670, 1981, 2265, 2274, 2923, 2977, 3020, 3130, 3140, 3178, 3265, 3344, 3519, 3603, 3636, 3683, 4148, 4166, 4321, 4479, 4506, 4528, 4865, 5108, 5218, 5284, 5312, 5317, 5465, 5666, 5890, 6125, 6479, 6508, 6567, 6604, 6617, 6743, 6820, 6977, 7049, 7197, 8039, 8356, 8470, 8720, 9075, 9294, 9310, 9340, 9507, 10016, 10073, 10112, 10400, 10413, 10509, 10535, 10623, 10950, 10991, 11052, 11090, 11094, 11118, 11135, 11167, 11354, 11597, 11929, 11951, 11988, 11992, 12007, 12239, 12325, 12434, 12880, 12948, 13058, 13262, 13683, 13875, 14754, 14973, 15060, 15400, 15442, 15514, 15589, 15741, 15907, 15929, 16572, 17036, 17116, 17249, 17547, 17886, 17991, 18028, 18211, 19026, 19158, 19199, 19244, 19282, 19672, 19728, 19816, 19906, 19972, 20015, 20105, 20121, 20282, 20325, 20665, 20991, 21219, 21558, 21832, 22368, 22421, 23084, 23126, 23330, 23472, 23507, 23584, 23730, 23851, 23938, 23981, 24042, 24066, 24277, 24298, 24656, 24805, 24853, 24896, 24979, 25292, 25818, 25849, 25902, 25906, 26127, 26145, 26288, 26300, 26508, 26725, 26789, 27114, 27158, 27209, 28260, 29268, 29760, 30175, 30405, 30552, 31027, 31138, 31182, 31307, 31493, 31699, 32126, 32233, 32296, 32399, 32910, 33591, 33629, 33787, 33826, 34121, 34153, 34205, 34563, 34596, 35331, 35464, 35562, 35751, 35835]","[8720, 10400, 12434, 15741, 17116, 17991]","[371, 749, 860, 902, 1080, 1236, 1279, 1670, 1981, 2265, 2274, 2923, 2977, 3020, 3130, 3140, 3178, 3265, 3344, 3519, 3603, 3636, 3683, 4148, 4166, 4321, 4479, 4506, 4528, 4865, 5108, 5218, 5284, 5312, 5317, 5465, 5666, 5890, 6125, 6479, 6508, 6567, 6604, 6617, 6743, 6820, 6977, 7049, 7197, 8039, 8356, 8470, 9075, 9294, 9310, 9340, 9507, 10016, 10073, 10112, 10413, 10509, 10535, 10623, 10950, 10991, 11052, 11090, 11094, 11118, 11135, 11167, 11354, 11597, 11929, 11951, 11988, 11992, 12007, 12239, 12325, 12880, 12948, 13058, 13262, 13683, 13875, 14754, 14973, 15060, 15400, 15442, 15514, 15589, 15907, 15929, 16572, 17036, 17249, 17547, 17886, 18028, 18211, 19026, 19158, 19199, 19244, 19282, 19672, 19728, 19816, 19906, 19972, 20015, 20105, 20121, 20282, 20325, 20665, 20991, 21219, 21558, 21832, 22368, 22421, 23084, 23126, 23330, 23472, 23507, 23584, 23730, 23851, 23938, 23981, 24042, 24066, 24277, 24298, 24656, 24805, 24853, 24896, 24979, 25292, 25818, 25849, 25902, 25906, 26127, 26145, 26288, 26300, 26508, 26725, 26789, 27114, 27158, 27209, 28260, 29268, 29760, 30175, 30405, 30552, 31027, 31138, 31182, 31307, 31493, 31699, 32126, 32233, 32296, 32399, 32910, 33591, 33629, 33787, 33826, 34121, 34153, 34205, 34563, 34596, 35331, 35464, 35562, 35751, 35835]","[8720, 10400, 12434, 14200, 15741, 17116, 17991]",35954,196,35758,6,190,35757,1
3.5,HSALDCG,"[88, 105, 148, 349, 555, 801, 1014, 1283, 1914, 2098, 2481, 2637, 2641, 2663, 2939, 3110, 3289, 3366, 3386, 3411, 3551, 3567, 3994, 4346, 4434]","[2641, 2939, 3110, 3366, 3567, 3994]","[88, 105, 148, 349, 555, 801, 1014, 1283, 1914, 2098, 2481, 2637, 2663, 3289, 3386, 3411, 3551, 4346, 4434]","[2641, 2939, 3110, 3366, 3567, 3994, 4326]",5190,25,5165,6,19,5164,1
3.5,HSAPC3A,"[110, 172, 226, 636, 919, 1178, 1246, 1829, 2140, 2325, 2363, 2515, 2778, 3106, 3212, 3409, 3492, 3863, 3874, 3924, 4086, 4222, 4460, 4585, 4618, 4662, 4679, 5222, 5823]","[919, 1178]","[110, 172, 226, 636, 1246, 1829, 2140, 2325, 2363, 2515, 2778, 3106, 3212, 3409, 3492, 3863, 3874, 3924, 4086, 4222, 4460, 4585, 4618, 4662, 4679, 5222, 5823]","[919, 1178]",6039,29,6010,2,27,6010,0
3.5,HSAPOA2B,"[152, 168, 232, 245, 267, 338, 490, 682, 698, 916, 1554, 1585]","[490, 916]","[152, 168, 232, 245, 267, 338, 682, 698, 1554, 1585]","[490, 916]",1747,12,1735,2,10,1735,0
3.5,HSAPOAIA,"[57, 317, 583, 661, 1397, 1409, 1799, 1849, 2090, 2177]","[317, 661]","[57, 583, 1397, 1409, 1799, 1849, 2090, 2177]","[317, 661]",2183,10,2173,2,8,2173,0
3.5,HSAPOAIT,"[120, 231, 491, 757, 835, 1572, 1584, 1974, 2024, 2143, 2265, 2353]","[491, 835]","[120, 231, 757, 1572, 1584, 1974, 2024, 2143, 2265, 2353]","[491, 835]",2377,12,2365,2,10,2365,0
3.5,HSAPOC2G,"[33, 231, 255, 273, 606, 645, 790, 946, 1276, 1494, 1505, 1553, 1572, 1971, 2021, 2037, 2121, 2148, 2191, 2346, 2358, 2401, 2479, 2714, 2943, 3041]","[2714, 3041]","[33, 231, 255, 273, 606, 645, 790, 946, 1276, 1494, 1505, 1553, 1572, 1971, 2021, 2037, 2121, 2148, 2191, 2346, 2358, 2401, 2479, 2943]","[2714, 3041]",3832,26,3806,2,24,3806,0
3.5,HSAQUPN2,"[236, 299, 431, 497, 632, 794, 917]","[431, 632]","[236, 299, 497, 794, 917]","[431, 632, 746]",987,7,980,2,5,979,1
3.5,HSARYLA,"[275, 413, 459, 560, 848, 1091, 1238, 1571, 1815, 1906, 1991, 2004, 2052, 2141, 2252, 2470, 2479, 2528, 2666, 3040, 3432, 3567]","[848, 1238, 1571, 1815, 2252, 2470]","[275, 413, 459, 560, 1091, 1906, 1991, 2004, 2052, 2141, 2479, 2528, 2666, 3040, 3432, 3567]","[848, 1238, 1571, 1815, 2252, 2470, 2823]",3629,22,3607,6,16,3606,1
3.5,HSAT3,"[160, 257, 280, 327, 646, 655, 825, 2225, 2451, 2846, 3311, 4422, 4823, 4978, 5095, 5305, 5311, 5717, 6015, 6059, 6235, 6645, 6879, 6934, 6938, 7102, 7225, 7231, 8050, 8072, 8303, 8536, 8551, 8570, 8733, 9045, 9139, 9260, 9625, 9717, 9730, 10089, 10131, 10336, 10401, 10776, 10948, 11303, 11320, 11660, 11748, 11977, 12007, 12165, 12249, 12547, 12555, 12719, 13056, 13092, 13487, 13775]","[646, 3311, 6059, 7102, 8303, 10401]","[160, 257, 280, 327, 655, 825, 2225, 2451, 2846, 4422, 4823, 4978, 5095, 5305, 5311, 5717, 6015, 6235, 6645, 6879, 6934, 6938, 7225, 7231, 8050, 8072, 8536, 8551, 8570, 8733, 9045, 9139, 9260, 9625, 9717, 9730, 10089, 10131, 10336, 10776, 10948, 11303, 11320, 11660, 11748, 11977, 12007, 12165, 12249, 12547, 12555, 12719, 13056, 13092, 13487, 13775]","[646, 3311, 6059, 7102, 8303, 10401]",14198,62,14136,6,56,14136,0
3.5,HSATPCP1,"[26, 158, 496, 534, 673, 705, 831, 989, 1257, 1518, 1680, 1838, 1994, 2127, 2133, 2258, 2347, 2691, 2846, 2889, 3013, 3045, 3169, 4036, 4080, 4245, 4726, 4773, 4843, 4975, 5389, 5394, 5525, 5924, 5934, 6099, 6382, 6830, 6843, 6860, 6865, 6999, 7017, 7267, 7430, 7698, 7854, 7927, 8207, 8529, 8701, 8708, 8714, 8947, 9101]","[5389, 6382, 7267]","[26, 158, 496, 534, 673, 705, 831, 989, 1257, 1518, 1680, 1838, 1994, 2127, 2133, 2258, 2347, 2691, 2846, 2889, 3013, 3045, 3169, 4036, 4080, 4245, 4726, 4773, 4843, 4975, 5394, 5525, 5924, 5934, 6099, 6830, 6843, 6860, 6865, 6999, 7017, 7430, 7698, 7854, 7927, 8207, 8529, 8701, 8708, 8714, 8947, 9101]","[5389, 6382, 7267]",9449,55,9394,3,52,9394,0
3.5,HSATPCP2,"[6, 107, 1210, 1546, 1683, 2402, 2996, 3326, 3624, 3721, 3824, 3890, 4013, 4180, 4668, 4692, 4738, 4743, 5367, 6152, 6504, 6916, 7005, 7310, 7490, 7756, 7768, 8252, 8414, 8638, 8957, 9194, 9212, 9627, 9637, 9647, 9689, 9752, 9790, 10099, 10195, 10918, 10966, 11516, 11530, 11602, 11686, 11693, 11736, 12001, 12044, 12342, 12497, 13004, 13012, 13249, 13435, 13810, 13888, 14022]","[7490, 10195, 10918]","[6, 107, 1210, 1546, 1683, 2402, 2996, 3326, 3624, 3721, 3824, 3890, 4013, 4180, 4668, 4692, 4738, 4743, 5367, 6152, 6504, 6916, 7005, 7310, 7756, 7768, 8252, 8414, 8638, 8957, 9194, 9212, 9627, 9637, 9647, 9689, 9752, 9790, 10099, 10966, 11516, 11530, 11602, 11686, 11693, 11736, 12001, 12044, 12342, 12497, 13004, 13012, 13249, 13435, 13810, 13888, 14022]","[7490, 10195, 10918]",15008,60,14948,3,57,14948,0
3.5,HSB3A,"[580, 890, 1175, 1424, 1843, 1940, 2085, 2623, 2640, 2655, 2659, 2670, 3047, 3139, 3166, 3203, 3474]",[1843],"[580, 890, 1175, 1424, 1940, 2085, 2623, 2640, 2655, 2659, 2670, 3047, 3139, 3166, 3203, 3474]",[1843],3675,17,3658,1,16,3658,0
3.5,HSBGPG,"[29, 151, 560, 817, 850, 856, 1096, 1212, 1340, 1344, 1593, 1645]","[560, 850, 1096]","[29, 151, 817, 856, 1212, 1340, 1344, 1593, 1645]","[560, 850, 1096]",1667,12,1655,3,9,1655,0
3.5,HSBSF2,"[238, 318, 477, 1242, 1587, 1621, 2089, 2450, 2748, 2847, 2930, 2956, 3022, 3106, 3336, 3601, 4086, 4317, 4358, 4427, 4505, 4715, 4895, 4943, 5688]","[1242, 1587, 2748, 3601]","[238, 318, 477, 1621, 2089, 2450, 2847, 2930, 2956, 3022, 3106, 3336, 4086, 4317, 4358, 4427, 4505, 4715, 4895, 4943, 5688]","[1242, 1587, 2748, 3601]",5953,25,5928,4,21,5928,0
3.5,HSCBMYHC,"[62, 278, 297, 345, 369, 649, 1577, 2228, 2258, 2583, 2735, 2805, 2858, 2868, 3016, 3193, 3218, 3301, 3592, 3819, 3833, 3932, 4092, 4595, 4612, 4776, 4921, 5041, 5485, 5644, 6160, 6529, 6694, 6814, 7026, 7246, 7567, 7609, 7735, 7912, 8095, 8354, 8647, 8867, 8898, 8933, 9024, 9084, 9174, 9626, 9885, 9909, 10530, 10554, 10877, 11339, 11536, 12155, 12159, 12229, 12303, 12427, 12635, 12786, 12825, 12829, 13037, 13342, 14042, 14210, 14394, 14571, 14806, 15120, 15375, 15416, 15683, 15784, 16410, 16665, 17120, 18138, 18228, 18590, 18734, 18777, 18896, 19262, 19469, 19970, 20028, 20057, 20132, 20604, 20964, 21352, 21466, 21505, 21576, 21839, 22088, 22369, 22423, 22474, 22486, 22643, 23176, 23209, 23454, 23605, 23701, 23830, 24128, 24751, 24794]","[4595, 5041, 5485, 5644, 6529, 6694, 7246, 7567, 8354, 8898, 9174, 9626, 10530, 10877, 11339, 12155, 12427, 12829, 13342, 14210, 14571, 17120, 18228, 18590, 18896, 19262, 19970, 20604, 21466, 21839, 22088, 22474, 23454, 23701]","[62, 278, 297, 345, 369, 649, 1577, 2228, 2258, 2583, 2735, 2805, 2858, 2868, 3016, 3193, 3218, 3301, 3592, 3819, 3833, 3932, 4092, 4612, 4776, 4921, 6160, 6814, 7026, 7609, 7735, 7912, 8095, 8647, 8867, 8933, 9024, 9084, 9885, 9909, 10554, 11536, 12159, 12229, 12303, 12635, 12786, 12825, 13037, 14042, 14394, 14806, 15120, 15375, 15416, 15683, 15784, 16410, 16665, 18138, 18734, 18777, 19469, 20028, 20057, 20132, 20964, 21352, 21505, 21576, 22369, 22423, 22486, 22643, 23176, 23209, 23605, 23830, 24128, 24751, 24794]","[4595, 5041, 5485, 5644, 6354, 6529, 6694, 7246, 7567, 8354, 8898, 9174, 9626, 10530, 10877, 11339, 12155, 12427, 12829, 13342, 14210, 14571, 15900, 17120, 18228, 18590, 18896, 19262, 19970, 20319, 20604, 21466, 21839, 22088, 22474, 23454, 23701]",24992,115,24877,34,81,24874,3
3.5,HSCD14G,"[159, 514, 562, 763, 986, 1114, 1318]",[159],"[514, 562, 763, 986, 1114, 1318]",[159],1562,7,1555,1,6,1555,0
3.5,HSCKBG,"[98, 236, 347, 657, 876, 1075, 1244, 1341, 1619, 1733, 1824, 2068, 2099, 2124, 2380, 2552, 2570, 2638, 2643, 2746, 2877, 3022, 3174, 3434, 3521, 3534, 3620, 4078]","[1341, 1619, 1824, 2380, 3174, 3521]","[98, 236, 347, 657, 876, 1075, 1244, 1733, 2068, 2099, 2124, 2552, 2570, 2638, 2643, 2746, 2877, 3022, 3434, 3534, 3620, 4078]","[1341, 1619, 1824, 2380, 3174, 3521]",4192,28,4164,6,22,4164,0
3.5,HSCOMT2,"[197, 589, 636, 703, 911, 936, 1075, 1959, 2212, 2350, 2378, 2547, 2827, 2897, 2920, 3082, 3091, 3503]","[1959, 2378]","[197, 589, 636, 703, 911, 936, 1075, 2212, 2350, 2547, 2827, 2897, 2920, 3082, 3091, 3503]","[1630, 1959, 2378]",3643,18,3625,2,16,3624,1
3.5,HSCPH70,"[11, 205, 297, 633, 773, 829, 865, 926, 1057, 1302, 1784, 2936, 3382, 3675, 3831, 3895, 4204, 4407, 4801, 5251, 5666, 6024]","[4204, 4407, 4801]","[11, 205, 297, 633, 773, 829, 865, 926, 1057, 1302, 1784, 2936, 3382, 3675, 3831, 3895, 5251, 5666, 6024]","[1729, 4204, 4407, 4801]",6703,22,6681,3,19,6680,1
3.5,HSCSF1PO,"[359, 496, 534, 678, 779, 1290, 1433, 1965, 2385, 2428, 2591, 2704, 2816, 3283, 3327, 3691, 3740, 3777, 3815, 4479, 4703, 4825, 5071, 5393, 5398, 5510, 5647, 6017, 6274, 6579, 6651, 6706, 7061, 7314, 7376, 7572, 7831, 7943, 8115, 8121, 8250, 8287, 8486, 8680, 8694, 8699, 8725, 8843, 8847, 8876, 8943, 9217, 9575, 9665, 9857, 9882, 10134, 10227, 10249, 10444, 10517, 11059, 11063, 11092, 11111, 11515, 11707, 11723, 12101, 12296, 12404, 12436, 12482, 12926, 12953, 12975, 13021, 13044, 13436, 13526, 13657, 13951, 14645, 14683, 14890, 15036, 15082, 15556, 15733, 15783, 15792, 15804, 16061, 16103, 17256, 17480, 17882, 17968, 18046, 18156, 18208, 18274, 18350, 18465, 18756, 19403, 19724, 20123, 20151, 20159, 20177, 20510, 21307, 21311, 21444, 23086, 23437, 23668, 24059, 24072, 24260, 24749, 24806, 25151, 25196, 25492, 25690, 25817, 26033, 26044, 26095, 26605, 26732, 26837, 26841, 26963, 27465, 27837, 27905, 28627, 29084, 29206, 29926, 30172, 30657, 30823, 30890, 31040, 31077, 31133, 31351, 31663, 31739, 31836, 31942, 32108, 32301, 32402, 32862, 33041, 33463, 33729, 33743, 33816, 34006, 34015, 34027, 34038, 34158, 34399, 34417, 34668, 34831]","[1965, 7572, 8287, 10227, 11063, 15036, 17882, 18156, 18465, 20123, 26605, 26837, 27465, 28627, 30823, 31040, 32108, 32301, 34006]","[359, 496, 534, 678, 779, 1290, 1433, 2385, 2428, 2591, 2704, 2816, 3283, 3327, 3691, 3740, 3777, 3815, 4479, 4703, 4825, 5071, 5393, 5398, 5510, 5647, 6017, 6274, 6579, 6651, 6706, 7061, 7314, 7376, 7831, 7943, 8115, 8121, 8250, 8486, 8680, 8694, 8699, 8725, 8843, 8847, 8876, 8943, 9217, 9575, 9665, 9857, 9882, 10134, 10249, 10444, 10517, 11059, 11092, 11111, 11515, 11707, 11723, 12101, 12296, 12404, 12436, 12482, 12926, 12953, 12975, 13021, 13044, 13436, 13526, 13657, 13951, 14645, 14683, 14890, 15082, 15556, 15733, 15783, 15792, 15804, 16061, 16103, 17256, 17480, 17968, 18046, 18208, 18274, 18350, 18756, 19403, 19724, 20151, 20159, 20177, 20510, 21307, 21311, 21444, 23086, 23437, 23668, 24059, 24072, 24260, 24749, 24806, 25151, 25196, 25492, 25690, 25817, 26033, 26044, 26095, 26732, 26841, 26963, 27837, 27905, 29084, 29206, 29926, 30172, 30657, 30890, 31077, 31133, 31351, 31663, 31739, 31836, 31942, 32402, 32862, 33041, 33463, 33729, 33743, 33816, 34015, 34027, 34038, 34158, 34399, 34417, 34668, 34831]","[1965, 7572, 8287, 10227, 11063, 15036, 17882, 18156, 18465, 20123, 26605, 26837, 27465, 28627, 30823, 31040, 32108, 32301, 33091, 34006]",35092,173,34919,19,154,34918,1
3.5,HSCST3G,"[271, 330, 536, 888, 931, 1006, 1145, 1328, 1661, 2234, 2342, 3064, 3155, 3443, 3468, 3694, 3783, 3865, 3879, 3938, 4063, 4123, 4129, 4620, 4741, 4813, 5241, 5518, 5990, 6231, 6293, 6448, 6521, 6582, 6632, 6921, 7112]","[1328, 3694]","[271, 330, 536, 888, 931, 1006, 1145, 1661, 2234, 2342, 3064, 3155, 3443, 3468, 3783, 3865, 3879, 3938, 4063, 4123, 4129, 4620, 4741, 4813, 5241, 5518, 5990, 6231, 6293, 6448, 6521, 6582, 6632, 6921, 7112]","[1328, 3694]",7284,37,7247,2,35,7247,0
3.5,HSCYCLA,"[274, 1029, 1049, 1098, 1102, 1333, 1393, 1422, 1530, 2406, 2439, 2509, 2940, 2954, 3031, 3668, 3731, 3962, 4024, 4168, 4520, 4538, 4614, 5338, 5389, 5670, 5911, 6070, 6323, 6667, 6982, 7024, 7439, 7622, 7956, 7973, 8050, 8113]","[1393, 2406, 3731, 4168, 5338, 5911, 6667]","[274, 1029, 1049, 1098, 1102, 1333, 1422, 1530, 2439, 2509, 2940, 2954, 3031, 3668, 3962, 4024, 4520, 4538, 4614, 5389, 5670, 6070, 6323, 6982, 7024, 7439, 7622, 7956, 7973, 8050, 8113]","[1393, 2406, 3731, 4168, 5338, 5911, 6667]",8355,38,8317,7,31,8317,0
3.5,HSCYP216,"[255, 302, 442, 567, 629, 665, 874, 879, 1088, 1278, 1466, 1475, 1836, 1888, 2215, 2239, 2402]","[255, 442, 879, 1088, 1278, 1466, 1836, 2215, 2402]","[302, 567, 629, 665, 874, 1475, 1888, 2239]","[255, 442, 879, 1088, 1278, 1466, 1836, 2215, 2402]",2763,17,2746,9,8,2746,0
3.5,HSCYP45C,"[185, 731, 828, 947, 1256, 1688, 1772, 2048, 2667, 3358, 3538, 3542, 3975, 4405, 4603, 4680, 4942, 4963, 5008, 5624, 5801, 6016, 6248, 6525, 6562, 6694, 6935, 7081, 7429]","[4942, 5624, 5801, 6016, 6248]","[185, 731, 828, 947, 1256, 1688, 1772, 2048, 2667, 3358, 3538, 3542, 3975, 4405, 4603, 4680, 4963, 5008, 6525, 6562, 6694, 6935, 7081, 7429]","[4942, 5624, 5801, 6016, 6248]",7546,29,7517,5,24,7517,0
3.5,HSCYTOK17,"[396, 452, 488, 581, 982, 1422, 1709, 1951, 1963, 2079, 2304, 2857, 2928, 2935, 3066, 3131, 3171, 3245, 3257, 3288, 3382, 3468, 3601, 3625, 3693, 4000, 4123, 4972, 4987]","[581, 1709, 2304, 3066, 3693, 4000, 4123]","[396, 452, 488, 982, 1422, 1951, 1963, 2079, 2857, 2928, 2935, 3131, 3171, 3245, 3257, 3288, 3382, 3468, 3601, 3625, 4972, 4987]","[581, 1709, 2304, 3066, 3693, 4000, 4123]",5252,29,5223,7,22,5223,0
3.5,HSCYTOK20,"[60, 116, 203, 1277, 1871, 2287, 2601, 2644, 3128, 3978, 4019, 4075, 4732, 5047, 5152, 5205, 5281, 5352, 6824, 7135, 7290, 7458, 7512, 8061, 8134, 8722, 8760, 9313, 9470, 9642, 9984, 10005, 10271, 10620, 10714, 10828, 11052, 11206, 11499, 11940, 12458, 12705, 12783, 12902, 12915, 13941, 15297, 15384, 15989, 16190, 16343, 16347, 16498, 16620, 16791, 17174, 17254]","[5281, 7512, 9470, 9984, 10271, 11940, 12705]","[60, 116, 203, 1277, 1871, 2287, 2601, 2644, 3128, 3978, 4019, 4075, 4732, 5047, 5152, 5205, 5352, 6824, 7135, 7290, 7458, 8061, 8134, 8722, 8760, 9313, 9642, 10005, 10620, 10714, 10828, 11052, 11206, 11499, 12458, 12783, 12902, 12915, 13941, 15297, 15384, 15989, 16190, 16343, 16347, 16498, 16620, 16791, 17174, 17254]","[5281, 7512, 9470, 9984, 10271, 11940, 12705]",18053,57,17996,7,50,17996,0
3.5,HSDAO,"[588, 956, 1035, 1080, 1111, 1177, 1263, 1329, 1381, 1437, 1635, 1665, 1751, 2197, 2229, 2351, 2551, 2582, 2775, 2877, 2974, 3236, 3885, 3987, 4423, 4584, 4623, 5121, 5561, 5744, 5903, 6200, 6426, 6696, 7384, 7431, 7461, 7766, 7871, 7903, 8028, 8329, 8347, 8502, 8880, 9013, 9276, 9343]","[6426, 7431, 9013]","[588, 956, 1035, 1080, 1111, 1177, 1263, 1329, 1381, 1437, 1635, 1665, 1751, 2197, 2229, 2351, 2551, 2582, 2775, 2877, 2974, 3236, 3885, 3987, 4423, 4584, 4623, 5121, 5561, 5744, 5903, 6200, 6696, 7384, 7461, 7766, 7871, 7903, 8028, 8329, 8347, 8502, 8880, 9276, 9343]","[6426, 7431, 9013]",9895,48,9847,3,45,9847,0
3.5,HSERPG,"[143, 628, 1303, 1340, 1683, 1774, 1943, 2026, 2069, 2290, 2474, 2509, 2768]","[628, 1340, 1683, 2474]","[143, 1303, 1774, 1943, 2026, 2069, 2290, 2509, 2768]","[628, 1340, 1683, 2474]",3390,13,3377,4,9,3377,0
3.5,HSFAU1,"[335, 432, 505, 547, 655, 824, 857, 1096, 1100, 1129, 1140, 1557, 1592, 1599, 1613, 1617, 1821, 2004]","[857, 1096, 1613]","[335, 432, 505, 547, 655, 824, 1100, 1129, 1140, 1557, 1592, 1599, 1617, 1821, 2004]","[857, 1096, 1613]",2008,18,1990,3,15,1990,0
3.5,HSFESFPS,"[8, 13, 513, 543, 608, 728, 738, 771, 872, 1227, 1248, 1553, 1650, 1781, 1889, 3023, 3180, 3336, 3435, 3637, 3645, 3726, 3769, 3797, 3873, 3923, 4008, 4522, 4532, 4547, 5028, 5154, 5405, 5598, 5924, 6108, 6240, 6445, 6767, 7063, 7089, 7150, 7230, 7330, 7345, 7634, 7757, 7836, 8020, 8052, 8069, 8349, 8546, 8598, 8720, 8782, 9087, 9151, 9176, 9294, 9315, 9371, 9424, 9768, 10015, 10445, 10483, 10626, 10664, 10965, 10996, 11068, 11128, 11511, 11788, 11865, 12034, 12062, 12225]","[1227, 1553, 3023, 3336, 5405, 5598, 5924, 6240, 6445, 7150, 7634, 8069, 8782, 9151, 9371, 9768, 10015]","[8, 13, 513, 543, 608, 728, 738, 771, 872, 1248, 1650, 1781, 1889, 3180, 3435, 3637, 3645, 3726, 3769, 3797, 3873, 3923, 4008, 4522, 4532, 4547, 5028, 5154, 6108, 6767, 7063, 7089, 7230, 7330, 7345, 7757, 7836, 8020, 8052, 8349, 8546, 8598, 8720, 9087, 9176, 9294, 9315, 9424, 10445, 10483, 10626, 10664, 10965, 10996, 11068, 11128, 11511, 11788, 11865, 12034, 12062, 12225]","[1227, 1553, 3023, 3336, 5405, 5598, 5924, 6240, 6445, 7150, 7634, 8069, 8782, 9151, 9371, 9768, 10015]",12255,79,12176,17,62,12176,0
3.5,HSGCSFG,"[264, 404, 540, 690, 735, 739, 744, 748, 774, 970, 1230, 1521, 1999, 2121, 2296, 2514]","[404, 744, 1230, 1521]","[264, 540, 690, 735, 739, 748, 774, 970, 1999, 2121, 2296, 2514]","[404, 744, 1230, 1521]",2952,16,2936,4,12,2936,0
3.5,HSGEBCMA,"[334, 607, 700, 888, 983, 1137, 1206, 1294, 1349, 1496, 1545, 1648, 2292, 2430, 2587, 2766, 3234, 3273, 3292, 3409, 3489, 3607]","[607, 1496]","[334, 700, 888, 983, 1137, 1206, 1294, 1349, 1545, 1648, 2292, 2430, 2587, 2766, 3234, 3273, 3292, 3409, 3489, 3607]","[607, 1496]",3711,22,3689,2,20,3689,0
3.5,HSGGL2,"[164, 202, 433, 547, 882, 1055, 1067]","[202, 547]","[164, 433, 882, 1055, 1067]","[202, 547]",1620,7,1613,2,5,1613,0
3.5,HSGLA,"[94, 779, 852, 868, 885, 901, 937, 955, 1102, 1374, 1822, 1826, 2011, 2148, 2339, 2472, 2499, 3422, 4062, 4106, 4149, 4435, 5022, 5040, 5093, 5269, 5308, 5575, 5717, 6672, 6740, 6958, 6983, 7164, 7447, 7846, 7915, 8012, 8167, 8378, 8413, 9335, 10329, 10359, 10369, 10708, 11096, 11472, 11761, 12168, 12322]","[1374, 5269, 7447, 8413, 10708]","[94, 779, 852, 868, 885, 901, 937, 955, 1102, 1822, 1826, 2011, 2148, 2339, 2472, 2499, 3422, 4062, 4106, 4149, 4435, 5022, 5040, 5093, 5308, 5575, 5717, 6672, 6740, 6958, 6983, 7164, 7846, 7915, 8012, 8167, 8378, 9335, 10329, 10359, 10369, 11096, 11472, 11761, 12168, 12322]","[1374, 5269, 7447, 8413, 10293, 10708]",12428,51,12377,5,46,12376,1
3.5,HSGROW2,"[92, 211, 345, 462, 899, 1091]","[345, 1091]","[92, 211, 462, 899]","[345, 762, 1091, 1349]",1956,6,1950,2,4,1948,2
3.5,HSGSTM4,"[37, 41, 117, 391, 466, 522, 778, 874, 1262, 1296, 1357, 1458, 1793, 2098, 2142, 2232, 2469, 2670, 2907, 2960, 3139, 3277, 3366, 3484, 3511, 3516, 3623, 3953, 3984, 3991, 4183, 4343]","[37, 391, 874, 1262, 1458, 2469, 2670]","[41, 117, 466, 522, 778, 1296, 1357, 1793, 2098, 2142, 2232, 2907, 2960, 3139, 3277, 3366, 3484, 3511, 3516, 3623, 3953, 3984, 3991, 4183, 4343]","[37, 391, 874, 1262, 1458, 2469, 2670]",4834,32,4802,7,25,4802,0
3.5,HSGTRH,"[442, 515, 536, 1193, 1293, 1301, 1847, 1927, 2111, 2205, 2322, 2431, 2502, 2809, 2814, 3141, 3732, 3816, 5548, 5645, 5766, 5921, 6094, 6275, 6449, 6552]","[2205, 3816]","[442, 515, 536, 1193, 1293, 1301, 1847, 1927, 2111, 2322, 2431, 2502, 2809, 2814, 3141, 3732, 5548, 5645, 5766, 5921, 6094, 6275, 6449, 6552]","[2205, 3816]",7216,26,7190,2,24,7190,0
3.5,HSHMG17G,"[139, 283, 400, 651, 856, 911, 1043, 1117, 1538, 1793, 2037, 2279, 2335, 2524, 2927, 2946, 3403, 3415, 3473, 3620, 3705, 4021, 4342, 4469, 4553, 4815, 4833, 4854, 4929, 5014, 5920, 5937, 6844, 7087, 7188]","[2524, 3415, 3620, 4021, 4553]","[139, 283, 400, 651, 856, 911, 1043, 1117, 1538, 1793, 2037, 2279, 2335, 2927, 2946, 3403, 3473, 3705, 4342, 4469, 4815, 4833, 4854, 4929, 5014, 5920, 5937, 6844, 7087, 7188]","[2524, 3415, 3620, 4021, 4553]",7187,35,7152,5,30,7152,0
3.5,HSHNRNPA,"[49, 220, 318, 707, 814, 868, 1086, 1159, 1494, 1789, 1936, 2100, 2295, 2481, 2511, 2615, 2660, 2869, 2988, 3229, 3559, 3602, 3773, 3962, 4312, 5159]","[814, 1494, 1936, 2295, 2481, 2660, 2869, 3962]","[49, 220, 318, 707, 868, 1086, 1159, 1789, 2100, 2511, 2615, 2988, 3229, 3559, 3602, 3773, 4312, 5159]","[814, 1494, 1936, 2295, 2481, 2660, 2869, 3962]",5360,26,5334,8,18,5334,0
3.5,HSHOX51,"[9, 698, 703, 760, 1278, 1425, 1475, 1651, 1791, 2052, 2126, 2201, 2393, 2415, 2425, 2519, 2611, 2690, 3022, 3601, 4023, 4643, 4748, 4921, 4940, 5208, 6206]",[2052],"[9, 698, 703, 760, 1278, 1425, 1475, 1651, 1791, 2126, 2201, 2393, 2415, 2425, 2519, 2611, 2690, 3022, 3601, 4023, 4643, 4748, 4921, 4940, 5208, 6206]",[2052],6297,27,6270,1,26,6270,0
3.5,HSHSC70,"[27, 41, 54, 59, 119, 305, 456, 777, 913, 1194, 1245, 1313, 1773, 1778, 2052, 2250, 2533, 2550, 2893, 2938, 3307, 3734, 3841, 3908, 4114, 4329, 4735, 4819, 4910, 5145, 5194, 5253, 5330, 5378]","[1245, 1773, 2250, 2893, 3307, 3734, 4114]","[27, 41, 54, 59, 119, 305, 456, 777, 913, 1194, 1313, 1778, 2052, 2533, 2550, 2938, 3841, 3908, 4329, 4735, 4819, 4910, 5145, 5194, 5253, 5330, 5378]","[1245, 1773, 2250, 2893, 3307, 3734, 4114]",5400,34,5366,7,27,5366,0
3.5,HSIFNAR,"[329, 365, 394, 429, 549, 568, 583, 616, 631, 654, 712, 830, 869, 1043, 1218, 1356, 1404, 1420, 1437, 1540, 1597, 2165, 2445, 2605, 2612, 2684, 2696, 3337, 4103, 4272, 4481, 4612, 5386, 5712, 5843, 7631, 7694, 7976, 8112, 8182, 8569, 8594, 9219, 9606, 10270, 10423, 10677, 10800, 11127, 11325, 11655, 11687, 11832, 12704, 12838, 13828, 13884, 14172, 14247, 14793, 14937, 15058, 15464, 15482, 15686, 16062, 16084, 16909, 16944, 17681, 17725, 17942, 18117, 18394, 18426, 18564, 19188, 19220, 19442, 19858, 19910, 20036, 20088, 20346, 20795, 20837, 21132, 21239, 21243, 21261, 21610, 22130, 22538, 22586, 22719, 23043, 23136, 23180, 23783, 23985, 24341, 24359, 24515, 24742, 25061, 25314, 25630, 25777, 26285, 26578, 26897, 27001, 27236, 27240, 27744, 27840, 27880, 27952, 28142, 28272, 28315, 28489, 28657, 28679, 29018, 29168, 29554, 29885, 29899, 30053, 30214, 30400, 30452, 30489, 30881, 30998, 31727, 31769, 31918, 32103]","[830, 11325, 16944, 19188, 19442, 21132, 25061, 25314, 28679, 29554]","[329, 365, 394, 429, 549, 568, 583, 616, 631, 654, 712, 869, 1043, 1218, 1356, 1404, 1420, 1437, 1540, 1597, 2165, 2445, 2605, 2612, 2684, 2696, 3337, 4103, 4272, 4481, 4612, 5386, 5712, 5843, 7631, 7694, 7976, 8112, 8182, 8569, 8594, 9219, 9606, 10270, 10423, 10677, 10800, 11127, 11655, 11687, 11832, 12704, 12838, 13828, 13884, 14172, 14247, 14793, 14937, 15058, 15464, 15482, 15686, 16062, 16084, 16909, 17681, 17725, 17942, 18117, 18394, 18426, 18564, 19220, 19858, 19910, 20036, 20088, 20346, 20795, 20837, 21239, 21243, 21261, 21610, 22130, 22538, 22586, 22719, 23043, 23136, 23180, 23783, 23985, 24341, 24359, 24515, 24742, 25630, 25777, 26285, 26578, 26897, 27001, 27236, 27240, 27744, 27840, 27880, 27952, 28142, 28272, 28315, 28489, 28657, 29018, 29168, 29885, 29899, 30053, 30214, 30400, 30452, 30489, 30881, 30998, 31727, 31769, 31918, 32103]","[830, 11325, 16944, 19188, 19442, 21132, 25061, 25314, 28679, 29554]",32898,140,32758,10,130,32758,0
3.5,HSIFNG,"[63, 136, 589, 835, 976, 1897, 2175, 2347, 2364, 2413, 2442, 2446, 3213, 3516, 3631, 3690, 3742, 3833, 4115, 4278, 4482, 5167, 5305, 5853]","[589, 1897, 2175]","[63, 136, 835, 976, 2347, 2364, 2413, 2442, 2446, 3213, 3516, 3631, 3690, 3742, 3833, 4115, 4278, 4482, 5167, 5305, 5853]","[589, 1897, 2175]",5953,24,5929,3,21,5929,0
3.5,HSIL1AG,"[826, 916, 1489, 1617, 1830, 1987, 2208, 2641, 2949, 3215, 3631, 3939, 4118, 4326, 4847, 5019, 5155, 5343, 5552, 5580, 6433, 7173, 7384, 7604, 7666, 7940, 8025, 8132, 8526, 8943, 8989, 9035, 9081, 9174, 9290, 9436, 9875, 10013, 10321, 10487, 11229, 11703]","[2208, 3215, 4326, 6433, 7940]","[826, 916, 1489, 1617, 1830, 1987, 2641, 2949, 3631, 3939, 4118, 4847, 5019, 5155, 5343, 5552, 5580, 7173, 7384, 7604, 7666, 8025, 8132, 8526, 8943, 8989, 9035, 9081, 9174, 9290, 9436, 9875, 10013, 10321, 10487, 11229, 11703]","[2208, 3215, 4326, 6433, 7940]",11962,42,11920,5,37,11920,0
3.5,HSIL1B,"[735, 821, 935, 1296, 1352, 1446, 1515, 1565, 1855, 2240, 2528, 3144, 3269, 3903, 4383, 4477, 4485, 4554, 5220, 5657, 6039, 6555, 7121, 7406, 8995, 9010, 9336, 9353, 9692]","[2528, 3144, 6039, 7406]","[735, 821, 935, 1296, 1352, 1446, 1515, 1565, 1855, 2240, 3269, 3903, 4383, 4477, 4485, 4554, 5220, 5657, 6555, 7121, 8995, 9010, 9336, 9353, 9692]","[2528, 3144, 5327, 6039, 7406]",9703,29,9674,4,25,9673,1
3.5,HSINT2,"[439, 516, 1156, 1285, 2267, 2467, 2792, 3197, 3282, 3420, 3471, 3509, 3549, 3567, 3790, 4140, 4327, 5335, 5386, 6546, 6824, 6954, 7600, 8668, 8973, 9056, 9331, 9443, 9480, 10216, 10228, 10232, 10273, 10458, 10533, 10644, 10708, 10736, 11148, 11551, 11562]","[1156, 3549]","[439, 516, 1285, 2267, 2467, 2792, 3197, 3282, 3420, 3471, 3509, 3567, 3790, 4140, 4327, 5335, 5386, 6546, 6824, 6954, 7600, 8668, 8973, 9056, 9331, 9443, 9480, 10216, 10228, 10232, 10273, 10458, 10533, 10644, 10708, 10736, 11148, 11551, 11562]","[1156, 3549]",11600,41,11559,2,39,11559,0
3.5,HSL7A,"[122, 420, 1133, 1288, 1408, 1989, 2073, 2077, 2576, 2646, 2867, 3127, 3259, 3525, 4052, 4164, 4259, 4564, 4572, 4781, 4919, 5073]","[2073, 2867, 3525, 4164, 4572, 4919]","[122, 420, 1133, 1288, 1408, 1989, 2077, 2576, 2646, 3127, 3259, 4052, 4259, 4564, 4781, 5073]","[2073, 2867, 3525, 3881, 4164, 4572, 4919]",5498,22,5476,6,16,5475,1
3.5,HSLCATG,"[361, 991, 1261, 1352, 1590, 1620, 1629, 1636, 1672, 1704, 1881, 2076, 2266, 2305, 2574, 2609, 3577, 3893, 4200, 4283, 4458, 4812, 5051, 5147, 5320, 5331, 5372, 5638, 5649, 5873, 5914, 6028, 6060, 6184, 6357, 6402, 6420, 6574, 6705, 6743]","[991, 1881, 2076, 2266, 2574]","[361, 1261, 1352, 1590, 1620, 1629, 1636, 1672, 1704, 2305, 2609, 3577, 3893, 4200, 4283, 4458, 4812, 5051, 5147, 5320, 5331, 5372, 5638, 5649, 5873, 5914, 6028, 6060, 6184, 6357, 6402, 6420, 6574, 6705, 6743]","[991, 1881, 2076, 2266, 2574]",6893,40,6853,5,35,6853,0
3.5,HSMECDAG,"[93, 230, 387, 471, 716, 923, 1153, 1198, 1393, 1430, 1456, 1805, 2149, 2517, 2584, 2588, 2593, 2597, 2601, 2616, 2776, 2870, 2966, 3072, 3090, 3162, 3170, 3202, 3245, 3353, 3544, 3673, 3852, 3939, 4095, 4361]","[1393, 2517, 2776, 2966, 3544, 3852]","[93, 230, 387, 471, 716, 923, 1153, 1198, 1430, 1456, 1805, 2149, 2584, 2588, 2593, 2597, 2601, 2616, 2870, 3072, 3090, 3162, 3170, 3202, 3245, 3353, 3673, 3939, 4095, 4361]","[1393, 2517, 2776, 2966, 3544, 3852]",4362,36,4326,6,30,4326,0
3.5,HSMED,"[36, 52, 139, 277, 307, 360, 413, 466, 519, 619, 636, 789, 812, 896, 967, 1354, 1506, 1592, 1693, 1704, 1774, 1943, 1989, 1993, 1998, 2186, 2315, 3154, 3315, 3529, 3899, 4051, 4355, 4686, 4716, 4762, 4833, 5214, 5218]","[1354, 1943, 2315, 4716]","[36, 52, 139, 277, 307, 360, 413, 466, 519, 619, 636, 789, 812, 896, 967, 1506, 1592, 1693, 1704, 1774, 1989, 1993, 1998, 2186, 3154, 3315, 3529, 3899, 4051, 4355, 4686, 4762, 4833, 5214, 5218]","[1354, 1943, 2315, 4716]",5284,39,5245,4,35,5245,0
3.5,HSMT1H,"[20, 196, 396, 442, 816, 1475, 2125]","[816, 1475]","[20, 196, 396, 442, 2125]","[816, 1475]",2134,7,2127,2,5,2127,0
3.5,HSNCAMX1,"[188, 280, 638, 1174, 1256, 1550, 1609, 1794, 2245, 2381, 2470, 2486, 2537, 2557, 2791, 2808, 2898, 2917, 2974, 4142, 4157, 4190, 4608, 4750, 4778, 5218, 5515, 6024, 6440, 6582, 6983, 7316, 7569, 7640, 7795, 7852, 8033, 8171, 8529, 8552, 8809, 9068, 9083, 9248, 9369, 9373, 9522, 9571, 9863, 10015, 10317, 10722, 11249, 11509, 11667, 11710, 11726, 11870, 12072, 12283, 12467, 12508, 12550, 12786, 12924, 13049, 13302, 13357, 13408, 13487, 13609, 13684, 13893, 14002, 14016, 15056, 15353]","[1609, 4142, 4778, 5218, 6582, 6983, 7316, 7569, 7852, 8529, 8809, 9068, 9373, 9571, 10015, 10317, 10722, 11667, 12072, 12283, 12550, 12786, 13049, 13487, 13893, 14002]","[188, 280, 638, 1174, 1256, 1550, 1794, 2245, 2381, 2470, 2486, 2537, 2557, 2791, 2808, 2898, 2917, 2974, 4157, 4190, 4608, 4750, 5515, 6024, 6440, 7640, 7795, 8033, 8171, 8552, 9083, 9248, 9369, 9522, 9863, 11249, 11509, 11710, 11726, 11870, 12467, 12508, 12924, 13302, 13357, 13408, 13609, 13684, 14016, 15056, 15353]","[1609, 4142, 4778, 5218, 6315, 6582, 6983, 7316, 7569, 7852, 8529, 8809, 9068, 9373, 9571, 10015, 10317, 10722, 11667, 12072, 12283, 12550, 12786, 13049, 13487, 13893, 14002]",16280,77,16203,26,51,16202,1
3.5,HSNFM,"[242, 417, 432, 790, 1188, 1252, 1411, 1741, 1822, 2243, 2311, 2675, 3371, 3772, 3849, 3863, 4020, 4101, 4491, 4575, 4896, 4952, 5057, 5148, 5172, 5234, 5343, 5388]","[1822, 2675]","[242, 417, 432, 790, 1188, 1252, 1411, 1741, 2243, 2311, 3371, 3772, 3849, 3863, 4020, 4101, 4491, 4575, 4896, 4952, 5057, 5148, 5172, 5234, 5343, 5388]","[1822, 2675]",6228,28,6200,2,26,6200,0
3.5,HSODCG,"[362, 455, 735, 1002, 1361, 1589, 1938, 2483, 2612, 2649, 2847, 2912, 3007, 3411, 3454, 3567, 3745, 3968, 4192, 4433, 4445, 4649, 5028, 5421, 5633, 5815, 5893, 6211, 6298, 6336, 6378, 7111, 7208, 7306, 7501, 7614, 7836, 7881, 8052, 8090, 8214, 8758, 8842, 8854, 9013]","[4192, 4649, 5028, 5421, 5633, 5893, 7111, 7306, 7614]","[362, 455, 735, 1002, 1361, 1589, 1938, 2483, 2612, 2649, 2847, 2912, 3007, 3411, 3454, 3567, 3745, 3968, 4433, 4445, 5815, 6211, 6298, 6336, 6378, 7208, 7501, 7836, 7881, 8052, 8090, 8214, 8758, 8842, 8854, 9013]","[4192, 4649, 5028, 5421, 5633, 5893, 7111, 7306, 7614]",9035,45,8990,9,36,8990,0
3.5,HSODF2,"[4, 97, 131, 158, 250, 269, 907, 964, 993, 1375]",[],"[4, 97, 131, 158, 250, 269, 907, 964, 993, 1375]",[600],1422,10,1412,0,10,1411,1
3.5,HSPAT133,"[393, 558, 654, 762, 794, 1126, 1173, 1447, 1707, 1782, 2627, 2995, 3711]",[1447],"[393, 558, 654, 762, 794, 1126, 1173, 1707, 1782, 2627, 2995, 3711]",[1447],3712,13,3699,1,12,3699,0
3.5,HSPLAPL,"[24, 403, 599, 603, 728, 808, 827, 1192, 1225]","[403, 599, 827]","[24, 603, 728, 808, 1192, 1225]","[403, 599, 827]",1274,9,1265,3,6,1265,0
3.5,HSPRB3L,"[279, 356, 386, 415, 566, 616, 789, 896, 1103, 1412, 1537, 2934, 3083, 3376, 3584, 4014, 4236]","[566, 1537]","[279, 356, 386, 415, 616, 789, 896, 1103, 1412, 2934, 3083, 3376, 3584, 4014, 4236]","[566, 1537]",4508,17,4491,2,15,4491,0
3.5,HSPRB4S,"[97, 411, 487, 518, 542, 693, 719, 741, 913, 1018, 1534, 1565, 1658, 2128, 2384, 2495, 2812, 2957, 3462, 3999, 5204]","[693, 1658]","[97, 411, 487, 518, 542, 719, 741, 913, 1018, 1534, 1565, 2128, 2384, 2495, 2812, 2957, 3462, 3999, 5204]","[693, 1658]",5805,21,5784,2,19,5784,0
3.5,HSPSAG,"[46, 403, 447, 872, 1759, 1848, 2383, 2397, 2551, 2594, 2687, 2695, 2834, 3535, 3544, 3611, 3866, 3987, 4044, 4080, 4368, 4427, 4493, 4499, 4648, 5088, 5456]","[447, 1848, 4044]","[46, 403, 872, 1759, 2383, 2397, 2551, 2594, 2687, 2695, 2834, 3535, 3544, 3611, 3866, 3987, 4080, 4368, 4427, 4493, 4499, 4648, 5088, 5456]","[447, 1848, 3764, 4044]",5865,27,5838,3,24,5837,1
3.5,HSRPII145,"[449, 467, 588, 908, 1071, 1086, 1097, 1102, 1157, 1181, 1233, 1302, 1378, 1535, 1615, 1619, 1641, 1688, 1729]","[449, 588, 908, 1071, 1233]","[467, 1086, 1097, 1102, 1157, 1181, 1302, 1378, 1535, 1615, 1619, 1641, 1688, 1729]","[449, 588, 908, 1071, 1233]",2085,19,2066,5,14,2066,0
3.5,HSRPS7,"[55, 115, 264, 284, 404, 415, 516, 1008, 1077, 1599, 1628, 1831, 2166, 2369, 2530, 2551, 3108, 3329, 3383, 3598, 3755, 4254, 4460, 4644, 4654, 5088, 5100, 5409, 5736, 5912, 6064, 6068, 6325, 6386, 6408, 6429, 6734, 6773, 7003, 7045]","[2166, 2369, 3108, 4254, 6734]","[55, 115, 264, 284, 404, 415, 516, 1008, 1077, 1599, 1628, 1831, 2530, 2551, 3329, 3383, 3598, 3755, 4460, 4644, 4654, 5088, 5100, 5409, 5736, 5912, 6064, 6068, 6325, 6386, 6408, 6429, 6773, 7003, 7045]","[2166, 2369, 3108, 4254, 6734]",7505,40,7465,5,35,7465,0
3.5,HSSAA1B,"[13, 349, 527, 862, 1009, 1151, 1543, 1831, 2345, 2367, 2467, 3182, 3845, 3876, 3988, 4007, 4013, 4267, 4403, 4571, 4697, 4712, 4744]","[1543, 3845]","[13, 349, 527, 862, 1009, 1151, 1831, 2345, 2367, 2467, 3182, 3876, 3988, 4007, 4013, 4267, 4403, 4571, 4697, 4712, 4744]","[1543, 3845]",4815,23,4792,2,21,4792,0
3.5,HSSHBG,"[228, 472, 1016, 1058, 1551, 2388, 2575, 2615, 2672, 2679, 2759, 2810, 2823, 2867, 3019, 3148, 3440]","[472, 1058, 1551, 3148]","[228, 1016, 2388, 2575, 2615, 2672, 2679, 2759, 2810, 2823, 2867, 3019, 3440]","[472, 696, 1058, 1551, 1938, 2205, 3148]",3802,17,3785,4,13,3782,3
3.5,HSSSPN1AG,"[155, 418, 589, 1343, 1434, 1635, 1809, 2066, 2280, 2330, 2652, 2975, 3028, 3073, 3360, 3491, 3518, 3781, 3934, 4053]","[1343, 1635, 1809, 3360, 3491]","[155, 418, 589, 1434, 2066, 2280, 2330, 2652, 2975, 3028, 3073, 3518, 3781, 3934, 4053]","[1343, 1635, 1809, 3360, 3491]",4088,20,4068,5,15,4068,0
3.5,HSSURF3,"[200, 284, 288, 743, 813, 1033, 1294, 1692, 2048, 2160, 2209, 2321, 2415, 2721, 2729, 2936, 3074, 3226]","[284, 1033, 1692, 2048, 2321, 2729, 3074]","[200, 288, 743, 813, 1294, 2160, 2209, 2415, 2721, 2936, 3226]","[284, 1033, 1692, 2048, 2321, 2729, 3074]",3407,18,3389,7,11,3389,0
3.5,HSTNFB,"[189, 836, 980, 1202, 1309, 1375, 2691, 3015]",[1375],"[189, 836, 980, 1202, 1309, 2691, 3015]","[1375, 1567]",3029,8,3021,1,7,3020,1
3.5,HSTPI1G,"[730, 746, 837, 919, 972, 1127, 1304, 1558, 1616, 1685, 1817, 2035, 2176, 2231, 2438, 2493, 2821, 3181, 3249, 3760, 3846, 4330, 4376, 4651, 4827, 4845, 4849, 4868]","[746, 2035, 2231, 2438, 2821, 3181]","[730, 837, 919, 972, 1127, 1304, 1558, 1616, 1685, 1817, 2176, 2493, 3249, 3760, 3846, 4330, 4376, 4651, 4827, 4845, 4849, 4868]","[746, 2035, 2231, 2438, 2821, 3181]",4987,28,4959,6,22,4959,0
3.5,HSTUBAG,"[71, 96, 536, 984, 1912, 2065, 2221, 2287, 2310, 2337, 2584, 3441, 3623, 3733, 3759, 3777, 3815, 3843, 3887]","[536, 2287, 2584]","[71, 96, 984, 1912, 2065, 2221, 2310, 2337, 3441, 3623, 3733, 3759, 3777, 3815, 3843, 3887]","[536, 2287, 2584]",4079,19,4060,3,16,4060,0
3.5,HSU01102,"[222, 275, 373, 668, 745, 817, 858, 1671, 1711, 1939, 1943, 2082, 2192, 2210, 2568, 2875, 3273, 4040, 4166, 4611, 4655]",[668],"[222, 275, 373, 745, 817, 858, 1671, 1711, 1939, 1943, 2082, 2192, 2210, 2568, 2875, 3273, 4040, 4166, 4611, 4655]","[668, 3896]",4987,21,4966,1,20,4965,1
3.5,HSU04357,"[97, 123, 792, 800, 1201, 1239, 1342, 1650, 1882, 1953, 1963]","[97, 1342]","[123, 792, 800, 1201, 1239, 1650, 1882, 1953, 1963]","[97, 1342]",2074,11,2063,2,9,2063,0
3.5,HSU04636,"[103, 465, 749, 852, 1018, 1449, 1935, 2199, 2262, 2561, 2761, 2996, 3000, 3264, 3426, 3608, 3849, 3965, 4362, 4424, 5359, 5719, 5723, 6008, 6340, 7357, 8108, 8301, 8483, 8640]","[1018, 1935, 2199, 2996, 3608, 4424, 5359, 6008]","[103, 465, 749, 852, 1449, 2262, 2561, 2761, 3000, 3264, 3426, 3849, 3965, 4362, 5719, 5723, 6340, 7357, 8108, 8301, 8483, 8640]","[1018, 1935, 2199, 2996, 3608, 4424, 4790, 5359, 6008]",9445,30,9415,8,22,9414,1
3.5,HSU05259,"[164, 499, 782, 814, 951, 1177, 1773, 1891, 2051, 2055, 2091, 2173, 2435, 2571, 2678, 2685, 2774, 2859, 3045, 3109, 3387, 3672, 3937, 4128, 4642, 4871, 5264]","[782, 2685, 3045, 4128]","[164, 499, 814, 951, 1177, 1773, 1891, 2051, 2055, 2091, 2173, 2435, 2571, 2678, 2774, 2859, 3109, 3387, 3672, 3937, 4642, 4871, 5264]","[782, 2685, 3045, 4128]",5662,27,5635,4,23,5635,0
3.5,HSU07807,"[454, 459, 609, 614, 757, 1040, 1362, 1848, 1983, 1991, 2047, 2481, 2568, 2736, 2873, 3386, 3446, 3509, 3664, 4350, 4725]","[757, 3386]","[454, 459, 609, 614, 1040, 1362, 1848, 1983, 1991, 2047, 2481, 2568, 2736, 2873, 3446, 3509, 3664, 4350, 4725]","[757, 3386]",4831,21,4810,2,19,4810,0
3.5,HSU07983,"[170, 287, 354, 390, 621, 1286]",[390],"[170, 287, 354, 621, 1286]",[390],1418,6,1412,1,5,1412,0
3.5,HSU08198,"[311, 676, 707, 895, 1072, 1124, 1147, 1316, 1392, 1601, 1684, 1689, 1811, 1845, 1892, 1900]","[895, 1124, 1316, 1689, 1811]","[311, 676, 707, 1072, 1147, 1392, 1601, 1684, 1845, 1892, 1900]","[583, 895, 1124, 1316, 1689, 1811]",2336,16,2320,5,11,2319,1
3.5,HSU12421,"[227, 311, 583, 957, 999, 1384, 1400, 1706, 1854, 1882, 1941, 2080, 2158, 2255, 2291, 2334, 2434, 2624, 3216, 3242, 3287, 3349, 3573, 3577, 3705, 3747, 3869, 3910]","[311, 2080]","[227, 583, 957, 999, 1384, 1400, 1706, 1854, 1882, 1941, 2158, 2255, 2291, 2334, 2434, 2624, 3216, 3242, 3287, 3349, 3573, 3577, 3705, 3747, 3869, 3910]","[311, 2080]",4250,28,4222,2,26,4222,0
3.5,HSUBR,"[219, 374, 417, 564, 957, 1589, 2316, 2324, 3005, 3124]","[1589, 2324]","[219, 374, 417, 564, 957, 2316, 3005, 3124]","[1589, 2324]",3287,10,3277,2,8,3277,0
3.5,HSXBXVIII,"[417, 473, 529, 644, 1059, 1133, 1189, 1193, 1199, 1203, 1213, 1671, 2137, 2578, 2596, 2723, 2781, 2897, 3019, 3026, 3061, 3074, 3099, 3123, 3175, 3248, 3333, 3339, 3371, 3803, 3828, 3859, 3929, 4456, 4586, 5320, 5362, 5401, 5486, 5490, 6115, 6193, 6240, 6599, 6733, 7675, 8302, 8850, 8934, 8943, 9475, 9552, 9633, 10043, 10077, 10107, 10136, 10425, 10629, 10687, 10723, 10737, 10911, 11162, 11253, 11405, 11589, 11615, 11714, 11843, 11856, 11870, 12085, 12311, 12408, 12693]","[11405, 11589, 11843, 12085]","[417, 473, 529, 644, 1059, 1133, 1189, 1193, 1199, 1203, 1213, 1671, 2137, 2578, 2596, 2723, 2781, 2897, 3019, 3026, 3061, 3074, 3099, 3123, 3175, 3248, 3333, 3339, 3371, 3803, 3828, 3859, 3929, 4456, 4586, 5320, 5362, 5401, 5486, 5490, 6115, 6193, 6240, 6599, 6733, 7675, 8302, 8850, 8934, 8943, 9475, 9552, 9633, 10043, 10077, 10107, 10136, 10425, 10629, 10687, 10723, 10737, 10911, 11162, 11253, 11615, 11714, 11856, 11870, 12311, 12408, 12693]","[11405, 11589, 11843, 12085]",12630,76,12554,4,72,12554,0
3.5,HSZNGP1,"[445, 518, 565, 932, 1142, 1765, 2672, 3191, 3608, 4109, 4312, 4718, 4777, 5026, 5073, 5752, 5805, 5990, 6144, 6347, 6402, 6435, 7275, 7410, 7454, 8313, 8597, 8615, 8762, 8986, 8991, 9067, 9762]","[518, 4718, 8313]","[445, 565, 932, 1142, 1765, 2672, 3191, 3608, 4109, 4312, 4777, 5026, 5073, 5752, 5805, 5990, 6144, 6347, 6402, 6435, 7275, 7410, 7454, 8597, 8615, 8762, 8986, 8991, 9067, 9762]","[518, 4718, 8313]",9815,33,9782,3,30,9782,0
3.5,HUMADAG,"[8, 47, 710, 1241, 1309, 1355, 1609, 1677, 2001, 2050, 2405, 2418, 2423, 2578, 2769, 2805, 3343, 3539, 3737, 4064, 4501, 4521, 4549, 4623, 4817, 4900, 5136, 5267, 5278, 5296, 5341, 5657, 5751, 5773, 5828, 5871, 6192, 6261, 6277, 7184, 7249, 7568, 7938, 7980, 8160, 8421, 9092, 9628, 9946, 10139, 10243, 10515, 11124, 11190, 11568, 11763, 11804, 11825, 12068, 12435, 12555, 12584, 13187, 13314, 13416, 13458, 13503, 13521, 14450, 14833, 15069, 15395, 15582, 15661, 15857, 15875, 15955, 16030, 16262, 17025, 17067, 17161, 17205, 17401, 17492, 17850, 18465, 18482, 18637, 19292, 19437, 19529, 19940, 20245, 20776, 21006, 21015, 21020, 21027, 21114, 21399, 21499, 22419, 22592, 22735, 22747, 23112, 23649, 23808, 23861, 24039, 24165, 24224, 24260, 24752, 25434, 25532, 25869, 26150, 26467, 26603, 26912, 27206, 27250, 27585, 28038, 28083, 28099, 28255, 28362, 28479, 28712, 28722, 28987, 28992, 29052, 29419, 29704, 29939, 30609, 30766, 30860, 31115, 31304, 31313, 31342, 31644, 31682, 32470, 32497, 32675, 32916, 33343, 33626, 33952, 33998, 34262, 34279, 34484, 34578, 34742, 35203, 36268, 36357]","[4064, 19292, 26467, 29052, 29939, 31304, 32497, 32675, 32916, 34484, 35203]","[8, 47, 710, 1241, 1309, 1355, 1609, 1677, 2001, 2050, 2405, 2418, 2423, 2578, 2769, 2805, 3343, 3539, 3737, 4501, 4521, 4549, 4623, 4817, 4900, 5136, 5267, 5278, 5296, 5341, 5657, 5751, 5773, 5828, 5871, 6192, 6261, 6277, 7184, 7249, 7568, 7938, 7980, 8160, 8421, 9092, 9628, 9946, 10139, 10243, 10515, 11124, 11190, 11568, 11763, 11804, 11825, 12068, 12435, 12555, 12584, 13187, 13314, 13416, 13458, 13503, 13521, 14450, 14833, 15069, 15395, 15582, 15661, 15857, 15875, 15955, 16030, 16262, 17025, 17067, 17161, 17205, 17401, 17492, 17850, 18465, 18482, 18637, 19437, 19529, 19940, 20245, 20776, 21006, 21015, 21020, 21027, 21114, 21399, 21499, 22419, 22592, 22735, 22747, 23112, 23649, 23808, 23861, 24039, 24165, 24224, 24260, 24752, 25434, 25532, 25869, 26150, 26603, 26912, 27206, 27250, 27585, 28038, 28083, 28099, 28255, 28362, 28479, 28712, 28722, 28987, 28992, 29419, 29704, 30609, 30766, 30860, 31115, 31313, 31342, 31644, 31682, 32470, 33343, 33626, 33952, 33998, 34262, 34279, 34578, 34742, 36268, 36357]","[4064, 19292, 26467, 29052, 29939, 31304, 32497, 32675, 32916, 34484, 35203]",36733,164,36569,11,153,36569,0
3.5,HUMADPRF02,"[90, 277, 359, 514, 638, 1308, 1325, 1338, 1456, 1650, 2102, 2953, 2972, 3035, 3305, 3392, 3994, 4213, 4223, 4253, 4732, 4870, 5150]","[359, 1308, 1650]","[90, 277, 514, 638, 1325, 1338, 1456, 2102, 2953, 2972, 3035, 3305, 3392, 3994, 4213, 4223, 4253, 4732, 4870, 5150]","[359, 1308, 1650]",5159,23,5136,3,20,5136,0
3.5,HUMAPEXN,"[137, 349, 1190, 1268, 1347, 1364, 1376, 1465, 1530, 1535, 1693, 1863, 2233, 2341, 2432, 2622, 2850]","[1465, 1863, 2622]","[137, 349, 1190, 1268, 1347, 1364, 1376, 1530, 1535, 1693, 2233, 2341, 2432, 2850]","[1465, 1863, 2622]",3722,17,3705,3,14,3705,0
3.5,HUMAPOCII,"[70, 184, 198, 349, 547, 571, 589, 891, 930, 1075, 1230, 1557, 1778, 1789, 1837, 1856, 2255, 2305, 2321, 2405, 2630, 2642, 2760, 2995, 3223, 3321, 4263]","[2995, 3321]","[70, 184, 198, 349, 547, 571, 589, 891, 930, 1075, 1230, 1557, 1778, 1789, 1837, 1856, 2255, 2305, 2321, 2405, 2630, 2642, 2760, 3223, 4263]","[2995, 3321]",4332,27,4305,2,25,4305,0
3.5,HUMAPOE4,"[281, 617, 1064, 1091, 1225, 1294, 1324, 1506, 1575, 1773, 1914, 2365, 2409, 2611, 3156, 3200, 3234, 4001, 4032, 4166, 4292, 4313, 4445]","[1914, 3200]","[281, 617, 1064, 1091, 1225, 1294, 1324, 1506, 1575, 1773, 2365, 2409, 2611, 3156, 3234, 4001, 4032, 4166, 4292, 4313, 4445]","[1914, 3200]",5507,23,5484,2,21,5484,0
3.5,HUMATPGG,"[156, 203, 213, 285, 676, 831, 1445, 1727, 1762, 1902, 2553, 2601, 2677, 2819, 2891, 3025, 3180, 3691, 4114, 4293, 4578, 5307, 5627, 5882, 5953, 6118, 6191, 6534, 6749, 7311, 7456, 7488, 7833, 7885, 7908, 8017, 8198, 8227, 9179, 9299, 9308, 9315, 9436, 9672, 9778, 10001, 10190, 10354, 10406, 10478, 10624, 10635, 10770, 10861, 11018, 11405, 11435, 11928, 12001, 12074, 12415, 12549, 12987, 13136, 13458, 13592, 14100, 14110, 14276, 14537, 14755]","[1445, 1727, 1902, 2677, 4293, 5307, 6118, 6534, 6749, 7456, 8198, 9436, 9672, 10190, 11405, 12074, 14100, 14276]","[156, 203, 213, 285, 676, 831, 1762, 2553, 2601, 2819, 2891, 3025, 3180, 3691, 4114, 4578, 5627, 5882, 5953, 6191, 7311, 7488, 7833, 7885, 7908, 8017, 8227, 9179, 9299, 9308, 9315, 9778, 10001, 10354, 10406, 10478, 10624, 10635, 10770, 10861, 11018, 11435, 11928, 12001, 12415, 12549, 12987, 13136, 13458, 13592, 14110, 14537, 14755]","[1445, 1727, 1902, 2677, 4293, 4749, 5307, 6118, 6534, 6749, 7456, 8198, 9436, 9672, 9946, 10190, 11405, 12074, 13663, 14100, 14276]",15107,71,15036,18,53,15033,3
3.5,HUMBETGLOA,"[52, 351, 376, 601, 687, 920, 942, 958, 1176, 1264, 1311, 2016, 2475, 2559, 2931]","[958, 1311]","[52, 351, 376, 601, 687, 920, 942, 1176, 1264, 2016, 2475, 2559, 2931]","[958, 1311]",2994,15,2979,2,13,2979,0
3.5,HUMBETGLOB,"[52, 349, 374, 599, 685, 918, 940, 956, 1174, 1262, 1309, 2014, 2473, 2557, 2929]","[956, 1309]","[52, 349, 374, 599, 685, 918, 940, 1174, 1262, 2014, 2473, 2557, 2929]","[956, 1309]",2992,15,2977,2,13,2977,0
3.5,HUMBETGLOC,"[52, 351, 376, 601, 687, 920, 942, 958, 1176, 1264, 1311, 2016, 2475, 2559, 2931]","[958, 1311]","[52, 351, 376, 601, 687, 920, 942, 1176, 1264, 2016, 2475, 2559, 2931]","[958, 1311]",2994,15,2979,2,13,2979,0
3.5,HUMBETGLOD,"[52, 351, 376, 601, 687, 920, 942, 958, 1176, 1264, 1311, 2016, 2475, 2559, 2931]","[958, 1311]","[52, 351, 376, 601, 687, 920, 942, 1176, 1264, 2016, 2475, 2559, 2931]","[958, 1311]",2994,15,2979,2,13,2979,0
3.5,HUMBETGLOE,"[52, 349, 374, 599, 685, 918, 940, 956, 1174, 1262, 1309, 2014, 2473, 2557, 2929]","[956, 1309]","[52, 349, 374, 599, 685, 918, 940, 1174, 1262, 2014, 2473, 2557, 2929]","[956, 1309]",2992,15,2977,2,13,2977,0
3.5,HUMBETGLOF,"[52, 351, 376, 601, 687, 920, 942, 958, 1176, 1264, 1311, 2016, 2475, 2559, 2931]","[958, 1311]","[52, 351, 376, 601, 687, 920, 942, 1176, 1264, 2016, 2475, 2559, 2931]","[958, 1311]",2994,15,2979,2,13,2979,0
3.5,HUMBETGLOG,"[52, 351, 376, 601, 687, 920, 942, 958, 1176, 1264, 1311, 2016, 2475, 2559, 2931]","[958, 1311]","[52, 351, 376, 601, 687, 920, 942, 1176, 1264, 2016, 2475, 2559, 2931]","[958, 1311]",2994,15,2979,2,13,2979,0
3.5,HUMBETGLOH,"[52, 351, 376, 601, 687, 920, 942, 958, 1176, 1264, 1311, 2016, 2475, 2559, 2931]","[958, 1311]","[52, 351, 376, 601, 687, 920, 942, 1176, 1264, 2016, 2475, 2559, 2931]","[958, 1311]",2994,15,2979,2,13,2979,0
3.5,HUMBETGLOI,"[52, 349, 374, 599, 685, 918, 940, 956, 1174, 1262, 1309, 2014, 2473, 2557, 2929]","[956, 1309]","[52, 349, 374, 599, 685, 918, 940, 1174, 1262, 2014, 2473, 2557, 2929]","[956, 1309]",2992,15,2977,2,13,2977,0
3.5,HUMBETGLOJ,"[52, 349, 374, 599, 685, 918, 940, 956, 1174, 1262, 1309, 2014, 2473, 2557, 2929]","[956, 1309]","[52, 349, 374, 599, 685, 918, 940, 1174, 1262, 2014, 2473, 2557, 2929]","[956, 1309]",2992,15,2977,2,13,2977,0
3.5,HUMBETGLOK,"[52, 349, 374, 599, 685, 918, 940, 956, 1174, 1262, 1309, 2014, 2473, 2557, 2929]","[956, 1309]","[52, 349, 374, 599, 685, 918, 940, 1174, 1262, 2014, 2473, 2557, 2929]","[956, 1309]",2992,15,2977,2,13,2977,0
3.5,HUMBETGLOL,"[52, 349, 374, 599, 685, 918, 940, 956, 1174, 1262, 1309, 2014, 2473, 2557, 2929]","[956, 1309]","[52, 349, 374, 599, 685, 918, 940, 1174, 1262, 2014, 2473, 2557, 2929]","[956, 1309]",2992,15,2977,2,13,2977,0
3.5,HUMBETGLOM,"[52, 348, 373, 598, 684, 917, 939, 955, 1173, 1261, 1308, 2013, 2472, 2556, 2928]","[955, 1308]","[52, 348, 373, 598, 684, 917, 939, 1173, 1261, 2013, 2472, 2556, 2928]","[955, 1308]",2991,15,2976,2,13,2976,0
3.5,HUMBETGLON,"[52, 349, 374, 599, 685, 918, 940, 956, 1174, 1262, 1309, 2014, 2473, 2557, 2929]","[956, 1309]","[52, 349, 374, 599, 685, 918, 940, 1174, 1262, 2014, 2473, 2557, 2929]","[956, 1309]",2992,15,2977,2,13,2977,0
3.5,HUMBETGLOO,"[52, 349, 374, 599, 685, 918, 940, 956, 1174, 1262, 1309, 2014, 2473, 2557, 2929]","[956, 1309]","[52, 349, 374, 599, 685, 918, 940, 1174, 1262, 2014, 2473, 2557, 2929]","[956, 1309]",2992,15,2977,2,13,2977,0
3.5,HUMBETGLOP,"[52, 349, 374, 599, 685, 918, 940, 956, 1174, 1262, 1309, 2014, 2473, 2557, 2929]","[956, 1309]","[52, 349, 374, 599, 685, 918, 940, 1174, 1262, 2014, 2473, 2557, 2929]","[956, 1309]",2992,15,2977,2,13,2977,0
3.5,HUMBETGLOR,"[52, 349, 374, 599, 685, 918, 940, 956, 1174, 1262, 1309, 2014, 2473, 2557, 2929]","[956, 1309]","[52, 349, 374, 599, 685, 918, 940, 1174, 1262, 2014, 2473, 2557, 2929]","[956, 1309]",2992,15,2977,2,13,2977,0
3.5,HUMCBRG,"[80, 167, 237, 567, 704, 1220, 2123, 2689, 2715, 2848, 2897, 2901, 2950, 3041]","[567, 1220]","[80, 167, 237, 704, 2123, 2689, 2715, 2848, 2897, 2901, 2950, 3041]","[567, 1220]",3318,14,3304,2,12,3304,0
3.5,HUMCHYMASE,"[510, 646, 969, 1185, 1277, 1379, 1826, 2315, 3135, 3165, 3252, 3406, 3765, 3982, 4038, 4104, 5028, 5216, 5644, 5779, 6037, 6922, 7220, 7255, 7363, 7455, 7463, 8006, 8052]","[5216, 6037, 6922, 7363]","[510, 646, 969, 1185, 1277, 1379, 1826, 2315, 3135, 3165, 3252, 3406, 3765, 3982, 4038, 4104, 5028, 5644, 5779, 7220, 7255, 7455, 7463, 8006, 8052]","[5216, 6037, 6922, 7363]",8107,29,8078,4,25,8078,0
3.5,HUMCP21OH,"[92, 185, 408, 435, 463, 505, 622, 626, 644, 947, 994, 1134, 1259, 1321, 1357, 1566, 1571, 1780, 1970, 2158, 2167, 2528, 2580, 2907, 2931, 3094, 3481, 3659]","[947, 1134, 1571, 1780, 1970, 2158, 2528, 2907, 3094]","[92, 185, 408, 435, 463, 505, 622, 626, 644, 994, 1259, 1321, 1357, 1566, 2167, 2580, 2931, 3481, 3659]","[947, 1134, 1571, 1780, 1970, 2158, 2528, 2907, 3094]",4034,28,4006,9,19,4006,0
3.5,HUMCP21OHC,"[92, 185, 408, 435, 506, 623, 627, 645, 948, 995, 1135, 1260, 1322, 1358, 1567, 1572, 1781, 1971, 2159, 2529, 2581, 2908, 2933, 3096, 3483, 3661]","[948, 1135, 1572, 1781, 1971, 2159, 2529, 2908, 3096]","[92, 185, 408, 435, 506, 623, 627, 645, 995, 1260, 1322, 1358, 1567, 2581, 2933, 3483, 3661]","[948, 1135, 1572, 1781, 1971, 2159, 2529, 2908, 3096]",4036,26,4010,9,17,4010,0
3.5,HUMCS1,"[85, 148, 304, 310, 429, 565, 669, 991, 1334, 1591, 1679, 2095, 2196, 2210]","[565, 991, 1334, 1591]","[85, 148, 304, 310, 429, 669, 1679, 2095, 2196, 2210]","[565, 991, 1334, 1591]",2293,14,2279,4,10,2279,0
3.5,HUMCS3,"[87, 150, 306, 312, 431, 566, 671, 991, 1334, 1588, 2098, 2200, 2214, 2520, 2728]","[566, 991, 1334, 1588]","[87, 150, 306, 312, 431, 671, 2098, 2200, 2214, 2520, 2728]","[566, 991, 1334, 1588]",2732,15,2717,4,11,2717,0
3.5,HUMCSN2A,"[122, 591, 1451, 1845, 2107, 2228, 2287, 3194, 3480, 3776, 4104, 4855, 5391, 5620, 5742, 5747, 6144, 6244, 6682, 6747, 6887, 7171, 7210, 7474, 7789, 8522, 8683, 8805, 9482]","[4855, 5747, 6747, 6887, 8522]","[122, 591, 1451, 1845, 2107, 2228, 2287, 3194, 3480, 3776, 4104, 5391, 5620, 5742, 6144, 6244, 6682, 7171, 7210, 7474, 7789, 8683, 8805, 9482]","[4855, 5747, 6747, 6887, 8522]",10600,29,10571,5,24,10571,0
3.5,HUMCSPA,"[455, 982, 1239, 2216, 2276, 2477, 2929, 3200, 3608, 3691, 3819]","[982, 2276, 2929]","[455, 1239, 2216, 2477, 3200, 3608, 3691, 3819]","[982, 2276, 2929, 3392]",4783,11,4772,3,8,4771,1
3.5,HUMCTLA1,"[988, 1332, 1812, 1976, 2119, 2179, 2297, 2336, 2360, 2770, 3041, 3122, 3236, 3532, 3695]","[988, 2179, 2770, 3236]","[1332, 1812, 1976, 2119, 2297, 2336, 2360, 3041, 3122, 3532, 3695]","[988, 2179, 2770, 3236]",4520,15,4505,4,11,4505,0
3.5,HUMDEF5A,"[296, 500, 923, 1387, 1571, 1719, 2196, 2276, 2323, 2601]",[1571],"[296, 500, 923, 1387, 1719, 2196, 2276, 2323, 2601]",[1571],2872,10,2862,1,9,2862,0
3.5,HUMDZA2G,"[24, 296, 333, 595, 631, 680, 727, 829, 849, 1160, 1425, 1531, 1645, 1747, 1973, 1982, 2003, 2013, 2353, 2928, 3711, 3775, 3942, 4262, 4436, 4857, 5316, 5389, 5436, 5803, 6013, 6636, 7542, 8063, 8480, 8981, 9184, 9590, 9649, 9898, 9945, 10624, 10677, 10862, 11016, 11212, 11267, 11300, 12139, 12274, 12318, 13183, 13467, 13485, 13632, 13857, 13862, 13938, 14633]","[5389, 9590, 13183]","[24, 296, 333, 595, 631, 680, 727, 829, 849, 1160, 1425, 1531, 1645, 1747, 1973, 1982, 2003, 2013, 2353, 2928, 3711, 3775, 3942, 4262, 4436, 4857, 5316, 5436, 5803, 6013, 6636, 7542, 8063, 8480, 8981, 9184, 9649, 9898, 9945, 10624, 10677, 10862, 11016, 11212, 11267, 11300, 12139, 12274, 12318, 13467, 13485, 13632, 13857, 13862, 13938, 14633]","[5389, 9590, 13183]",14686,59,14627,3,56,14627,0
3.5,HUMELAFIN,"[208, 326, 338, 557, 786, 802, 1089, 1351, 1456, 1461, 1517, 1534, 1559]",[326],"[208, 338, 557, 786, 802, 1089, 1351, 1456, 1461, 1517, 1534, 1559]",[326],1870,13,1857,1,12,1857,0
3.5,HUMEPOHYDD,"[504, 776, 1048, 1107, 1724, 1863, 1951, 2121, 2164, 2190, 2283, 2289, 2801, 2972, 2990, 3069, 3143, 3327, 3680, 4407, 5656, 5814, 5979, 5997, 6103, 6115, 6277, 6289, 6422, 6542, 6599, 6758, 6950, 7098, 7946, 8217, 8650, 8696, 8728, 9045, 9132, 9213, 9328, 9470, 9489, 9564, 10184, 10319, 10351, 10392, 10475, 10621, 10778, 10872, 11088, 11772, 11832, 12105, 12409, 12625, 12819, 12928, 13103, 13241, 13279, 13322, 13416, 13651, 13804, 13924, 14095, 14107, 14420, 14606, 15062, 15197, 15227, 15620, 15705, 15831, 16085, 16324, 16771, 16775, 16885, 17075, 17080, 17170, 17238, 17489, 17789, 17810, 17870, 18254, 18296, 18395, 18573, 18887, 18944, 19204, 19373, 19698, 19867, 19920, 20118, 20318, 20545, 20674, 20683, 20720, 20857, 20883, 20954, 20979, 20994, 21354, 21468, 21539, 21648, 21715, 21941, 21945, 22251, 22539, 22856, 22952, 23010, 23217, 23497, 23652, 23927, 24312, 24408, 24469]","[5656, 8696, 15620, 16085, 16775, 19204, 21354]","[504, 776, 1048, 1107, 1724, 1863, 1951, 2121, 2164, 2190, 2283, 2289, 2801, 2972, 2990, 3069, 3143, 3327, 3680, 4407, 5814, 5979, 5997, 6103, 6115, 6277, 6289, 6422, 6542, 6599, 6758, 6950, 7098, 7946, 8217, 8650, 8728, 9045, 9132, 9213, 9328, 9470, 9489, 9564, 10184, 10319, 10351, 10392, 10475, 10621, 10778, 10872, 11088, 11772, 11832, 12105, 12409, 12625, 12819, 12928, 13103, 13241, 13279, 13322, 13416, 13651, 13804, 13924, 14095, 14107, 14420, 14606, 15062, 15197, 15227, 15705, 15831, 16324, 16771, 16885, 17075, 17080, 17170, 17238, 17489, 17789, 17810, 17870, 18254, 18296, 18395, 18573, 18887, 18944, 19373, 19698, 19867, 19920, 20118, 20318, 20545, 20674, 20683, 20720, 20857, 20883, 20954, 20979, 20994, 21468, 21539, 21648, 21715, 21941, 21945, 22251, 22539, 22856, 22952, 23010, 23217, 23497, 23652, 23927, 24312, 24408, 24469]","[5656, 8696, 15620, 16085, 16775, 19204, 21354]",24782,134,24648,7,127,24648,0
3.5,HUMG0S24B,"[91, 631, 658, 812, 1133, 1264, 1331, 1415, 2598, 3102]",[631],"[91, 658, 812, 1133, 1264, 1331, 1415, 2598, 3102]",[631],3127,10,3117,1,9,3117,0
3.5,HUMG0S8PP,"[91, 401, 660, 784, 942, 1230, 1379, 2148, 2152, 2682, 2744, 2853, 3036, 3768, 3836, 3840, 3932, 4113, 4399, 4646, 5361, 5877, 7286]","[2682, 3768, 3932, 4646]","[91, 401, 660, 784, 942, 1230, 1379, 2148, 2152, 2744, 2853, 3036, 3836, 3840, 4113, 4399, 5361, 5877, 7286]","[2682, 3768, 3932, 4646]",7337,23,7314,4,19,7314,0
3.5,HUMGAD45A,"[392, 628, 927, 1042, 1114, 1215, 1292, 1321, 1425, 1558, 1761, 2266, 2457, 2461, 2596, 2968, 3092, 3184, 3639, 3645, 3730, 3880, 4167, 4171, 4396, 4427, 4828, 4956, 5015]","[2596, 3184, 3645]","[392, 628, 927, 1042, 1114, 1215, 1292, 1321, 1425, 1558, 1761, 2266, 2457, 2461, 2968, 3092, 3639, 3730, 3880, 4167, 4171, 4396, 4427, 4828, 4956, 5015]","[2596, 3184, 3645]",5370,29,5341,3,26,5341,0
3.5,HUMGARE,"[25, 71, 322, 590, 598, 609, 633, 810, 964, 1056, 1467, 1872, 2239, 2243, 2411, 2455, 2653, 2861, 3118, 3133, 3207, 3213, 3254, 3259, 4469, 4718]","[810, 2239, 2653, 3118]","[25, 71, 322, 590, 598, 609, 633, 964, 1056, 1467, 1872, 2243, 2411, 2455, 2861, 3133, 3207, 3213, 3254, 3259, 4469, 4718]","[810, 2239, 2653, 3118]",4746,26,4720,4,22,4720,0
3.5,HUMGCK,"[304, 506, 634, 725, 916, 1188, 1514, 1582, 1989, 2345, 2647, 3096, 3197, 3248, 3360, 3783, 3789, 3799, 3882, 4288, 4312, 4806, 5015, 5092, 5118, 5341, 5442, 5452, 5584, 5623, 5808, 5848, 5956, 5964, 5981, 6475, 6500, 6630, 6651, 6744, 6765, 6921, 6946, 7127]","[1188, 3360, 3882, 4312, 4806, 5015, 5452, 5964, 6475]","[304, 506, 634, 725, 916, 1514, 1582, 1989, 2345, 2647, 3096, 3197, 3248, 3783, 3789, 3799, 4288, 5092, 5118, 5341, 5442, 5584, 5623, 5808, 5848, 5956, 5981, 6500, 6630, 6651, 6744, 6765, 6921, 6946, 7127]","[1188, 3360, 3882, 4312, 4806, 5015, 5452, 5964, 6475]",7519,44,7475,9,35,7475,0
3.5,HUMGFP40H,"[11, 243, 910, 1058, 1140, 1173, 1731, 1748, 1846, 1870, 1943, 2486, 2593, 2646, 2752, 2781, 3126, 3261, 3426, 3615, 4025, 4290]","[910, 1058, 1173, 2593]","[11, 243, 1140, 1731, 1748, 1846, 1870, 1943, 2486, 2646, 2752, 2781, 3126, 3261, 3426, 3615, 4025, 4290]","[910, 1058, 1173, 2593]",4371,22,4349,4,18,4349,0
3.5,HUMGHG,"[40, 689, 946, 1923, 1983, 2184, 2636, 2907, 3315, 3398, 3526]","[689, 1983, 2636]","[40, 946, 1923, 2184, 2907, 3315, 3398, 3526]","[689, 1983, 2636, 3099]",4444,11,4433,3,8,4432,1
3.5,HUMGHN,"[85, 148, 199, 307, 313, 434, 569, 673, 1316, 1574, 2181, 2439, 2583]","[569, 1316, 1574]","[85, 148, 199, 307, 313, 434, 673, 2181, 2439, 2583]","[569, 989, 1316, 1574]",2649,13,2636,3,10,2635,1
3.5,HUMGHV,"[86, 149, 198, 306, 432, 464, 566, 1136, 1328, 1351, 1584, 2188, 2207, 2443, 2485]","[566, 1328, 1584]","[86, 149, 198, 306, 432, 464, 1136, 1351, 2188, 2207, 2443, 2485]","[566, 998, 1328, 1584]",2652,15,2637,3,12,2636,1
3.5,HUMGSTM4A,"[116, 516, 777, 781, 1139, 1272, 1535, 1631, 1844, 2024, 2098, 2124, 2225, 2573, 2880, 2925, 3023, 3262, 3463, 3700, 3753, 3933, 4072, 4160, 4279, 4306, 4311, 4425, 4760, 4791, 4798, 4913, 4991, 5152, 5226, 5623, 5629]","[777, 1139, 1631, 2024, 2225, 3262, 3463]","[116, 516, 781, 1272, 1535, 1844, 2098, 2124, 2573, 2880, 2925, 3023, 3700, 3753, 3933, 4072, 4160, 4279, 4306, 4311, 4425, 4760, 4791, 4798, 4913, 4991, 5152, 5226, 5623, 5629]","[777, 1139, 1631, 2024, 2225, 3262, 3463]",6074,37,6037,7,30,6037,0
3.5,HUMHMGIY,"[310, 720, 1075, 1337, 1472, 1557, 2136, 2388, 2558, 2578, 2704, 3280, 3749, 3875, 3978, 3983, 4410, 4529, 4627, 4648, 4660, 4773, 5150, 5496, 5569, 5619, 5722, 6274, 6422, 6544, 6673, 6687, 6776, 7016, 7102, 7133, 7166, 7270, 7315, 7420, 7449, 7463, 7629, 7781, 7962, 8043, 8047, 8361, 8507, 9134, 9286, 9390, 9424, 9791, 9823, 10022]","[4660, 6544, 7270]","[310, 720, 1075, 1337, 1472, 1557, 2136, 2388, 2558, 2578, 2704, 3280, 3749, 3875, 3978, 3983, 4410, 4529, 4627, 4648, 4773, 5150, 5496, 5569, 5619, 5722, 6274, 6422, 6673, 6687, 6776, 7016, 7102, 7133, 7166, 7315, 7420, 7449, 7463, 7629, 7781, 7962, 8043, 8047, 8361, 8507, 9134, 9286, 9390, 9424, 9791, 9823, 10022]","[4660, 6544, 7270]",10098,56,10042,3,53,10042,0
3.5,HUMHOX13G,"[336, 380, 503, 811, 1131, 1451, 1653, 2083, 2405, 2502, 2576, 2652, 2796]",[811],"[336, 380, 503, 1131, 1451, 1653, 2083, 2405, 2502, 2576, 2652, 2796]",[811],3062,13,3049,1,12,3049,0
3.5,HUMHPARS1,"[20, 338, 779, 967, 1046, 1300, 1320, 1655, 1961, 2005, 2105, 2327, 2362, 2632, 2648, 2984, 3020, 3096, 3337, 3496, 3855, 4708, 4744, 4820, 5061, 5220, 5577, 6373, 6499, 6620, 6790, 6948, 7164, 7217, 7231, 7510, 7569, 7692, 7696, 7752, 8126, 8485, 8703, 8728, 8994, 9085, 9344, 9570, 9649, 9904, 9924, 10183, 10406, 10466, 10563, 10607, 10668, 11363, 11385]","[1046, 2632, 3020, 3855, 4744, 5577]","[20, 338, 779, 967, 1300, 1320, 1655, 1961, 2005, 2105, 2327, 2362, 2648, 2984, 3096, 3337, 3496, 4708, 4820, 5061, 5220, 6373, 6499, 6620, 6790, 6948, 7164, 7217, 7231, 7510, 7569, 7692, 7696, 7752, 8126, 8485, 8703, 8728, 8994, 9085, 9344, 9570, 9649, 9904, 9924, 10183, 10406, 10466, 10563, 10607, 10668, 11363, 11385]","[1046, 2632, 3020, 3855, 4744, 5577]",11543,59,11484,6,53,11484,0
3.5,HUMIBP3,"[182, 1260, 1284, 1409, 1473, 1556, 1685, 1701, 1718, 2221, 2441, 2457, 2584, 2687, 2715, 2845, 2849, 2935, 3142, 3149, 3356, 3635, 3924, 3984, 4247, 4262, 4304, 4342, 4358, 4406, 4476, 4924, 5122, 5197, 5323, 5534, 5553, 5735, 6375, 6425, 6617, 6621, 6764, 7184, 7377, 7842, 8250, 8353, 8677, 8756, 9118, 9945]","[2441, 6617]","[182, 1260, 1284, 1409, 1473, 1556, 1685, 1701, 1718, 2221, 2457, 2584, 2687, 2715, 2845, 2849, 2935, 3142, 3149, 3356, 3635, 3924, 3984, 4247, 4262, 4304, 4342, 4358, 4406, 4476, 4924, 5122, 5197, 5323, 5534, 5553, 5735, 6375, 6425, 6621, 6764, 7184, 7377, 7842, 8250, 8353, 8677, 8756, 9118, 9945]","[2441, 5953, 6617]",10876,52,10824,2,50,10823,1
3.5,HUMIDS,"[372, 636, 672, 1160, 1797, 1972, 2038, 2248, 2376, 2860, 2882, 3140, 3243, 3321, 3731, 4119, 4174, 4684, 4778, 4865, 5244, 5385, 5446, 5850, 5864, 5876, 5927, 6071, 6178, 6964, 7368, 8086, 8266, 8364, 8494, 8721, 8796, 9161, 9282, 9286, 9391, 9526, 9847, 9965, 10120, 10170, 10734, 10877, 10987, 11136, 11158, 11182, 11397, 11401, 11928, 12302, 12329, 13103, 13812, 13969, 14169, 14418, 14645, 14655, 14702, 14808, 15205, 15210, 15473, 15596, 15803, 15879, 15901, 16084, 16844, 18130, 18292, 18552, 18689, 19046, 19268, 19301, 19483, 19537, 19599, 19657, 19747, 20044, 21216, 21250, 21311, 21624, 21640, 21795, 21930, 22055, 22309, 22369, 22524, 22536, 22809, 22814, 23494, 24724, 24873, 25403, 25810, 25819, 26308, 26943, 27097, 27785, 27983, 28627, 28773, 28973, 29070, 29300, 29338, 29400, 29441, 29518, 29555, 29710, 29830, 30034, 30410, 30436, 30535, 30554, 30602, 30999, 31004, 31046, 31147, 31179, 31515, 32027, 32099, 32333, 33900, 34107, 34645, 35521, 35761, 35777, 35860, 35958, 36682, 36718]","[1160, 2038, 2882, 5244, 8086, 9847, 15879, 19268]","[372, 636, 672, 1797, 1972, 2248, 2376, 2860, 3140, 3243, 3321, 3731, 4119, 4174, 4684, 4778, 4865, 5385, 5446, 5850, 5864, 5876, 5927, 6071, 6178, 6964, 7368, 8266, 8364, 8494, 8721, 8796, 9161, 9282, 9286, 9391, 9526, 9965, 10120, 10170, 10734, 10877, 10987, 11136, 11158, 11182, 11397, 11401, 11928, 12302, 12329, 13103, 13812, 13969, 14169, 14418, 14645, 14655, 14702, 14808, 15205, 15210, 15473, 15596, 15803, 15901, 16084, 16844, 18130, 18292, 18552, 18689, 19046, 19301, 19483, 19537, 19599, 19657, 19747, 20044, 21216, 21250, 21311, 21624, 21640, 21795, 21930, 22055, 22309, 22369, 22524, 22536, 22809, 22814, 23494, 24724, 24873, 25403, 25810, 25819, 26308, 26943, 27097, 27785, 27983, 28627, 28773, 28973, 29070, 29300, 29338, 29400, 29441, 29518, 29555, 29710, 29830, 30034, 30410, 30436, 30535, 30554, 30602, 30999, 31004, 31046, 31147, 31179, 31515, 32027, 32099, 32333, 33900, 34107, 34645, 35521, 35761, 35777, 35860, 35958, 36682, 36718]","[1160, 2038, 2882, 5244, 8086, 9847, 15879, 19268]",36837,150,36687,8,142,36687,0
3.5,HUMIGERA,"[68, 1072, 1089, 1261, 1342, 1601, 1664, 1797, 2173, 2574, 3105, 3141, 3309, 3416, 3471, 3683, 4527, 4653, 4792, 4971, 5005, 5024, 5043, 5105, 5168, 5626, 5681, 5709, 6083, 6188, 6281, 6676, 7019, 7275]","[1342, 1797, 3105, 5168]","[68, 1072, 1089, 1261, 1601, 1664, 2173, 2574, 3141, 3309, 3416, 3471, 3683, 4527, 4653, 4792, 4971, 5005, 5024, 5043, 5105, 5626, 5681, 5709, 6083, 6188, 6281, 6676, 7019, 7275]","[1342, 1797, 3105, 5168]",7651,34,7617,4,30,7617,0
3.5,HUMIL2RGA,"[28, 231, 735, 772, 817, 840, 1232, 1476, 1646, 1914, 1957, 1980, 2162, 2402, 2683, 2783, 2794, 2841, 3031, 3126, 3353, 3781, 4026]","[735, 1476, 2402, 3031, 3353]","[28, 231, 772, 817, 840, 1232, 1646, 1914, 1957, 1980, 2162, 2683, 2783, 2794, 2841, 3126, 3781, 4026]","[203, 735, 1128, 1476, 2402, 3031, 3353]",4030,23,4007,5,18,4005,2
3.5,HUMIL4A,"[59, 67, 189, 290, 328, 407, 491, 1306, 1344, 1626, 1644, 2072, 2810, 3234, 3254, 3380, 3469, 3861, 3877, 4037, 4460, 4465, 4830, 4997, 6460, 6557, 6702, 7003, 7433, 7514, 7518, 7646, 7915, 7981, 8041, 8135, 8208, 8316, 8362, 8391, 8407, 8461, 8466, 8512, 8605, 8686, 9292, 9400, 9501, 9622]","[1306, 1626, 7003]","[59, 67, 189, 290, 328, 407, 491, 1344, 1644, 2072, 2810, 3234, 3254, 3380, 3469, 3861, 3877, 4037, 4460, 4465, 4830, 4997, 6460, 6557, 6702, 7433, 7514, 7518, 7646, 7915, 7981, 8041, 8135, 8208, 8316, 8362, 8391, 8407, 8461, 8466, 8512, 8605, 8686, 9292, 9400, 9501, 9622]","[1306, 1626, 7003]",9892,50,9842,3,47,9842,0
3.5,HUMIRBPG,"[786, 791, 1285, 1516, 1819, 1823, 1861, 2419, 2428, 2593, 2776, 2935, 3181, 3221, 3263, 3550, 3861, 4554, 4599, 4606, 4612, 4672, 4686, 4736, 5069, 5157, 5340, 5556, 5568, 6337, 6592, 6975, 7160, 7261, 8440, 8766, 8885, 9086, 9262]","[3181, 5157, 7160]","[786, 791, 1285, 1516, 1819, 1823, 1861, 2419, 2428, 2593, 2776, 2935, 3221, 3263, 3550, 3861, 4554, 4599, 4606, 4612, 4672, 4686, 4736, 5069, 5340, 5556, 5568, 6337, 6592, 6975, 7261, 8440, 8766, 8885, 9086, 9262]","[3181, 5157, 7160]",9703,39,9664,3,36,9664,0
3.5,HUMLHDC,"[166, 258, 262, 697, 766, 791, 843, 1727, 1763, 2138, 2859, 3070, 3735, 3820, 4598, 4641, 4925, 5520, 6016, 6140, 6257, 6295, 6432, 6492, 7357, 7415, 7475, 7949, 8171, 8200, 8690, 8890, 8992, 9773, 9823, 10421, 10512, 10795, 11183, 11221, 11591, 11765, 11770, 11774, 11797, 12252, 12347, 12354, 12756, 13017, 13049, 13087, 13467, 13768, 14169, 14605, 15099, 15584, 15896, 15970, 16003, 16409, 16490, 16729, 16774, 17237, 17363, 17536, 18253, 18382, 18464, 18782, 18827, 18855, 19019, 19312, 19687, 19692, 19921, 19951, 20075, 20118, 20137, 20143, 20300, 20482, 20508, 20857, 21206, 21593, 21661, 21813, 21867, 22046, 22090, 22140, 22219, 22928, 23457, 23463, 23866, 24054, 24086, 24666, 24767, 25000, 25206, 25233, 25246, 25488, 25563, 25846, 25895, 26636, 27104, 27699, 28034, 28067, 28191, 28493, 28499, 28537, 28671, 28843, 29151, 29773, 30408, 30438, 30867, 30871, 31558, 31702, 31819, 31856, 32156, 32346]","[7415, 9773, 14605, 15584, 18382, 18782, 19312, 20300, 20482, 24666, 29773]","[166, 258, 262, 697, 766, 791, 843, 1727, 1763, 2138, 2859, 3070, 3735, 3820, 4598, 4641, 4925, 5520, 6016, 6140, 6257, 6295, 6432, 6492, 7357, 7475, 7949, 8171, 8200, 8690, 8890, 8992, 9823, 10421, 10512, 10795, 11183, 11221, 11591, 11765, 11770, 11774, 11797, 12252, 12347, 12354, 12756, 13017, 13049, 13087, 13467, 13768, 14169, 15099, 15896, 15970, 16003, 16409, 16490, 16729, 16774, 17237, 17363, 17536, 18253, 18464, 18827, 18855, 19019, 19687, 19692, 19921, 19951, 20075, 20118, 20137, 20143, 20508, 20857, 21206, 21593, 21661, 21813, 21867, 22046, 22090, 22140, 22219, 22928, 23457, 23463, 23866, 24054, 24086, 24767, 25000, 25206, 25233, 25246, 25488, 25563, 25846, 25895, 26636, 27104, 27699, 28034, 28067, 28191, 28493, 28499, 28537, 28671, 28843, 29151, 30408, 30438, 30867, 30871, 31558, 31702, 31819, 31856, 32156, 32346]","[7415, 9773, 14605, 15584, 18382, 18782, 19312, 20300, 20482, 24666, 29773]",32343,136,32207,11,125,32207,0
3.5,HUMLUCT,"[108, 324, 1550, 1877, 2369, 2505, 2861, 3004]","[1550, 2505, 2861]","[108, 324, 1877, 2369, 3004]","[1550, 2505, 2861]",3288,8,3280,3,5,3280,0
3.5,HUMLYTOXBB,"[540, 855, 1097, 1235, 1357, 1395, 2157, 2184, 2202, 2275, 2657, 2694, 2734, 2934, 3048, 3150, 3207, 3229, 3330, 3376, 3631, 4298, 4333, 4402, 4472, 4477, 4504, 4665, 4677, 4948, 5005, 5291, 5345, 5349, 5530, 6032, 6179]","[2934, 3376, 3631]","[540, 855, 1097, 1235, 1357, 1395, 2157, 2184, 2202, 2275, 2657, 2694, 2734, 3048, 3150, 3207, 3229, 3330, 4298, 4333, 4402, 4472, 4477, 4504, 4665, 4677, 4948, 5005, 5291, 5345, 5349, 5530, 6032, 6179]","[2934, 3376, 3631]",6297,37,6260,3,34,6260,0
3.5,HUMMCHEMP,"[159, 280, 674, 790, 812, 984, 1065, 1077, 1328, 1590]","[674, 1590]","[159, 280, 790, 812, 984, 1065, 1077, 1328]","[674, 1590]",2756,10,2746,2,8,2746,0
3.5,HUMMET2,"[505, 615, 866, 1128, 1167, 1233]","[866, 1233]","[505, 615, 1128, 1167]","[866, 1233]",1695,6,1689,2,4,1689,0
3.5,HUMMGPA,"[4, 333, 845, 1045, 1050, 1288, 1299, 2295, 2484, 2515, 3076, 3137, 3516, 3748, 4493, 5093, 5401, 6334, 7349, 7617]","[3516, 5093, 6334]","[4, 333, 845, 1045, 1050, 1288, 1299, 2295, 2484, 2515, 3076, 3137, 3748, 4493, 5401, 7349, 7617]","[3516, 5093, 6334]",7726,20,7706,3,17,7706,0
3.5,HUMMIF,"[700, 753, 825, 912, 997, 1129, 1643, 1893]",[1643],"[700, 753, 825, 912, 997, 1129, 1893]","[1281, 1643]",2159,8,2151,1,7,2150,1
3.5,HUMMIS,"[527, 623, 669, 778, 1358, 1489, 1639, 1887, 2044, 2832, 2962]","[623, 1358, 1639, 1887]","[527, 669, 778, 1489, 2044, 2832, 2962]","[623, 1358, 1639, 1887]",3092,11,3081,4,7,3081,0
3.5,HUMMKXX,"[679, 870, 1040, 1168, 1264, 1290, 1415, 1574, 1737, 1887, 2019, 2078, 2202, 2463, 2985, 3142, 3172, 3194]","[1415, 1737, 2019]","[679, 870, 1040, 1168, 1264, 1290, 1574, 1887, 2078, 2202, 2463, 2985, 3142, 3172, 3194]","[1415, 1737, 2019]",3300,18,3282,3,15,3282,0
3.5,HUMNKG5PRO,"[214, 298, 345, 362, 389, 666, 843, 964, 1055, 1118, 1505, 1644, 1865, 2262, 2357, 2431, 2639, 2715, 2721, 2788, 2915, 2978, 3215, 3283, 3314, 3387, 3580, 3584, 3848, 3912, 3982, 4048, 4473, 5180, 5323, 5379, 5435, 5468, 5480, 6072, 6576, 6599]","[2262, 3215, 3848, 5468]","[214, 298, 345, 362, 389, 666, 843, 964, 1055, 1118, 1505, 1644, 1865, 2357, 2431, 2639, 2715, 2721, 2788, 2915, 2978, 3283, 3314, 3387, 3580, 3584, 3912, 3982, 4048, 4473, 5180, 5323, 5379, 5435, 5480, 6072, 6576, 6599]","[2262, 3215, 3848, 5468]",6738,42,6696,4,38,6696,0
3.5,HUMNTRI,"[10, 575, 668, 1247, 1349, 1483, 1629, 2145, 2342, 2412, 2615, 2802, 3141, 3151]",[2802],"[10, 575, 668, 1247, 1349, 1483, 1629, 2145, 2342, 2412, 2615, 3141, 3151]",[2802],3702,14,3688,1,13,3688,0
3.5,HUMNTRIII,"[10, 575, 668, 1247, 1349, 1483, 1629, 2145, 2342, 2412, 2615, 2802, 3141, 3151]",[2802],"[10, 575, 668, 1247, 1349, 1483, 1629, 2145, 2342, 2412, 2615, 3141, 3151]",[2802],3702,14,3688,1,13,3688,0
3.5,HUMOSTP,"[214, 970, 1549, 1581, 2162, 2358, 3054, 3385, 3509, 3657, 3909, 4738, 5862, 6004, 6322, 6327, 6420, 6480, 6679, 6986, 7239, 7813, 7897, 8035, 8287, 8349, 8520, 8832, 9372, 10025, 10352, 10617, 10776]","[3509, 3657, 6679, 6986, 8349]","[214, 970, 1549, 1581, 2162, 2358, 3054, 3385, 3909, 4738, 5862, 6004, 6322, 6327, 6420, 6480, 7239, 7813, 7897, 8035, 8287, 8520, 8832, 9372, 10025, 10352, 10617, 10776]","[3509, 3657, 6679, 6986, 8349]",10714,33,10681,5,28,10681,0
3.5,HUMPAP,"[167, 440, 641, 1012, 1410, 1490, 1495, 1676, 1737, 1970, 2089, 2115, 2354, 2414, 3167, 3336, 3342, 3477, 3574, 4164, 4270, 4366, 4478]","[1410, 2089, 2414, 3167]","[167, 440, 641, 1012, 1490, 1495, 1676, 1737, 1970, 2115, 2354, 3336, 3342, 3477, 3574, 4164, 4270, 4366, 4478]","[1410, 2089, 2414, 3167]",4489,23,4466,4,19,4466,0
3.5,HUMPCI,"[284, 308, 312, 511, 803, 914, 1118, 1538, 1978, 2078, 2124, 2208, 2226, 2298, 2586, 2671, 2784, 2812, 2930, 2957, 3129, 3238, 3307, 3477, 3536, 3575, 3636, 3685, 3914, 4332, 4672, 4697, 4718, 4859, 5210, 5543, 5864, 6192, 6409, 7088, 7199, 7255, 8054, 8156, 8384, 8568, 8664, 8725, 9094, 9209, 9603, 9820, 9964, 10139, 10273, 10704, 10819, 10839, 10855, 10898, 11275, 11483, 12583, 12688, 12792, 12966, 13606, 14117, 14121, 14247, 14264, 14272, 14452, 14982, 15064, 15146]","[8568, 10898, 11483]","[284, 308, 312, 511, 803, 914, 1118, 1538, 1978, 2078, 2124, 2208, 2226, 2298, 2586, 2671, 2784, 2812, 2930, 2957, 3129, 3238, 3307, 3477, 3536, 3575, 3636, 3685, 3914, 4332, 4672, 4697, 4718, 4859, 5210, 5543, 5864, 6192, 6409, 7088, 7199, 7255, 8054, 8156, 8384, 8664, 8725, 9094, 9209, 9603, 9820, 9964, 10139, 10273, 10704, 10819, 10839, 10855, 11275, 12583, 12688, 12792, 12966, 13606, 14117, 14121, 14247, 14264, 14272, 14452, 14982, 15064, 15146]","[8568, 10898, 11483]",15563,76,15487,3,73,15487,0
3.5,HUMPEM,"[65, 693, 700, 789, 934, 948, 1033, 1472, 1537, 2101, 2266, 2421, 2614, 2707, 2850, 2973, 3203, 3297, 3314, 3352, 3590, 3745, 3904, 3921, 4210]","[934, 2266, 2421, 2707, 2973, 3203]","[65, 693, 700, 789, 948, 1033, 1472, 1537, 2101, 2614, 2850, 3297, 3314, 3352, 3590, 3745, 3904, 3921, 4210]","[934, 2266, 2421, 2707, 2973, 3203]",4235,25,4210,6,19,4210,0
3.5,HUMPEPYYA,"[7, 20, 647, 727, 766, 904, 1201, 1307, 1388, 1516, 1537, 1658, 1699, 1824, 2196, 2243, 2254]","[1201, 1388]","[7, 20, 647, 727, 766, 904, 1307, 1516, 1537, 1658, 1699, 1824, 2196, 2243, 2254]","[1201, 1388]",2370,17,2353,2,15,2353,0
3.5,HUMPF4V1A,"[11, 46, 199, 381, 509, 785, 826]","[381, 826]","[11, 46, 199, 509, 785]","[381, 826]",1460,7,1453,2,5,1453,0
3.5,HUMPHOSA,"[87, 233, 312, 425, 536, 604, 850, 1286, 1300, 1494, 1555, 1713, 1810, 2185, 2323, 2469, 2988, 3209, 3729, 4449, 4516, 4789]","[233, 850, 1494, 1810, 2323, 2988, 3209, 3729]","[87, 312, 425, 536, 604, 1286, 1300, 1555, 1713, 2185, 2469, 4449, 4516, 4789]","[233, 850, 1494, 1810, 2323, 2988, 3209, 3729]",4884,22,4862,8,14,4862,0
3.5,HUMPRCA,"[130, 488, 498, 684, 1048, 1687, 1916, 2114, 2201, 2304, 2309, 2354, 2761, 3044, 3181, 3438, 3499, 3631, 3703, 3995, 4175, 4778, 5118, 5213, 5348, 5452, 5512, 5585, 6604, 6648, 6777, 6827, 6933, 7002, 7256, 7719, 8396, 8524, 8580, 8584, 9206, 9387, 9430, 9479, 9620, 10055, 10395, 10968, 10977, 10987, 11461, 11602]","[2201, 3631, 5118, 5348, 5585, 8396, 9387]","[130, 488, 498, 684, 1048, 1687, 1916, 2114, 2304, 2309, 2354, 2761, 3044, 3181, 3438, 3499, 3703, 3995, 4175, 4778, 5213, 5452, 5512, 6604, 6648, 6777, 6827, 6933, 7002, 7256, 7719, 8524, 8580, 8584, 9206, 9430, 9479, 9620, 10055, 10395, 10968, 10977, 10987, 11461, 11602]","[2201, 3631, 5118, 5348, 5585, 8396, 9387]",11717,52,11665,7,45,11665,0
3.5,HUMPREELAS,"[180, 274, 478, 596, 608, 826, 1054, 1070, 1357, 1619, 1724, 1729, 1785, 1802, 1827]",[596],"[180, 274, 478, 608, 826, 1054, 1070, 1357, 1619, 1724, 1729, 1785, 1802, 1827]",[596],2291,15,2276,1,14,2276,0
3.5,HUMPRPHX,"[71, 317, 568, 778, 963, 1143, 1299, 1346, 1475, 1551, 1838, 1911, 2127, 2140, 2502, 2523, 2532, 2550, 2869, 3173, 3322, 3633, 3719, 3914, 4225, 4319]","[1346, 1838, 2127, 2869, 3173, 3322, 3633]","[71, 317, 568, 778, 963, 1143, 1299, 1475, 1551, 1911, 2140, 2502, 2523, 2532, 2550, 3719, 3914, 4225, 4319]","[1346, 1838, 2127, 2652, 2869, 3173, 3322, 3633]",4524,26,4498,7,19,4497,1
3.5,HUMRCC1,"[108, 246, 486, 560, 638, 654, 973, 1017, 1099, 1608, 1708, 2437, 2711, 3451, 4068, 4242, 4304, 4379, 4555, 4654, 4681, 4733, 4737, 4787, 4872, 4991, 5210, 5479, 5539, 5545, 5562, 5741, 6493, 6765, 7271, 7529, 7642, 8110, 8620, 8701, 8862, 8986, 9297, 9448, 9869, 9960, 10003, 10178, 10252, 10366, 10535, 10711, 10754, 11120, 11134, 11329, 11364, 11415, 12204, 12573, 12616, 12731, 13006, 13360, 13471, 13510, 13805, 13819, 14069, 14112, 14368, 14604, 14619, 14697, 14702, 15108, 15126, 15324, 15385, 15440, 15532, 15548, 15580, 15704, 15894, 16280, 16316, 16362, 16465, 16526, 16574, 16836, 17016, 17025, 17060, 17556, 17659, 17950, 18304, 18348, 18716, 18795, 19037, 19296, 19784, 19855, 20442, 20525, 20685, 20849, 20918, 21036, 21092, 21296, 21303, 21774, 22033, 22051, 22193, 22205, 22579, 22748, 22826, 22868, 23423, 23588, 23681, 23725, 24194, 24201, 24839, 25071, 25287, 25727, 25857, 26108, 26218, 26579, 26679, 26701, 26808, 26950, 26989, 27447, 27798, 27973, 28010, 28244, 28523, 28793, 28858, 28893, 29020, 29247, 29419, 29746, 29766, 29965, 30000, 30085, 30235, 30648, 31313, 31610, 31672, 32040, 32435, 33137, 33187, 33278, 33404, 33503, 34138, 34406, 34481]","[24201, 26218, 26579, 28010, 28244, 28893, 29247, 29766]","[108, 246, 486, 560, 638, 654, 973, 1017, 1099, 1608, 1708, 2437, 2711, 3451, 4068, 4242, 4304, 4379, 4555, 4654, 4681, 4733, 4737, 4787, 4872, 4991, 5210, 5479, 5539, 5545, 5562, 5741, 6493, 6765, 7271, 7529, 7642, 8110, 8620, 8701, 8862, 8986, 9297, 9448, 9869, 9960, 10003, 10178, 10252, 10366, 10535, 10711, 10754, 11120, 11134, 11329, 11364, 11415, 12204, 12573, 12616, 12731, 13006, 13360, 13471, 13510, 13805, 13819, 14069, 14112, 14368, 14604, 14619, 14697, 14702, 15108, 15126, 15324, 15385, 15440, 15532, 15548, 15580, 15704, 15894, 16280, 16316, 16362, 16465, 16526, 16574, 16836, 17016, 17025, 17060, 17556, 17659, 17950, 18304, 18348, 18716, 18795, 19037, 19296, 19784, 19855, 20442, 20525, 20685, 20849, 20918, 21036, 21092, 21296, 21303, 21774, 22033, 22051, 22193, 22205, 22579, 22748, 22826, 22868, 23423, 23588, 23681, 23725, 24194, 24839, 25071, 25287, 25727, 25857, 26108, 26679, 26701, 26808, 26950, 26989, 27447, 27798, 27973, 28523, 28793, 28858, 29020, 29419, 29746, 29965, 30000, 30085, 30235, 30648, 31313, 31610, 31672, 32040, 32435, 33137, 33187, 33278, 33404, 33503, 34138, 34406, 34481]","[24201, 26218, 26579, 28010, 28244, 28893, 29247, 29766]",34633,175,34458,8,167,34458,0
3.5,HUMREGHOM,"[52, 274, 410, 684, 1107, 1170, 1419, 1423, 1459, 1602, 1864, 1909, 2739, 2825]","[684, 1419, 1864, 2739]","[52, 274, 410, 1107, 1170, 1423, 1459, 1602, 1909, 2825]","[684, 1419, 1864, 2739]",3403,14,3389,4,10,3389,0
3.5,HUMROD1X,"[321, 454, 980, 1146, 1223, 1242, 1876, 2015, 2227, 2288, 2343, 2611, 2638, 2695, 2720]","[1242, 1876]","[321, 454, 980, 1146, 1223, 2015, 2227, 2288, 2343, 2611, 2638, 2695, 2720]","[1242, 1876]",2833,15,2818,2,13,2818,0
3.5,HUMRPIB2,"[310, 356, 435, 472, 510, 622, 899, 1121, 1257, 1531, 1954, 2017, 2268, 2272, 2308, 2451, 2713, 2758, 3588, 3674]","[1531, 2268, 2713, 3588]","[310, 356, 435, 472, 510, 622, 899, 1121, 1257, 1954, 2017, 2272, 2308, 2451, 2758, 3674]","[1531, 2268, 2713, 3588]",4329,20,4309,4,16,4309,0
3.5,HUMRPS6B,"[359, 784, 1012, 1059, 1083, 1101, 1168, 1232, 1721, 1838, 2146, 2178, 2651, 2866, 3072, 3084, 3893, 4051, 4432, 4655, 4838]","[359, 1059, 1838, 2178, 4051]","[784, 1012, 1083, 1101, 1168, 1232, 1721, 2146, 2651, 2866, 3072, 3084, 3893, 4432, 4655, 4838]","[359, 1059, 1838, 2178, 4051]",4964,21,4943,5,16,4943,0
3.5,HUMSEMI,"[578, 681, 793, 806, 975, 1583, 1636, 2015, 2362, 2394, 2547, 2682, 2979, 3074, 3167, 3496, 3849, 3886]",[793],"[578, 681, 806, 975, 1583, 1636, 2015, 2362, 2394, 2547, 2682, 2979, 3074, 3167, 3496, 3849, 3886]",[793],4156,18,4138,1,17,4138,0
3.5,HUMSEMIIB,"[121, 493, 528, 765, 1274, 1298, 1316, 1389, 1490, 1642, 1790, 1889, 1988, 2444, 2489, 2515, 2616, 2746, 2979, 3011, 3135, 3352, 3769, 3843, 4271, 4486, 4499, 4660, 4667, 5275, 5328, 5640, 5820, 6000, 6304, 6446, 6514, 7146, 7527, 7944]",[4486],"[121, 493, 528, 765, 1274, 1298, 1316, 1389, 1490, 1642, 1790, 1889, 1988, 2444, 2489, 2515, 2616, 2746, 2979, 3011, 3135, 3352, 3769, 3843, 4271, 4499, 4660, 4667, 5275, 5328, 5640, 5820, 6000, 6304, 6446, 6514, 7146, 7527, 7944]",[4486],8216,40,8176,1,39,8176,0
3.5,HUMSTATH2,"[49, 353, 911, 1140, 1197, 1553, 1675, 1820, 2025, 2056, 2131, 2151, 2312, 2322, 2403, 2530, 2627, 2733, 2848, 3239, 4320, 4592, 4629]","[353, 1553, 1675]","[49, 911, 1140, 1197, 1820, 2025, 2056, 2131, 2151, 2312, 2322, 2403, 2530, 2627, 2733, 2848, 3239, 4320, 4592, 4629]","[353, 1553, 1675]",4715,23,4692,3,20,4692,0
3.5,HUMTBGA,"[362, 377, 451, 460, 854, 1021, 1435, 1646, 2099, 2681, 2911, 3107, 3244, 3355, 3744, 4216, 4529, 4941, 5032, 5164, 5177, 5231, 5236, 5469, 5475, 5530, 5782, 5875, 6296, 6314, 6627, 6841, 7144, 7395, 7441, 7960, 8219, 8362]","[4941, 7144]","[362, 377, 451, 460, 854, 1021, 1435, 1646, 2099, 2681, 2911, 3107, 3244, 3355, 3744, 4216, 4529, 5032, 5164, 5177, 5231, 5236, 5469, 5475, 5530, 5782, 5875, 6296, 6314, 6627, 6841, 7395, 7441, 7960, 8219, 8362]","[4941, 6265, 7144]",8761,38,8723,2,36,8722,1
3.5,HUMTCRBRA,"[199, 278, 318, 405, 469, 505, 561]",[278],"[199, 318, 405, 469, 505, 561]",[278],728,7,721,1,6,721,0
3.5,HUMTHROMA,"[159, 743, 787, 800, 818, 1277, 1428, 1464, 1605, 1696, 1985, 2344, 2384, 2717, 3117, 4129, 4222, 4266, 4362, 4394, 4430, 4817, 5134, 5715]","[1985, 2344, 2717, 4817]","[159, 743, 787, 800, 818, 1277, 1428, 1464, 1605, 1696, 2384, 3117, 4129, 4222, 4266, 4362, 4394, 4430, 5134, 5715]","[1985, 2344, 2717, 4817]",6155,24,6131,4,20,6131,0
3.5,HUMTNP2SS,"[80, 86, 177, 658, 673, 725, 941]",[658],"[80, 86, 177, 673, 725, 941]",[658],1774,7,1767,1,6,1767,0
3.5,HUMTPALBU,"[313, 722, 942, 1094, 1359, 1559, 1621, 1708, 1887, 2692, 2741, 2932, 2941, 3168, 3377, 3425, 3781, 4153, 4361, 4587, 4707, 4720, 5066, 5992, 6086]","[1094, 1621, 2741, 3425, 4361]","[313, 722, 942, 1359, 1559, 1708, 1887, 2692, 2932, 2941, 3168, 3377, 3781, 4153, 4587, 4707, 4720, 5066, 5992, 6086]","[1094, 1621, 2741, 3425, 4361]",6164,25,6139,5,20,6139,0
3.5,HUMTRHYAL,"[192, 201, 301, 562, 827, 1120, 1557, 1645, 1793, 2232, 2340, 2837, 4658, 6019, 6083, 6556, 7415, 7814, 8581]",[1645],"[192, 201, 301, 562, 827, 1120, 1557, 1793, 2232, 2340, 2837, 4658, 6019, 6083, 6556, 7415, 7814, 8581]",[1645],9543,19,9524,1,18,9524,0
3.5,HUMTSHB2,"[187, 780, 872]",[187],"[780, 872]",[187],978,3,975,1,2,975,0
3.5,HUMV2R,"[261, 287, 957, 965, 1366, 1404, 1507, 1815, 2047, 2118, 2128]","[261, 1507]","[287, 957, 965, 1366, 1404, 1815, 2047, 2118, 2128]","[261, 1507]",2274,11,2263,2,9,2263,0
3.5,HYPSCGH,"[41, 337, 806, 837, 889, 1039, 1252, 1624]","[41, 1039, 1624]","[337, 806, 837, 889, 1252]","[41, 451, 1039, 1624]",2476,8,2468,3,5,2467,1
3.5,LAYEGLOBIN,"[222, 238, 470, 584, 600, 1061, 1185, 1197, 1265, 1312, 1373]","[238, 584]","[222, 470, 600, 1061, 1185, 1197, 1265, 1312, 1373]","[238, 584]",1694,11,1683,2,9,1683,0
3.5,LEBGLOB,"[94, 142, 157, 658, 662, 672, 1373, 1501, 1539, 1561, 1577, 1663, 1791, 1812, 1828, 1926, 2206, 2555, 3171, 3208, 3565]","[1577, 1926]","[94, 142, 157, 658, 662, 672, 1373, 1501, 1539, 1561, 1663, 1791, 1812, 1828, 2206, 2555, 3171, 3208, 3565]","[1577, 1926]",3638,21,3617,2,19,3617,0
3.5,LNOEGLOBIN,"[220, 236, 345, 473, 587, 603, 724, 1062, 1185, 1197, 1265, 1293, 1312]","[236, 587]","[220, 345, 473, 603, 724, 1062, 1185, 1197, 1265, 1293, 1312]","[236, 587]",1690,13,1677,2,11,1677,0
3.5,MACHBGA1,"[283, 457, 495, 727, 794, 841, 1008, 1188, 1370]","[495, 841]","[283, 457, 727, 794, 1008, 1188, 1370]","[495, 841]",2097,9,2088,2,7,2088,0
3.5,MACHBGA2,"[20, 281, 455, 493, 725, 792, 839, 1006, 1185, 1367]","[493, 839]","[20, 281, 455, 725, 792, 1006, 1185, 1367]","[493, 839]",2100,10,2090,2,8,2090,0
3.5,MAMGLUTRA,"[34, 424, 484, 488, 657, 663, 821, 1073, 1082, 1255, 1627, 1718, 1819, 2152, 2406, 2558, 2745, 2938, 3059, 3175, 4252, 4272, 4642, 4967, 4974, 5131, 5135, 5213, 5870, 6065]","[484, 821, 1255, 1627, 1819, 2745, 2938]","[34, 424, 488, 657, 663, 1073, 1082, 1718, 2152, 2406, 2558, 3059, 3175, 4252, 4272, 4642, 4967, 4974, 5131, 5135, 5213, 5870, 6065]","[484, 821, 1255, 1627, 1819, 2745, 2938]",6287,30,6257,7,23,6257,0
3.5,MAU09941,"[11, 401, 613, 778, 1031, 1166, 1480, 1803, 1830, 1846, 2406, 2427, 2514, 2667, 2932, 2968, 3124, 3134, 3521, 3697]",[1830],"[11, 401, 613, 778, 1031, 1166, 1480, 1803, 1846, 2406, 2427, 2514, 2667, 2932, 2968, 3124, 3134, 3521, 3697]",[1830],3798,20,3778,1,19,3778,0
3.5,MFAPOA2A,"[53, 69, 133, 226, 379, 571, 587, 720, 785, 1422]","[379, 785]","[53, 69, 133, 226, 571, 587, 720, 1422]","[379, 785]",1489,10,1479,2,8,1479,0
3.5,MFAPOC3A,"[115, 232, 622, 642, 913, 1172, 1239, 1715, 1993, 2190, 2232, 2384, 2689, 3068, 3213, 3244]","[913, 1172]","[115, 232, 622, 642, 1239, 1715, 1993, 2190, 2232, 2384, 2689, 3068, 3213, 3244]","[913, 1172]",3254,16,3238,2,14,3238,0
3.5,MMA2IXCOA,"[584, 599, 798, 859, 878, 1383, 1439, 1757, 1800, 1812, 1866, 1881, 1925, 2183, 2935, 3105, 3132, 3652, 4386, 5665, 5682, 5831, 6014, 6054, 6266, 6355, 6481, 6628, 6635, 6930, 7102, 7250, 7371, 7472, 7658, 7684, 8064, 8135, 8216, 8255, 8401, 8539, 8882, 9179, 9209, 9322, 9437, 9467, 9573, 9609, 9626, 9702, 9793, 10270, 10282, 10304, 10930, 11077, 11426, 11555, 11611, 12074, 12406, 12792, 12952, 12989, 13033, 13111, 13361, 13447, 13726, 13786, 13840, 13912, 14575, 14663, 15021, 15338, 15597, 15746, 15933, 16114, 16240, 16522, 16811, 17106, 17145, 17275, 17333, 17647, 18032, 18243, 18283, 19461]","[3132, 4386, 5682, 5831, 7102, 7250, 7371, 7684, 8064, 8216, 8401, 8539, 8882, 9322, 9467, 9626, 13033, 13447, 13726, 14575, 15021, 15338, 15597, 15746, 15933, 16114, 16240, 16522, 16811, 17275, 17647]","[584, 599, 798, 859, 878, 1383, 1439, 1757, 1800, 1812, 1866, 1881, 1925, 2183, 2935, 3105, 3652, 5665, 6014, 6054, 6266, 6355, 6481, 6628, 6635, 6930, 7472, 7658, 8135, 8255, 9179, 9209, 9437, 9573, 9609, 9702, 9793, 10270, 10282, 10304, 10930, 11077, 11426, 11555, 11611, 12074, 12406, 12792, 12952, 12989, 13111, 13361, 13786, 13840, 13912, 14663, 17106, 17145, 17333, 18032, 18243, 18283, 19461]","[3132, 4386, 5682, 5831, 7102, 7250, 7371, 7684, 8064, 8216, 8401, 8539, 8882, 9322, 9467, 9626, 13033, 13447, 13726, 14575, 15021, 15338, 15597, 15746, 15933, 16114, 16240, 16522, 16811, 17275, 17647]",19471,94,19377,31,63,19377,0
3.5,MMACLGNA,"[474, 499, 541, 553, 918, 1192, 1458, 1499, 2397, 2537, 2666, 2734, 2923, 2933, 3107, 3178]","[474, 3178]","[499, 541, 553, 918, 1192, 1458, 1499, 2397, 2537, 2666, 2734, 2923, 2933, 3107]","[474, 3178]",3873,16,3857,2,14,3857,0
3.5,MMAPOG,"[143, 265, 536, 669, 806, 876, 1186, 1456, 1501, 1935, 2056, 2146]","[536, 806]","[143, 265, 669, 876, 1186, 1456, 1501, 1935, 2056, 2146]","[536, 806]",2168,12,2156,2,10,2156,0
3.5,MMASM1G,"[1088, 1141, 1294, 1492, 1591, 2065, 2244, 2830, 2928, 2961, 3168, 3245, 3367, 3599, 3619, 3745, 3749, 4681]","[1088, 2244, 2928, 3245, 3745]","[1141, 1294, 1492, 1591, 2065, 2830, 2961, 3168, 3367, 3599, 3619, 3749, 4681]","[1088, 2244, 2928, 3245, 3745]",4767,18,4749,5,13,4749,0
3.5,MMCASEIB,"[15, 1113, 1488, 1889, 2857, 2974, 3141, 3145, 3289, 3742, 3746, 4901, 4916, 5615, 5877, 6252, 6305, 6603, 6611, 6905, 6932, 7023, 7155, 7160, 7964, 8126, 8222, 8252, 8851, 9203, 9803, 10443, 10796, 10861, 11712, 11758, 11765, 11838, 12014, 12187, 12928, 13000]","[6252, 7023, 7160, 8126, 8252, 9803]","[15, 1113, 1488, 1889, 2857, 2974, 3141, 3145, 3289, 3742, 3746, 4901, 4916, 5615, 5877, 6305, 6603, 6611, 6905, 6932, 7155, 7964, 8222, 8851, 9203, 10443, 10796, 10861, 11712, 11758, 11765, 11838, 12014, 12187, 12928, 13000]","[6252, 7023, 7160, 8126, 8252, 9803]",13046,42,13004,6,36,13004,0
3.5,MMCD24A,"[198, 233, 274, 287, 477, 1126, 1273, 1660, 1670, 1804, 1969, 2195, 2259, 2486, 2555, 2860, 3016, 3068, 3158, 3693, 3805, 3828, 3911, 3949, 4043, 4140, 5478, 5793, 6430, 6441, 7063, 7475]",[2486],"[198, 233, 274, 287, 477, 1126, 1273, 1660, 1670, 1804, 1969, 2195, 2259, 2555, 2860, 3016, 3068, 3158, 3693, 3805, 3828, 3911, 3949, 4043, 4140, 5478, 5793, 6430, 6441, 7063, 7475]",[2486],7632,32,7600,1,31,7600,0
3.5,MMCFOS,"[99, 844, 1244, 1248, 1646, 1790, 1850, 2137, 2162, 2208, 2363, 3118, 3414]","[844, 1850, 2363]","[99, 1244, 1248, 1646, 1790, 2137, 2162, 2208, 3118, 3414]","[844, 1850, 2363]",3959,13,3946,3,10,3946,0
3.5,MMCOL10A,"[30, 560, 1070, 1193, 1518, 1719, 1802, 1964, 2931, 3292, 3514, 3918, 4222, 4672, 4716, 4779, 4974, 5092, 5105, 5224, 5555, 5660, 5729, 5765, 5846, 5888, 6020, 6146, 6290, 6371, 6389, 6407, 6704, 6754, 6833, 6895, 6933, 7009, 7059, 7101, 7192, 7282, 7335, 7656, 8029, 8394, 9050, 9284, 9322]",[1802],"[30, 560, 1070, 1193, 1518, 1719, 1964, 2931, 3292, 3514, 3918, 4222, 4672, 4716, 4779, 4974, 5092, 5105, 5224, 5555, 5660, 5729, 5765, 5846, 5888, 6020, 6146, 6290, 6371, 6389, 6407, 6704, 6754, 6833, 6895, 6933, 7009, 7059, 7101, 7192, 7282, 7335, 7656, 8029, 8394, 9050, 9284, 9322]",[1802],9323,49,9274,1,48,9274,0
3.5,MMCRPG,"[375, 523, 929, 1011]",[375],"[523, 929, 1011]",[375],2132,4,2128,1,3,2128,0
3.5,MMCYTOKNA,"[810, 1089, 1123, 1339, 1580, 1881]",[810],"[1089, 1123, 1339, 1580, 1881]","[810, 1559]",2551,6,2545,1,5,2544,1
3.5,MMDM2RR,"[104, 665, 680, 854, 878, 1305, 1439, 1651, 1846, 2004, 2156, 2407, 2702, 2727, 3262, 3378, 3509, 3526, 3701, 3962, 4028, 4033, 4134, 4663, 4793, 4925, 5134, 5928, 6030, 6048, 6476, 6591]","[665, 854, 1305, 1651, 2702, 3701, 3962, 4925, 5134]","[104, 680, 878, 1439, 1846, 2004, 2156, 2407, 2727, 3262, 3378, 3509, 3526, 4028, 4033, 4134, 4663, 4793, 5928, 6030, 6048, 6476, 6591]","[665, 854, 1305, 1651, 2702, 3701, 3962, 4925, 5134]",6632,32,6600,9,23,6600,0
3.5,MMDNAASFA,"[542, 855, 859, 918, 1241, 1497, 1576, 1823, 2135, 2357, 2406, 3239, 3306, 3517, 3558, 4082, 4306]","[855, 1241, 1576, 1823, 2135, 2357]","[542, 859, 918, 1497, 2406, 3239, 3306, 3517, 3558, 4082, 4306]","[855, 1241, 1576, 1823, 2135, 2357, 2695]",4307,17,4290,6,11,4289,1
3.5,MMEZGL,"[589, 613, 621, 637, 715, 802, 852, 910, 1167, 1276, 1599, 1625, 1658]","[589, 1599]","[613, 621, 637, 715, 802, 852, 910, 1167, 1276, 1625, 1658]","[589, 1599]",1945,13,1932,2,11,1932,0
3.5,MMG37,"[87, 213, 265, 332, 348, 381, 788, 1049, 1303, 1700, 2119, 2363, 2570, 2771, 2788]","[332, 788, 1303, 2119, 2363, 2570]","[87, 213, 265, 348, 381, 1049, 1700, 2771, 2788]","[332, 788, 1303, 2119, 2363, 2570]",3065,15,3050,6,9,3050,0
3.5,MMGBCRYA,"[165, 169, 188, 332, 671, 1003, 1412, 1416, 1702, 1718, 1754, 2175, 2261, 2662]","[671, 1003]","[165, 169, 188, 332, 1412, 1416, 1702, 1718, 1754, 2175, 2261, 2662]","[671, 1003]",2653,14,2639,2,12,2639,0
3.5,MMGCCRYA,"[721, 1056, 1430, 1473, 1478, 1716, 1790, 1807, 2488, 2650, 2655]","[721, 1056]","[1430, 1473, 1478, 1716, 1790, 1807, 2488, 2650, 2655]","[721, 1056]",2884,11,2873,2,9,2873,0
3.5,MMGFAPD,"[108, 713, 976, 990, 1035, 1175, 1298, 1624, 1901, 2179, 2277, 2449, 2760, 2995, 3351, 3473, 3660, 3711, 4335, 4868, 5452, 6297, 6333, 6370, 6406, 6547, 6584, 6620, 6656, 6692, 6728, 6765, 6837, 6873, 6909, 7117, 7192, 7198, 7253, 7605, 7902, 7907, 8227, 8409, 8598, 8630, 9093, 9301, 9788]","[713, 1624, 1901, 2995, 4335, 5452, 7907]","[108, 976, 990, 1035, 1175, 1298, 2179, 2277, 2449, 2760, 3351, 3473, 3660, 3711, 4868, 6297, 6333, 6370, 6406, 6547, 6584, 6620, 6656, 6692, 6728, 6765, 6837, 6873, 6909, 7117, 7192, 7198, 7253, 7605, 7902, 8227, 8409, 8598, 8630, 9093, 9301, 9788]","[713, 1624, 1901, 2995, 3906, 4335, 5452, 7907]",9963,49,9914,7,42,9913,1
3.5,MMGGLINE,"[204, 279, 441, 1487, 1787, 2076, 2250, 2288, 2520, 2587, 2634, 2801, 2980, 3162, 3948, 4400, 4417, 4790, 4813, 4824, 4883, 5098, 5624, 5706, 6374, 6664, 6955, 7129, 7167, 7399, 7466, 7513, 7680, 7859, 8041, 8852, 9096, 9162, 9179, 9263, 9567, 9578, 9641, 9714, 9849, 10407, 10978, 11052]","[7167, 7513]","[204, 279, 441, 1487, 1787, 2076, 2250, 2288, 2520, 2587, 2634, 2801, 2980, 3162, 3948, 4400, 4417, 4790, 4813, 4824, 4883, 5098, 5624, 5706, 6374, 6664, 6955, 7129, 7399, 7466, 7680, 7859, 8041, 8852, 9096, 9162, 9179, 9263, 9567, 9578, 9641, 9714, 9849, 10407, 10978, 11052]","[7167, 7513]",11278,48,11230,2,46,11230,0
3.5,MMGK5,"[30, 244, 695, 1439, 1690, 1805, 1809, 1890, 2626, 2768, 2825, 2845, 2850, 2986, 3239, 3269, 3287, 3465, 3525]","[695, 1805, 2825]","[30, 244, 1439, 1690, 1809, 1890, 2626, 2768, 2845, 2850, 2986, 3239, 3269, 3287, 3465, 3525]","[695, 1805, 2595, 2825]",3602,19,3583,3,16,3582,1
3.5,MMH2D4Q5,"[159, 345, 644, 1055]","[159, 644]","[345, 1055]","[159, 644]",1100,4,1096,2,2,1096,0
3.5,MMHOX13,"[325, 369, 492, 800, 1037, 1147, 1455, 1570, 1647, 1651, 1716, 2076, 2407, 2504, 2583, 2658, 2798]",[800],"[325, 369, 492, 1037, 1147, 1455, 1570, 1647, 1651, 1716, 2076, 2407, 2504, 2583, 2658, 2798]",[800],2827,17,2810,1,16,2810,0
3.5,MMHOX24I,"[72, 705, 837, 896, 914, 1160, 1264, 1719]",[837],"[72, 705, 896, 914, 1160, 1264, 1719]",[837],1915,8,1907,1,7,1907,0
3.5,MMIL1BG,"[121, 572, 1356, 1567, 1803, 1938, 2470, 3239, 3249, 3333, 3680, 4271, 4398, 4844, 4988, 5080, 5679, 6172, 6670]","[1356, 1938, 3680, 4398, 5679]","[121, 572, 1567, 1803, 2470, 3239, 3249, 3333, 4271, 4844, 4988, 5080, 6172, 6670]","[1356, 1938, 3680, 4398, 5679]",7092,19,7073,5,14,7073,0
3.5,MMIL3G,"[129, 188, 469, 686, 732, 745, 824, 1913, 2090, 2583]","[686, 824, 1913, 2090]","[129, 188, 469, 732, 745, 2583]","[686, 824, 1913, 2090]",3482,10,3472,4,6,3472,0
3.5,MMIL5G,"[21, 151, 218, 731, 818, 980, 1473, 1593, 1625, 1971, 2262, 2448, 2708, 3418, 3597, 4000, 4702, 4774, 4806, 4929, 5217, 5303, 5318, 5441, 5742, 6026, 6478, 6608]","[731, 1593, 3597]","[21, 151, 218, 818, 980, 1473, 1625, 1971, 2262, 2448, 2708, 3418, 4000, 4702, 4774, 4806, 4929, 5217, 5303, 5318, 5441, 5742, 6026, 6478, 6608]","[731, 1593, 3597]",6719,28,6691,3,25,6691,0
3.5,MMKFGF,"[493, 542, 693, 976, 1045, 1086, 1254, 1259, 1279, 1337, 1556, 1574, 1624, 2012, 2079, 2322, 2484, 2561, 2886, 3185]","[542, 1045]","[493, 693, 976, 1086, 1254, 1259, 1279, 1337, 1556, 1574, 1624, 2012, 2079, 2322, 2484, 2561, 2886, 3185]","[542, 1045]",3981,20,3961,2,18,3961,0
3.5,MMLDHAG,"[105, 571, 1012, 1180, 1378, 1782, 1906, 2132, 2186, 2429, 2616, 2774, 2978, 4167, 4226, 4377, 4577, 4824, 5138, 5333, 5458, 5919, 6038, 6123, 7171, 7208, 7224, 7338, 7668, 7780, 7959, 7963, 8206, 8280, 8315, 8327, 8336, 8380, 8402, 8414, 8597, 8833, 8981, 9652, 9818, 9897, 9999, 10037, 10447, 10503, 10590, 10704, 10855, 11308, 11532, 11655, 11915, 11977, 12060, 12155, 12262, 12598]","[4577, 5919, 7171, 7668, 8597, 10704]","[105, 571, 1012, 1180, 1378, 1782, 1906, 2132, 2186, 2429, 2616, 2774, 2978, 4167, 4226, 4377, 4824, 5138, 5333, 5458, 6038, 6123, 7208, 7224, 7338, 7780, 7959, 7963, 8206, 8280, 8315, 8327, 8336, 8380, 8402, 8414, 8833, 8981, 9652, 9818, 9897, 9999, 10037, 10447, 10503, 10590, 10855, 11308, 11532, 11655, 11915, 11977, 12060, 12155, 12262, 12598]","[4577, 5919, 7171, 7668, 8597, 10704]",12843,62,12781,6,56,12781,0
3.5,MMMMP9A,"[11, 70, 1476, 1562, 1734, 1890, 1949, 2008, 2031, 2331, 2375, 2550, 2781, 2849, 3064, 3222, 3230, 3359, 3418, 3808, 3945, 4206, 4321, 4851, 4864, 4944, 5301, 5695, 5708, 5716, 5936, 6087, 6215, 6282, 6356, 6564, 7049, 7374, 7632, 7752, 7770, 7791, 7954]","[2008, 2375, 2781, 3064, 3418, 3945, 4206, 5695, 5936, 6356, 6564]","[11, 70, 1476, 1562, 1734, 1890, 1949, 2031, 2331, 2550, 2849, 3222, 3230, 3359, 3808, 4321, 4851, 4864, 4944, 5301, 5708, 5716, 6087, 6215, 6282, 7049, 7374, 7632, 7752, 7770, 7791, 7954]","[1341, 2008, 2375, 2781, 3064, 3418, 3945, 4206, 5695, 5936, 6356, 6564]",8182,43,8139,11,32,8138,1
3.5,MMMRPS24,"[40, 353, 404, 645, 670, 836, 959, 1106, 1196, 1460, 1518, 1761, 1994, 2253, 2406, 2669, 2683, 2987, 3095, 3137, 3192, 3263, 3713, 3934, 4371, 4905, 4969, 5070, 5091, 5435]","[404, 1460, 1761, 3137]","[40, 353, 645, 670, 836, 959, 1106, 1196, 1518, 1994, 2253, 2406, 2669, 2683, 2987, 3095, 3192, 3263, 3713, 3934, 4371, 4905, 4969, 5070, 5091, 5435]","[404, 1460, 1761, 3137]",5491,30,5461,4,26,5461,0
3.5,MMMTIX,"[402, 706, 758, 951, 1355, 1515]","[402, 951]","[706, 758, 1355, 1515]","[402, 951]",1552,6,1546,2,4,1546,0
3.5,MMMUPBS6,"[449, 731, 792, 861, 1203, 1246, 1298, 1451, 1614, 2045, 2425, 2793, 3236, 3445, 4527]","[731, 1203, 2045, 2793, 3236]","[449, 792, 861, 1246, 1298, 1451, 1614, 2425, 3445, 4527]","[731, 1203, 2045, 2793, 3236]",4614,15,4599,5,10,4599,0
3.5,MMMYCL,"[337, 580, 806, 919, 1170, 1615, 1787, 1951, 2042, 2350, 2419, 2554, 2785, 3292, 3810, 4161, 4673, 4744, 4948, 4970, 5420, 5883, 6229, 6468, 6484, 6619, 6752, 7436, 7477, 7560, 7565, 8161]",[1787],"[337, 580, 806, 919, 1170, 1615, 1951, 2042, 2350, 2419, 2554, 2785, 3292, 3810, 4161, 4673, 4744, 4948, 4970, 5420, 5883, 6229, 6468, 6484, 6619, 6752, 7436, 7477, 7560, 7565, 8161]",[1787],8308,32,8276,1,31,8276,0
3.5,MMNFMG,"[50, 97, 120, 274, 421, 638, 1223, 1553, 1634, 1791, 2336, 2340, 2540, 2878, 3175, 3339, 3597, 3793, 4040, 4409, 4448, 4619, 4753, 4777, 4798, 4804, 4855, 4886, 5044]","[1634, 2540]","[50, 97, 120, 274, 421, 638, 1223, 1553, 1791, 2336, 2340, 2878, 3175, 3339, 3597, 3793, 4040, 4409, 4448, 4619, 4753, 4777, 4798, 4804, 4855, 4886, 5044]","[1634, 2540]",5463,29,5434,2,27,5434,0
3.5,MMNMYC,"[749, 869, 970, 1163, 1210, 1355, 1609, 1732, 1921, 2053, 3124, 3257, 3278, 3549, 3611, 3661, 3902, 4261]",[1163],"[749, 869, 970, 1210, 1355, 1609, 1732, 1921, 2053, 3124, 3257, 3278, 3549, 3611, 3661, 3902, 4261]",[1163],4799,18,4781,1,17,4781,0
3.5,MMNUCLEO,"[540, 622, 665, 784, 863, 1033, 1160, 1932, 2027, 2042, 2423, 2563, 2680, 2859, 3040, 3141, 3456, 3984, 4071, 4293, 4464, 4694, 4879, 5198, 5351, 5605, 5879, 6230, 6399, 6530, 6879, 7043, 7203, 7215, 7250, 7705, 8122, 8304, 8349, 8614, 8794, 8928, 9050, 9387, 9572, 9781, 9881, 10179, 10325, 10436, 10506, 10946, 11016, 11089]","[2042, 3141, 4293, 4694, 4879, 5198, 6230, 8122, 9050, 9881, 10436]","[540, 622, 665, 784, 863, 1033, 1160, 1932, 2027, 2423, 2563, 2680, 2859, 3040, 3456, 3984, 4071, 4464, 5351, 5605, 5879, 6399, 6530, 6879, 7043, 7203, 7215, 7250, 7705, 8304, 8349, 8614, 8794, 8928, 9387, 9572, 9781, 10179, 10325, 10506, 10946, 11016, 11089]","[2042, 3141, 4293, 4694, 4879, 5198, 6230, 7517, 8122, 8738, 9050, 9881, 10436]",11470,54,11416,11,43,11414,2
3.5,MMODC2,"[124, 331, 737, 944, 966, 1053, 1182, 1374, 1557, 1801, 1892, 2508, 2523, 2702, 2728, 2886, 2999, 3003, 3130, 3416, 3433, 4219]","[331, 737, 1053, 1374, 1557, 1801, 2508, 2702, 2999]","[124, 944, 966, 1182, 1892, 2523, 2728, 2886, 3003, 3130, 3416, 3433, 4219]","[331, 737, 1053, 1374, 1557, 1801, 2508, 2702, 2999]",4252,22,4230,9,13,4230,0
3.5,MMOESTEOP,"[510, 993, 1091, 1127, 1662, 1666, 1800, 2283, 2605, 2609, 2742, 2821, 4039, 4101, 4452, 4834, 5104, 5308, 5456, 5607]","[993, 1127, 2283, 2821, 4101]","[510, 1091, 1662, 1666, 1800, 2605, 2609, 2742, 4039, 4452, 4834, 5104, 5308, 5456, 5607]","[993, 1127, 2283, 2821, 4101]",5774,20,5754,5,15,5754,0
3.5,MMPO,"[324, 475, 561, 825, 857, 1686, 1709, 1800, 1950, 2193, 2446, 2553, 2860, 2948, 3054, 3336, 3503, 3719, 3728, 3749, 4385, 4769, 4831, 5261, 5312, 5641, 5673, 6010, 6250, 6384, 6555, 6637, 6805, 6833, 6901, 6982, 7167, 7842, 8043, 8109, 8440, 8907, 9079, 9156, 9240, 9244, 9454, 9464, 9476, 9716, 9809, 9903, 9938, 10001, 10055, 10756, 10894, 10983, 11076, 11636, 11901]","[2193, 2446, 2948, 3503, 3728, 4769, 7167, 8440, 8907, 9903]","[324, 475, 561, 825, 857, 1686, 1709, 1800, 1950, 2553, 2860, 3054, 3336, 3719, 3749, 4385, 4831, 5261, 5312, 5641, 5673, 6010, 6250, 6384, 6555, 6637, 6805, 6833, 6901, 6982, 7842, 8043, 8109, 9079, 9156, 9240, 9244, 9454, 9464, 9476, 9716, 9809, 9938, 10001, 10055, 10756, 10894, 10983, 11076, 11636, 11901]","[2193, 2446, 2948, 3503, 3728, 4018, 4769, 7167, 8440, 8907, 9903]",11905,61,11844,10,51,11843,1
3.5,MMPPSOMA,"[124, 251, 411, 447, 562, 608, 706, 722, 1034, 1208, 1248, 2049, 2196, 2491]",[1034],"[124, 251, 411, 447, 562, 608, 706, 722, 1208, 1248, 2049, 2196, 2491]",[1034],2556,14,2542,1,13,2542,0
3.5,MMPROP2,"[78, 631]",[],"[78, 631]",[289],712,2,710,0,2,709,1
3.5,MMPROT1,"[312, 452, 478, 590, 759, 937]",[759],"[312, 452, 478, 590, 937]",[759],1178,6,1172,1,5,1172,0
3.5,MMPROT2,"[311, 361, 508, 615, 880, 915, 987, 1128, 1218, 1357, 1469]",[1218],"[311, 361, 508, 615, 880, 915, 987, 1128, 1357, 1469]",[1218],1568,11,1557,1,10,1557,0
3.5,MMSAP,"[441, 794, 1550, 1558]",[441],"[794, 1550, 1558]",[441],1868,4,1864,1,3,1864,0
3.5,MMSCIMIP,"[415, 600, 1017, 1054, 1066, 1153, 1946]","[415, 1017]","[600, 1054, 1066, 1153, 1946]","[415, 1017]",1980,7,1973,2,5,1973,0
3.5,MMSYNDE1A,"[190, 526, 762, 816, 1054, 1345, 1483, 1992, 2151, 2198, 2272, 2289, 2623, 3132, 3556, 3570, 3706, 3831, 4124, 4826, 4867, 5018, 5043, 5366, 5420, 5616, 5772, 5923, 6256, 6275, 6622, 6741, 6996, 7075, 7622, 7683, 7733, 7805, 7828, 7914, 7931, 8043, 8056, 8412, 8442, 8765, 9076, 9182, 9320, 9867, 10045, 10122, 10340, 10903, 11099, 11249, 11397, 11495, 11583, 11823, 11858, 11900, 11920, 11930, 12132, 12515, 12803, 13095, 13198, 13426, 13599, 13646, 13723, 13761, 13851, 14080, 14113, 14182, 14254, 14623, 14634, 14812, 14843, 14948, 15172, 15203, 15299, 15641, 15674, 15696, 15704, 15845, 15929, 15955, 16427, 16639, 16744, 16770, 17281, 17647, 17663, 17701, 17717, 18655, 18754, 18837, 19009, 19057, 19286, 19424, 19440, 19542, 19726, 19767, 19903, 20385, 20460, 20515, 20604, 20657, 20735, 20900, 20942, 20958, 21888, 22028, 22081, 22120, 22488, 22707, 22802, 23203]","[1345, 19009, 20385, 20942]","[190, 526, 762, 816, 1054, 1483, 1992, 2151, 2198, 2272, 2289, 2623, 3132, 3556, 3570, 3706, 3831, 4124, 4826, 4867, 5018, 5043, 5366, 5420, 5616, 5772, 5923, 6256, 6275, 6622, 6741, 6996, 7075, 7622, 7683, 7733, 7805, 7828, 7914, 7931, 8043, 8056, 8412, 8442, 8765, 9076, 9182, 9320, 9867, 10045, 10122, 10340, 10903, 11099, 11249, 11397, 11495, 11583, 11823, 11858, 11900, 11920, 11930, 12132, 12515, 12803, 13095, 13198, 13426, 13599, 13646, 13723, 13761, 13851, 14080, 14113, 14182, 14254, 14623, 14634, 14812, 14843, 14948, 15172, 15203, 15299, 15641, 15674, 15696, 15704, 15845, 15929, 15955, 16427, 16639, 16744, 16770, 17281, 17647, 17663, 17701, 17717, 18655, 18754, 18837, 19057, 19286, 19424, 19440, 19542, 19726, 19767, 19903, 20460, 20515, 20604, 20657, 20735, 20900, 20958, 21888, 22028, 22081, 22120, 22488, 22707, 22802, 23203]","[1345, 19009, 20385, 20942]",23592,132,23460,4,128,23460,0
3.5,MMTHY1G,"[80, 183, 616, 696, 854, 1009, 1156, 1586, 1833, 1837, 1943, 2181]","[80, 1009]","[183, 616, 696, 854, 1156, 1586, 1833, 1837, 1943, 2181]","[80, 1009]",2682,12,2670,2,10,2670,0
3.5,MMTLAC,"[140, 299, 494, 748, 912, 925, 1171, 1335, 2743, 2858, 3092, 3338, 3467, 3509, 3836, 4297, 4373, 4591, 4774, 4783, 4830, 5339]","[299, 748, 1171, 3092, 3338]","[140, 494, 912, 925, 1335, 2743, 2858, 3467, 3509, 3836, 4297, 4373, 4591, 4774, 4783, 4830, 5339]","[299, 748, 1171, 3092, 3338]",5239,22,5217,5,17,5217,0
3.5,MMTNFBG,"[315, 524, 734, 813, 1196, 1553, 1558, 1728, 2415, 2456]",[1728],"[315, 524, 734, 813, 1196, 1553, 1558, 2415, 2456]","[1728, 1911]",3211,10,3201,1,9,3200,1
3.5,MMTROPIB,"[183, 656, 1261, 1307, 1568, 1697, 1744, 1749, 1832, 1932, 1939, 2033, 2038, 2185, 2274, 2327, 2522, 2534, 2656, 2761, 3037, 3564, 3690, 4493, 4580, 4604, 4620, 4748, 4865, 4950, 5379, 5561]","[1697, 1932, 2185, 2656, 3037, 3564, 4604]","[183, 656, 1261, 1307, 1568, 1744, 1749, 1832, 1939, 2033, 2038, 2274, 2327, 2522, 2534, 2761, 3690, 4493, 4580, 4620, 4748, 4865, 4950, 5379, 5561]","[1697, 1932, 2185, 2656, 3037, 3564, 4604]",5683,32,5651,7,25,5651,0
3.5,MMTUM198,"[70, 120, 347, 709, 1084, 1729, 1750, 1849, 2808, 2818, 2899, 3098, 3313, 3338, 3587, 3818, 3836, 4180, 4220]","[2818, 3098, 3313, 3587, 3818, 4180]","[70, 120, 347, 709, 1084, 1729, 1750, 1849, 2808, 2899, 3338, 3836, 4220]","[1692, 2818, 3098, 3313, 3587, 3818, 4180]",4376,19,4357,6,13,4356,1
3.5,MMU01530,"[76, 358, 636, 891, 924, 1080, 1164, 1180, 1357, 1458, 1576, 1589, 2027, 2244, 2269, 2298, 2581, 3094, 3188, 3231, 3536, 3729, 3803, 4412, 4904, 5260, 5405, 5602, 5885, 6039, 6229, 6394, 6423, 6546, 6611]","[3094, 3231]","[76, 358, 636, 891, 924, 1080, 1164, 1180, 1357, 1458, 1576, 1589, 2027, 2244, 2269, 2298, 2581, 3188, 3536, 3729, 3803, 4412, 4904, 5260, 5405, 5602, 5885, 6039, 6229, 6394, 6423, 6546, 6611]","[3094, 3231]",6694,35,6659,2,33,6659,0
3.5,MMU02278,"[75, 342, 888, 1041, 1135, 1638, 1858, 2159, 2312, 2344, 3368, 3433, 3669, 3873, 3967]",[1638],"[75, 342, 888, 1041, 1135, 1858, 2159, 2312, 2344, 3368, 3433, 3669, 3873, 3967]",[1638],3973,15,3958,1,14,3958,0
3.5,MMU02298,"[475, 603, 1099, 1180, 1508, 1639, 2102, 2413, 2874, 3047, 3116, 3911, 3920, 4270, 4343, 4351, 4749, 4794, 4897, 5502]","[1180, 2413]","[475, 603, 1099, 1508, 1639, 2102, 2874, 3047, 3116, 3911, 3920, 4270, 4343, 4351, 4749, 4794, 4897, 5502]","[1180, 2413]",5851,20,5831,2,18,5831,0
3.5,MMU02884,"[214, 220, 512, 668, 711, 814, 875, 1025, 1576, 1630, 1761, 2107, 2340, 2382, 2441, 2484, 2785, 3386, 3665, 3669, 3865, 4056, 4706, 4798, 5217, 5244, 5291, 5517, 5806, 6022, 6642, 6740, 6836, 7219, 7309, 7527, 7562, 7567, 7708, 7866, 7973, 8590, 8612]","[1630, 5244, 6836]","[214, 220, 512, 668, 711, 814, 875, 1025, 1576, 1761, 2107, 2340, 2382, 2441, 2484, 2785, 3386, 3665, 3669, 3865, 4056, 4706, 4798, 5217, 5291, 5517, 5806, 6022, 6642, 6740, 7219, 7309, 7527, 7562, 7567, 7708, 7866, 7973, 8590, 8612]","[1630, 5244, 6836]",8757,43,8714,3,40,8714,0
3.5,MMU04056,"[186, 231, 265, 321, 901, 1227, 1326, 1331, 1382, 1450, 1461, 1472, 1502, 1857, 1865, 2046, 2135, 2183, 2377, 2490, 2509, 2667, 2711, 2747, 2902, 2960, 3291, 3530, 4688, 5218, 5459, 5594, 6264, 6477, 7111, 7683, 7710, 7979, 8501, 8633, 8664, 8680, 8732, 8895, 9807, 10200, 10317, 10794, 10876, 10998, 11259, 11441, 11578, 11797, 12088, 12211, 13211, 13933, 14104, 14226, 14478, 14615, 14896, 15214, 15270, 15365, 15417, 15506, 15545, 15620, 15870, 15971, 16157, 16230, 16348, 16561, 16710, 16734, 16843, 16994, 17245, 17992, 18100, 19830, 19860, 20025, 20066, 20243, 20314, 20602, 20633, 20804, 21185, 21351, 21514, 21625, 21633]","[1382, 3530, 4688, 7979, 8895, 10317, 10876, 11259, 12211, 16230, 16561]","[186, 231, 265, 321, 901, 1227, 1326, 1331, 1450, 1461, 1472, 1502, 1857, 1865, 2046, 2135, 2183, 2377, 2490, 2509, 2667, 2711, 2747, 2902, 2960, 3291, 5218, 5459, 5594, 6264, 6477, 7111, 7683, 7710, 8501, 8633, 8664, 8680, 8732, 9807, 10200, 10794, 10998, 11441, 11578, 11797, 12088, 13211, 13933, 14104, 14226, 14478, 14615, 14896, 15214, 15270, 15365, 15417, 15506, 15545, 15620, 15870, 15971, 16157, 16348, 16710, 16734, 16843, 16994, 17245, 17992, 18100, 19830, 19860, 20025, 20066, 20243, 20314, 20602, 20633, 20804, 21185, 21351, 21514, 21625, 21633]","[1382, 3530, 4688, 7979, 8895, 10317, 10876, 11259, 12211, 13491, 16230, 16561]",21710,97,21613,11,86,21612,1
3.5,MMU04827,"[105, 1299, 1649, 2179, 2246, 2280, 2512, 2767, 2828, 3551, 3555, 3684, 4276, 4281, 4301, 4969, 5174, 5286, 5444, 5675, 5771, 6145, 7133, 7252, 7369, 7592]","[3684, 4281, 4969]","[105, 1299, 1649, 2179, 2246, 2280, 2512, 2767, 2828, 3551, 3555, 4276, 4301, 5174, 5286, 5444, 5675, 5771, 6145, 7133, 7252, 7369, 7592]","[3684, 4281, 4969]",7600,26,7574,3,23,7574,0
3.5,MMU07568,"[84, 253, 267, 482, 527]","[84, 267, 482]","[253, 527]","[84, 267, 482]",743,5,738,3,2,738,0
3.5,MMU07808,"[61, 183, 404, 542, 547, 664, 673, 987, 1019, 1087, 1179, 1208, 1697, 1762, 1918, 2384]","[673, 1697]","[61, 183, 404, 542, 547, 664, 987, 1019, 1087, 1179, 1208, 1762, 1918, 2384]","[673, 1697]",2840,16,2824,2,14,2824,0
3.5,MMU09741,"[245, 1076, 1094, 1230, 1293, 1655, 1679, 2034, 2675]","[245, 1230]","[1076, 1094, 1293, 1655, 1679, 2034, 2675]","[245, 1230]",2844,9,2835,2,7,2835,0
3.5,MMU09964,"[26, 45, 49, 157, 321, 375, 510, 803, 857, 917, 1295, 1299, 1305, 1968, 2317, 2375, 2490, 2671, 2680, 2697, 2970, 3428, 3432, 3448, 3779, 3796, 3933, 4126, 4303, 4607, 4788, 5091, 5667, 5726, 5730, 5747, 5754, 5793, 5816, 5820, 5824, 5828, 5832, 5836, 5840, 5844, 5977, 6240, 6447, 6524, 6741, 6890, 7044, 7423, 7434, 7525, 7667, 7760, 7962, 8162, 8192, 8455, 8460, 8601, 9017, 9311, 9898, 9952, 9980, 10001, 10363, 10372, 10378, 10429, 10875, 10991, 11050, 11127, 11186, 11246]","[1968, 3428, 4303, 4607, 7962, 8162, 8601, 9017, 9311, 10875]","[26, 45, 49, 157, 321, 375, 510, 803, 857, 917, 1295, 1299, 1305, 2317, 2375, 2490, 2671, 2680, 2697, 2970, 3432, 3448, 3779, 3796, 3933, 4126, 4788, 5091, 5667, 5726, 5730, 5747, 5754, 5793, 5816, 5820, 5824, 5828, 5832, 5836, 5840, 5844, 5977, 6240, 6447, 6524, 6741, 6890, 7044, 7423, 7434, 7525, 7667, 7760, 8192, 8455, 8460, 9898, 9952, 9980, 10001, 10363, 10372, 10378, 10429, 10991, 11050, 11127, 11186, 11246]","[1968, 3428, 4303, 4607, 7962, 8162, 8601, 9017, 9311, 10875]",11454,80,11374,10,70,11374,0
3.5,MMU10098,"[593, 695, 1098, 1155, 1165, 1173, 1383, 1425, 1436, 1624, 2158, 3145, 3270, 3509, 3596, 5292, 5565, 5593, 5609, 5695, 5812]","[1173, 3509]","[593, 695, 1098, 1155, 1165, 1383, 1425, 1436, 1624, 2158, 3145, 3270, 3596, 5292, 5565, 5593, 5609, 5695, 5812]","[1173, 3509]",6117,21,6096,2,19,6096,0
3.5,MMU11054,"[23, 185, 204, 383, 1996, 2037, 2250, 2515]",[1996],"[23, 185, 204, 383, 2037, 2250, 2515]","[457, 1418, 1996]",2564,8,2556,1,7,2554,2
3.5,MMU11713,"[250, 288, 520, 587, 634, 1270, 1365]","[288, 634]","[250, 520, 587, 1270, 1365]","[288, 634]",1759,7,1752,2,5,1752,0
3.5,MMU12029,"[17, 51, 297, 342, 381, 582, 879, 1264, 1309, 1385, 1410, 1741, 1897, 2030, 2036, 2082]","[582, 1264]","[17, 51, 297, 342, 381, 879, 1309, 1385, 1410, 1741, 1897, 2030, 2036, 2082]","[582, 1264]",2255,16,2239,2,14,2239,0
3.5,MMU12273,"[38, 358, 384, 389, 680, 769, 915, 1085, 1434, 1550, 1740, 1940]","[680, 1085, 1740]","[38, 358, 384, 389, 769, 915, 1434, 1550, 1940]","[680, 1085, 1740]",2575,12,2563,3,9,2563,0
3.5,MMU12559,"[62, 247, 822]",[247],"[62, 822]",[247],918,3,915,1,2,915,0
3.5,MMU12560,"[62, 247, 257]",[247],"[62, 257]",[247],920,3,917,1,2,917,0
3.5,MMU12561,"[62, 247, 384, 420, 820]",[247],"[62, 384, 420, 820]",[247],916,5,911,1,4,911,0
3.5,MMU12562,"[62, 247]",[247],[62],[247],918,2,916,1,1,916,0
3.5,MMU12565,"[62, 247, 396, 630]",[247],"[62, 396, 630]",[247],1043,4,1039,1,3,1039,0
3.5,MMU13921,"[10, 162, 289, 329, 820, 856, 952, 1034, 1402, 1607, 1862, 1867, 2003, 2197, 2354, 2693, 2930, 3036, 3132, 3401, 3525, 3794, 3990, 4034, 4226]","[952, 2003, 2354, 2693, 2930, 3990]","[10, 162, 289, 329, 820, 856, 1034, 1402, 1607, 1862, 1867, 2197, 3036, 3132, 3401, 3525, 3794, 4034, 4226]","[952, 2003, 2354, 2693, 2930, 3241, 3990]",4670,25,4645,6,19,4644,1
3.5,MMU14421,"[255, 511, 1089, 1183, 1322, 1867, 1887, 2041, 2454, 3681, 3799, 3848, 3861, 3867, 3920, 4195, 4470, 4528, 4560, 4613, 4941, 5034, 5599, 5864]",[],"[255, 511, 1089, 1183, 1322, 1867, 1887, 2041, 2454, 3681, 3799, 3848, 3861, 3867, 3920, 4195, 4470, 4528, 4560, 4613, 4941, 5034, 5599, 5864]","[3668, 4237, 4502, 4814]",6254,24,6230,0,24,6226,4
3.5,MMVITRO,"[8, 14, 689, 725, 788, 1025, 1425, 1845, 1861, 1883, 1892, 2054, 2071, 2219, 2249, 2474, 2585, 2693, 2718, 2783, 2826, 3279, 3703, 3733, 3755, 3812, 3820, 3855, 3863, 4355, 4941, 4985, 4996]","[1845, 2054, 2474, 2693, 3279, 4355]","[8, 14, 689, 725, 788, 1025, 1425, 1861, 1883, 1892, 2071, 2219, 2249, 2585, 2718, 2783, 2826, 3703, 3733, 3755, 3812, 3820, 3855, 3863, 4941, 4985, 4996]","[1845, 2054, 2474, 2693, 3017, 3279, 4355]",4996,33,4963,6,27,4962,1
3.5,MMVPREB2,"[104, 172, 214, 379, 908, 930]",[379],"[104, 172, 214, 908, 930]",[379],1045,6,1039,1,5,1039,0
3.5,MMVPREB3,"[104, 172, 214, 379, 908]",[379],"[104, 172, 214, 908]",[379],1045,5,1040,1,4,1040,0
3.5,MNKEGLOBIM,"[221, 237, 469, 583, 599, 1060, 1184, 1196, 1264]","[237, 583]","[221, 469, 599, 1060, 1184, 1196, 1264]","[237, 583]",1693,9,1684,2,7,1684,0
3.5,MNKEGLOBIN,"[221, 237, 469, 583, 599, 1058, 1182, 1194, 1262]","[237, 583]","[221, 469, 599, 1058, 1182, 1194, 1262]","[237, 583]",1691,9,1682,2,7,1682,0
3.5,MNKHGBGGAG,"[75, 92, 249, 287, 519, 586, 633, 879, 1064, 1282, 1338]","[287, 633]","[75, 92, 249, 519, 586, 879, 1064, 1282, 1338]","[287, 633]",1697,11,1686,2,9,1686,0
3.5,MNPROP2,"[64, 620]",[],"[64, 620]",[278],696,2,694,0,2,693,1
3.5,MUS8HS20,"[257, 271, 280, 329, 503, 545, 617, 638, 940, 962, 1015, 1360, 1625, 2133, 2530, 2562]",[940],"[257, 271, 280, 329, 503, 545, 617, 638, 962, 1015, 1360, 1625, 2133, 2530, 2562]",[940],2622,16,2606,1,15,2606,0
3.5,MUSAP,"[110, 443, 499, 810, 814, 931, 1012, 1076, 2291, 2551, 2617, 2656, 2686, 2774, 2868, 3186, 3264, 3438, 3574, 3815, 3950, 4034, 4160, 4509, 4539, 4740, 4927, 4971, 5211, 5230, 5290, 5369, 5529, 5547, 5619, 5952, 6013, 6067, 6406, 6494, 6554, 6709, 6929, 7201, 7229, 7890, 8019]","[3574, 3815, 4034, 4509, 4740, 4971, 5290, 5619, 5952, 6406, 6709]","[110, 443, 499, 810, 814, 931, 1012, 1076, 2291, 2551, 2617, 2656, 2686, 2774, 2868, 3186, 3264, 3438, 3950, 4160, 4539, 4927, 5211, 5230, 5369, 5529, 5547, 6013, 6067, 6494, 6554, 6929, 7201, 7229, 7890, 8019]","[3574, 3815, 4034, 4509, 4740, 4971, 5290, 5619, 5952, 6406, 6709]",8086,47,8039,11,36,8039,0
3.5,MUSAP5A,"[259, 354, 551, 651, 697, 786, 853, 920, 1315, 1768, 1853, 1889, 2064, 2222, 2428, 2454, 2463, 2681, 2759, 3332, 3355, 3527, 3744, 3752, 3852, 4614, 4657, 4709, 5253, 5266, 5825, 6195, 6254, 6685, 6816]","[2428, 2759, 4614]","[259, 354, 551, 651, 697, 786, 853, 920, 1315, 1768, 1853, 1889, 2064, 2222, 2454, 2463, 2681, 3332, 3355, 3527, 3744, 3752, 3852, 4657, 4709, 5253, 5266, 5825, 6195, 6254, 6685, 6816]","[2428, 2759, 4614]",6821,35,6786,3,32,6786,0
3.5,MUSAPEX,"[300, 372, 412, 768, 1042, 1363, 1389, 1394, 1684, 1773, 1919, 2089, 2436, 2552, 2742, 2942, 3882]","[1684, 2089, 2742]","[300, 372, 412, 768, 1042, 1363, 1389, 1394, 1773, 1919, 2436, 2552, 2942, 3882]","[1684, 2089, 2742]",4034,17,4017,3,14,4017,0
3.5,MUSAPOAII,"[112, 474, 559, 723, 760, 940, 1155, 1543, 1887, 2361, 2621]","[723, 1155]","[112, 474, 559, 760, 940, 1543, 1887, 2361, 2621]","[723, 1155]",2952,11,2941,2,9,2941,0
3.5,MUSAPOIVA,"[63, 470, 529, 588, 975, 1029, 1226, 1256, 1385, 1415, 1676, 1759, 2149, 2299, 2365, 2629, 2774, 2898, 2914, 2929]","[588, 975]","[63, 470, 529, 1029, 1226, 1256, 1385, 1415, 1676, 1759, 2149, 2299, 2365, 2629, 2774, 2898, 2914, 2929]","[588, 975]",3012,20,2992,2,18,2992,0
3.5,MUSBMP4,"[221, 336, 441, 510, 664, 768, 1064, 1068, 1080, 1847, 2095, 2149, 2413, 2473, 2683, 2820, 2888, 2960, 3208, 3697, 3806, 3967, 4135, 4471, 4495, 4594, 4806, 5132, 5289, 5497, 5725, 5890, 5988, 6380, 6626, 7157, 7179, 7951, 8211, 8267, 8446, 8462, 8525, 9626]",[7179],"[221, 336, 441, 510, 664, 768, 1064, 1068, 1080, 1847, 2095, 2149, 2413, 2473, 2683, 2820, 2888, 2960, 3208, 3697, 3806, 3967, 4135, 4471, 4495, 4594, 4806, 5132, 5289, 5497, 5725, 5890, 5988, 6380, 6626, 7157, 7951, 8211, 8267, 8446, 8462, 8525, 9626]",[7179],9660,44,9616,1,43,9616,0
3.5,MUSBNP,"[225, 336, 412, 488, 680, 753, 903, 1057, 1449]","[336, 753]","[225, 412, 488, 680, 903, 1057, 1449]","[336, 753]",1460,9,1451,2,7,1451,0
3.5,MUSCD14A,"[176, 543, 639, 777, 1122, 1454]",[176],"[543, 639, 777, 1122, 1454]",[176],1865,6,1859,1,5,1859,0
3.5,MUSCRKNB,"[96, 460, 815, 917, 1440, 1807, 1904, 1989, 2058, 2245, 2455, 2466, 2658, 2796, 2829, 2879, 3056, 3505, 3842, 3862, 3876, 3949]","[1904, 2245, 2455, 2796, 3505, 3842]","[96, 460, 815, 917, 1440, 1807, 1989, 2058, 2466, 2658, 2829, 2879, 3056, 3862, 3876, 3949]","[1904, 2245, 2455, 2796, 3505, 3842]",4513,22,4491,6,16,4491,0
3.5,MUSCYTCOVB,"[48, 724, 928, 935, 1064, 1081, 1319, 1585, 1679, 1808, 1925, 1946, 2066, 2168, 2234]","[724, 1319, 1585]","[48, 928, 935, 1064, 1081, 1679, 1808, 1925, 1946, 2066, 2168, 2234]","[724, 1319, 1585]",2532,15,2517,3,12,2517,0
3.5,MUSENDOBA,"[59, 135, 382, 807, 1066, 1276, 1500, 1507, 1701, 2117, 2130, 2462, 2614, 2743, 3027, 3115, 3350, 3618, 3707, 3816, 3892, 4049, 4342, 4346, 4371, 4430, 4853, 4898, 5090, 5527, 5589, 5616, 5660, 5696, 5700, 5721, 5817, 5969, 6258, 6301, 6358, 6506, 6929, 6980, 7007, 7151, 7548, 7585]","[2743, 3618, 4049, 4853, 5090, 5589]","[59, 135, 382, 807, 1066, 1276, 1500, 1507, 1701, 2117, 2130, 2462, 2614, 3027, 3115, 3350, 3707, 3816, 3892, 4342, 4346, 4371, 4430, 4898, 5527, 5616, 5660, 5696, 5700, 5721, 5817, 5969, 6258, 6301, 6358, 6506, 6929, 6980, 7007, 7151, 7548, 7585]","[2743, 3618, 4049, 4853, 5090, 5589]",7871,48,7823,6,42,7823,0
3.5,MUSFAUA,"[506, 544, 760, 783, 846, 925, 988, 1216, 1249, 1496, 1535, 1645, 2068, 2103, 2110, 2124, 2220, 2650]","[1249, 1496, 2124]","[506, 544, 760, 783, 846, 925, 988, 1216, 1535, 1645, 2068, 2103, 2110, 2220, 2650]","[1249, 1496, 2124]",2842,18,2824,3,15,2824,0
3.5,MUSFERHC,"[483, 526, 1103, 1827, 1944, 2000, 2185, 2319, 2428]","[483, 1827, 2185]","[526, 1103, 1944, 2000, 2319, 2428]","[483, 1827, 2185]",2782,9,2773,3,6,2773,0
3.5,MUSFKBP13X,"[321, 736, 764, 904, 928, 1247, 1282, 1358, 1556]","[321, 736, 904, 1282]","[764, 928, 1247, 1358, 1556]","[321, 736, 904, 1282]",1573,9,1564,4,5,1564,0
3.5,MUSGAD45,"[559, 935, 1034, 1126, 1187, 1309, 1452, 1458, 1542, 1595, 1898, 2472, 2647, 3023]","[935, 1126, 1458]","[559, 1034, 1187, 1309, 1452, 1542, 1595, 1898, 2472, 2647, 3023]","[935, 1126, 1458]",3092,14,3078,3,11,3078,0
3.5,MUSGFJE,"[624, 709, 1098, 1194, 1323, 1489, 1839, 2167, 2275]","[624, 1489]","[709, 1098, 1194, 1323, 1839, 2167, 2275]","[624, 1489]",2403,9,2394,2,7,2394,0
3.5,MUSGPOAD,"[430, 890, 1044, 1048, 1169, 1324, 1328, 1737, 2306, 2538, 2898, 3046, 3337, 4023, 4403, 4816, 4916, 5083, 5250, 5328, 5342, 5400, 5647, 5859, 6515, 6573, 7850, 7929]","[1044, 2306, 4403, 4916]","[430, 890, 1048, 1169, 1324, 1328, 1737, 2538, 2898, 3046, 3337, 4023, 4816, 5083, 5250, 5328, 5342, 5400, 5647, 5859, 6515, 6573, 7850, 7929]","[1044, 2306, 4403, 4916]",8068,28,8040,4,24,8040,0
3.5,MUSHBBH0,"[163, 184, 365, 651, 914, 1012, 1112, 1265, 1566, 2081]","[365, 914]","[163, 184, 651, 1012, 1112, 1265, 1566, 2081]","[365, 914]",2127,10,2117,2,8,2117,0
3.5,MUSHBBH1,"[97, 249, 270, 451, 733, 780, 975, 1417, 1493]","[451, 780]","[97, 249, 270, 733, 975, 1417, 1493]","[451, 780]",1918,9,1909,2,7,1909,0
3.5,MUSHES1,"[355, 556, 784, 1108, 1121, 1159, 1351, 1367, 1400, 1488, 1698, 1797, 1819, 1839, 2208]","[556, 784, 1108]","[355, 1121, 1159, 1351, 1367, 1400, 1488, 1698, 1797, 1819, 1839, 2208]","[556, 784, 1108]",2817,15,2802,3,12,2802,0
3.5,MUSHOX35A,"[232, 597, 612, 1308, 1715, 2007, 2012, 2512, 2577, 2661, 2850, 3119, 3150, 3209, 3519, 3545]",[1308],"[232, 597, 612, 1715, 2007, 2012, 2512, 2577, 2661, 2850, 3119, 3150, 3209, 3519, 3545]",[1308],3847,16,3831,1,15,3831,0
3.5,MUSIL1RN,"[168, 512, 886, 1676, 1736, 1922, 2186, 2224, 2289, 2483, 2552, 2789, 3076, 3116, 3549, 3883, 3938, 4482, 4744, 5269, 5875, 6210]","[512, 2483, 3549]","[168, 886, 1676, 1736, 1922, 2186, 2224, 2289, 2552, 2789, 3076, 3116, 3883, 3938, 4482, 4744, 5269, 5875, 6210]","[512, 2483, 3549]",6342,22,6320,3,19,6320,0
3.5,MUSKE3A,"[21, 340, 349, 544, 657, 788, 840, 981, 1088, 1328, 1410, 1545, 1562, 1569, 1604, 1620, 1645, 1881, 1948, 2052, 2194, 2659, 2794, 3218, 3339, 3400, 3405, 3515]","[21, 544, 3218, 3400]","[340, 349, 657, 788, 840, 981, 1088, 1328, 1410, 1545, 1562, 1569, 1604, 1620, 1645, 1881, 1948, 2052, 2194, 2659, 2794, 3339, 3405, 3515]","[21, 544, 3218, 3400]",3612,28,3584,4,24,3584,0
3.5,MUSLMP7A,"[287, 429, 487, 535, 1318, 1354, 1364, 1407, 1876, 2153, 2157, 2293, 2454, 3029, 3046, 3178, 3674, 4005]","[1318, 2153, 2454, 3029, 3674]","[287, 429, 487, 535, 1354, 1364, 1407, 1876, 2157, 2293, 3046, 3178, 4005]","[1318, 2153, 2454, 3029, 3674]",4259,18,4241,5,13,4241,0
3.5,MUSLTA,"[530, 830, 1207, 1632, 1637, 1807, 2496, 2537]",[1807],"[530, 830, 1207, 1632, 1637, 2496, 2537]","[1807, 1990]",3286,8,3278,1,7,3277,1
3.5,MUSMC26,"[155, 687, 816, 843, 1581, 1906, 2071, 2419, 2475, 3046, 3075, 3190, 3415, 3666, 3682, 3716, 3964, 3982, 4144, 4182, 4669]","[2419, 3190, 4144]","[155, 687, 816, 843, 1581, 1906, 2071, 2475, 3046, 3075, 3415, 3666, 3682, 3716, 3964, 3982, 4182, 4669]","[2419, 3190, 4144]",5386,21,5365,3,18,5365,0
3.5,MUSOGC,"[113, 290, 489, 522, 631, 742, 814, 920]","[113, 290, 489]","[522, 631, 742, 814, 920]","[113, 290, 489]",941,8,933,3,5,933,0
3.5,MUSOGCA,"[214, 285, 356, 866, 1043, 1242, 1275, 1567, 1673]","[866, 1043, 1242]","[214, 285, 356, 1275, 1567, 1673]","[866, 1043, 1242]",1694,9,1685,3,6,1685,0
3.5,MUSOGCB,"[113, 290, 490, 632, 743, 815, 921]","[113, 290, 490]","[632, 743, 815, 921]","[113, 290, 490]",942,7,935,3,4,935,0
3.5,MUSPNMT,"[276, 547, 694, 955, 1076, 1523, 1665, 1713, 1881, 2135, 2343, 2450, 2491, 2599, 2755, 2890]","[1665, 2343]","[276, 547, 694, 955, 1076, 1523, 1713, 1881, 2135, 2450, 2491, 2599, 2755, 2890]","[1665, 2343]",3136,16,3120,2,14,3120,0
3.5,MUSPROTA,"[421, 585, 660, 1945, 2033, 2069, 2530, 2585, 2604, 3119, 3224, 3555, 3663, 4024, 4600]","[1945, 2585, 3224, 3663]","[421, 585, 660, 2033, 2069, 2530, 2604, 3119, 3555, 4024, 4600]","[1945, 2585, 3224, 3663]",4636,15,4621,4,11,4621,0
3.5,MUSPROTEB,"[337, 496, 594, 634, 647, 749, 765, 803, 993, 1024, 1482, 1645, 1682, 1920, 1988, 2130]","[337, 594, 993, 1988]","[496, 634, 647, 749, 765, 803, 1024, 1482, 1645, 1682, 1920, 2130]","[337, 594, 993, 1988]",2389,16,2373,4,12,2373,0
3.5,MUSPRPC2,"[652, 801, 817, 2455, 2470, 2740, 3019, 3141, 3778, 3833, 4087, 4186, 5493, 6159, 6607, 6793, 6797, 7232]",[801],"[652, 817, 2455, 2470, 2740, 3019, 3141, 3778, 3833, 4087, 4186, 5493, 6159, 6607, 6793, 6797, 7232]",[801],7298,18,7280,1,17,7280,0
3.5,MUSPRPMPB,"[120, 651, 801, 817, 1480, 1839, 2952, 2974]",[801],"[120, 651, 817, 1480, 1839, 2952, 2974]",[801],3566,8,3558,1,7,3558,0
3.5,MUSREGI,"[325, 632, 775, 1159, 1258, 1316, 1799, 1965, 2230, 2234, 2304, 2450, 2993, 3707]","[1159, 1799, 2230, 2993]","[325, 632, 775, 1258, 1316, 1965, 2234, 2304, 2450, 3707]","[1159, 1799, 2230, 2993]",3748,14,3734,4,10,3734,0
3.5,MUSREGII,"[530, 927, 1239, 1491, 1626, 1657, 1988, 2023, 2526, 2543, 2927, 3091, 3233, 3308, 3463]","[927, 1626, 1988, 3091]","[530, 1239, 1491, 1657, 2023, 2526, 2543, 2927, 3233, 3308, 3463]","[927, 1626, 1988, 3091]",3924,15,3909,4,11,3909,0
3.5,MUSROM1X,"[115, 219, 781, 983, 1030, 1146, 1242, 1848, 2038, 2169, 2555, 2616, 2640]","[1242, 1848]","[115, 219, 781, 983, 1030, 1146, 2038, 2169, 2555, 2616, 2640]","[1242, 1848]",2779,13,2766,2,11,2766,0
3.5,MUSRPL30,"[84, 500, 504, 660, 960, 1050, 1331, 1679, 2291, 2459, 2654, 2941, 3124, 3243, 3441]","[660, 1050, 2459]","[84, 500, 504, 960, 1331, 1679, 2291, 2654, 2941, 3124, 3243, 3441]","[660, 1050, 2459]",3468,15,3453,3,12,3453,0
3.5,MUSRPS16,"[17, 475, 636, 714, 758, 1210, 1311, 1491, 1667, 1728, 1868, 2005, 2009, 2038, 2355]","[1868, 2005]","[17, 475, 636, 714, 758, 1210, 1311, 1491, 1667, 1728, 2009, 2038, 2355]","[450, 687, 1868, 2005]",2641,15,2626,2,13,2624,2
3.5,MUSS100B,"[213, 342, 741, 1034, 1423, 1710, 1721, 1778, 2041, 2162, 2692, 2757, 3151, 3508, 3660, 3997, 4387, 4672, 4920, 5082, 5104, 5219, 5329, 5786, 6291, 6425, 6653, 6880, 6965, 7045, 7801, 8033, 8061, 8146, 8612, 8671, 8736]",[4920],"[213, 342, 741, 1034, 1423, 1710, 1721, 1778, 2041, 2162, 2692, 2757, 3151, 3508, 3660, 3997, 4387, 4672, 5082, 5104, 5219, 5329, 5786, 6291, 6425, 6653, 6880, 6965, 7045, 7801, 8033, 8061, 8146, 8612, 8671, 8736]",[4920],8865,37,8828,1,36,8828,0
3.5,MUSSERPROA,"[217, 1034, 1449, 1572, 1831, 2032, 2037, 2092, 2114, 2253, 2341, 2739, 3178, 3345, 3371, 3997]","[1449, 2092, 2739, 3178]","[217, 1034, 1572, 1831, 2032, 2037, 2114, 2253, 2341, 3345, 3371, 3997]","[1449, 2092, 2739, 3178]",4449,16,4433,4,12,4433,0
3.5,MUSSSATGN,"[29, 491, 613, 742, 840, 1162, 1346, 1774, 1825, 2081, 2102, 2165, 2190, 2516, 2905, 2929, 3039, 3233, 3436, 3612, 3706, 3892]","[840, 1162, 1346, 2905, 3039]","[29, 491, 613, 742, 1774, 1825, 2081, 2102, 2165, 2190, 2516, 2929, 3233, 3436, 3612, 3706, 3892]","[840, 1162, 1346, 2905, 3039]",4058,22,4036,5,17,4036,0
3.5,MUSTCP,"[224, 453, 470, 624, 908, 1005, 1329, 1705, 1940, 1993, 2164, 2427, 2463, 2496, 2781, 3172, 3270, 3474, 3576, 3642, 4019, 4278, 4687, 5303, 6098, 6296, 6552, 6567, 7171, 7230, 7255, 7274, 7512, 7562]","[453, 1705, 1993, 3270, 4278, 4687, 6098, 6552, 7230, 7512]","[224, 470, 624, 908, 1005, 1329, 1940, 2164, 2427, 2463, 2496, 2781, 3172, 3474, 3576, 3642, 4019, 5303, 6296, 6567, 7171, 7255, 7274, 7562]","[453, 1705, 1993, 3270, 3746, 4278, 4687, 6098, 6552, 7230, 7512]",9253,34,9219,10,24,9218,1
3.5,MUSTHY1,"[80, 183, 616, 696, 854, 1009, 1156, 1586, 1833, 1837, 1943, 2181]","[80, 1009]","[183, 616, 696, 854, 1156, 1586, 1833, 1837, 1943, 2181]","[80, 1009]",2682,12,2670,2,10,2670,0
3.5,MUSTLAG,"[153, 261, 269, 547, 705, 901, 1155, 1314, 1327, 1573, 1733, 1790, 2128, 2250, 3145, 3260, 3494, 3740, 3869, 4237, 4788, 5009, 5192, 5201]","[705, 1155, 1573, 3494, 3740]","[153, 261, 269, 547, 901, 1314, 1327, 1733, 1790, 2128, 2250, 3145, 3260, 3869, 4237, 4788, 5009, 5192, 5201]","[705, 1155, 1573, 3494, 3740]",5412,24,5388,5,19,5388,0
3.5,MUSTSHBA2,"[69, 388, 464, 629, 830, 1045]",[464],"[69, 388, 629, 830, 1045]",[464],1283,6,1277,1,5,1277,0
3.5,MUSY1GLOB,"[334, 354, 377, 576, 690, 829, 1066, 1224, 1249]","[377, 690]","[334, 354, 576, 829, 1066, 1224, 1249]","[377, 690]",1745,9,1736,2,7,1736,0
3.5,OABBGLOB,"[33, 192, 525, 692, 920, 958, 1174, 1262, 1309, 1987, 2701]","[958, 1309]","[33, 192, 525, 692, 920, 1174, 1262, 1987, 2701]","[958, 1309]",3241,11,3230,2,9,3230,0
3.5,OABCGLOB,"[33, 193, 433, 919, 957, 1011, 1177, 1265, 1312, 1352, 2648]","[957, 1312]","[33, 193, 433, 919, 1011, 1177, 1265, 1352, 2648]","[957, 1312]",3192,11,3181,2,9,3181,0
3.5,OAINIGFII1,"[266, 740, 1022, 1098, 1165, 1588, 1671, 1679, 1752, 2106, 2199]",[740],"[266, 1022, 1098, 1165, 1588, 1671, 1679, 1752, 2106, 2199]",[740],2385,11,2374,1,10,2374,0
3.5,OAINTL3,"[115, 134, 674, 721, 813, 850, 1598, 1909, 2072, 2099, 2704]","[674, 813, 1909, 2072]","[115, 134, 721, 850, 1598, 2099, 2704]","[674, 813, 1909, 2072]",2793,11,2782,4,7,2782,0
3.5,OAKRT213,"[144, 975, 1088, 1215, 1228, 1253, 1294, 1328, 1593, 1714, 1992, 2641, 2852, 3132, 3198, 3241, 3333, 3357, 3938, 4147, 4213, 4642, 4690, 4752, 4813, 5258, 5288, 5377, 5487, 5584, 5671, 5684, 5815, 6077, 6474, 6548, 6914, 7393, 7427, 7455, 7660, 7752, 7896, 7911, 8453, 8502, 8931, 9063, 9083, 9294, 9316, 9454]","[3198, 4147, 4813, 5288, 5684, 6077, 6548, 7393]","[144, 975, 1088, 1215, 1228, 1253, 1294, 1328, 1593, 1714, 1992, 2641, 2852, 3132, 3241, 3333, 3357, 3938, 4213, 4642, 4690, 4752, 5258, 5377, 5487, 5584, 5671, 5815, 6474, 6914, 7427, 7455, 7660, 7752, 7896, 7911, 8453, 8502, 8931, 9063, 9083, 9294, 9316, 9454]","[3198, 4147, 4813, 5288, 5684, 6077, 6548, 7393]",9521,52,9469,8,44,9469,0
3.5,OALGB,"[109, 123, 288, 374, 955, 959, 1216, 1459, 1682, 1742, 2043, 2432, 2438, 2660, 2939, 2994, 3336, 3500, 3557, 3883, 4092, 4204, 4250, 4387, 4656, 4886, 4911, 5008, 5244, 5895, 7320]","[1742, 2660, 3883, 4656]","[109, 123, 288, 374, 955, 959, 1216, 1459, 1682, 2043, 2432, 2438, 2939, 2994, 3336, 3500, 3557, 4092, 4204, 4250, 4387, 4886, 4911, 5008, 5244, 5895, 7320]","[938, 1742, 2660, 3883, 4656]",7371,31,7340,4,27,7339,1
3.5,OAMETIAG,"[9, 205, 438, 701, 953, 1136, 1479, 1674, 2726]","[701, 1479]","[9, 205, 438, 953, 1136, 1674, 2726]","[701, 1479]",2792,9,2783,2,7,2783,0
3.5,OAMTIB,"[338, 444, 1209, 1721, 1922, 2041, 2170, 2554, 2983, 3016, 3175, 3205]",[1721],"[338, 444, 1209, 1922, 2041, 2170, 2554, 2983, 3016, 3175, 3205]","[965, 1721]",3211,12,3199,1,11,3198,1
3.5,OAMTIC,"[65, 162, 381, 621, 707, 1295, 1332]","[621, 1295]","[65, 162, 381, 707, 1332]","[621, 1295]",2375,7,2368,2,5,2368,0
3.5,OAMTII,"[326, 799, 1023, 1312, 1325, 1378, 1976]","[1023, 1378]","[326, 799, 1312, 1325, 1976]","[1023, 1378]",2047,7,2040,2,5,2040,0
3.5,OAPROTP1,[7],[],[7],[212],524,1,523,0,1,522,1
3.5,OATRICH,"[146, 152, 1174, 1183, 1197, 1798, 2328, 3157, 3309, 3909, 4055, 4062, 4101, 4464, 4744, 4772, 4947, 5498, 5721, 5825, 6075, 6612, 6681, 6750, 7050, 7119, 7209, 7368, 7437, 7506, 7575]",[3157],"[146, 152, 1174, 1183, 1197, 1798, 2328, 3309, 3909, 4055, 4062, 4101, 4464, 4744, 4772, 4947, 5498, 5721, 5825, 6075, 6612, 6681, 6750, 7050, 7119, 7209, 7368, 7437, 7506, 7575]",[3157],9336,31,9305,1,30,9305,0
3.5,OCAPOAIG,"[361, 553, 777, 855, 1152, 1159, 1216, 1239, 1248, 1275, 1467, 1798, 1916]","[553, 855]","[361, 777, 1152, 1159, 1216, 1239, 1248, 1275, 1467, 1798, 1916]","[553, 855]",1986,13,1973,2,11,1973,0
3.5,OCTNFBETA,"[68, 202, 245, 390, 577]",[577],"[68, 202, 245, 390]","[577, 766]",1963,5,1958,1,4,1957,1
3.5,OCUTGLOB,"[852, 932, 1576, 1736, 1821, 2050, 2144, 2162, 2281, 2566, 2588, 2680, 2700, 3077, 3172, 3357, 3424, 3496, 3634, 4176, 4265, 4404, 4529, 4651, 4900, 4912, 5062, 5072, 5207, 5317, 5831]","[3357, 5831]","[852, 932, 1576, 1736, 1821, 2050, 2144, 2162, 2281, 2566, 2588, 2680, 2700, 3077, 3172, 3424, 3496, 3634, 4176, 4265, 4404, 4529, 4651, 4900, 4912, 5062, 5072, 5207, 5317]","[3357, 5831]",6560,31,6529,2,29,6529,0
3.5,OOGH,"[127, 200, 333, 768, 849, 914, 946, 1084, 1475, 2002, 2065]","[333, 1084, 1475]","[127, 200, 768, 849, 914, 946, 2002, 2065]","[333, 740, 1084, 1475]",2154,11,2143,3,8,2142,1
3.5,OPOP1,"[33, 249]",[249],[33],[249],616,2,614,1,1,614,0
3.5,ORAPROTP1A,"[59, 163, 276]",[163],"[59, 276]",[163],409,3,406,1,2,406,0
3.5,PAA1GL,"[155, 160, 185, 204, 513, 752]","[204, 513]","[155, 160, 185, 752]","[204, 513]",872,6,866,2,4,866,0
3.5,PAAFPG,"[214, 328]",[214],[328],[214],1087,2,1085,1,1,1085,0
3.5,PAU03674,"[361, 1194, 1566, 1633, 1710, 1853, 2100, 2414, 2493, 3171, 3574, 3773, 4013, 4171, 4611, 4741, 5237]","[3171, 3574, 3773, 4013, 4611]","[361, 1194, 1566, 1633, 1710, 1853, 2100, 2414, 2493, 4171, 4741, 5237]","[3171, 3574, 3773, 4013, 4294, 4611]",5437,17,5420,5,12,5419,1
3.5,PIGAPAI,"[35, 62, 107, 191, 449, 562, 794, 1031, 1051, 1129, 1156, 1819, 1823, 1918, 1930, 2041, 2317, 2367, 2693, 2917, 3022, 3317]","[794, 1129]","[35, 62, 107, 191, 449, 562, 1031, 1051, 1156, 1819, 1823, 1918, 1930, 2041, 2317, 2367, 2693, 2917, 3022, 3317]","[794, 1129]",3325,22,3303,2,20,3303,0
3.5,PIGAPCIII,"[27, 45, 148, 620, 682, 736, 867, 944, 1141, 1432, 1443, 1711, 2031, 2083, 2639]","[1432, 1711]","[27, 45, 148, 620, 682, 736, 867, 944, 1141, 1443, 2031, 2083, 2639]","[1432, 1711]",3268,15,3253,2,13,3253,0
3.5,PIGCNP,"[400, 429, 466, 528, 1150, 1416, 1430, 1622, 1662]",[400],"[429, 466, 528, 1150, 1416, 1430, 1622, 1662]",[400],1886,9,1877,1,8,1877,0
3.5,PIGFSB,"[515, 589, 782, 1042, 1511, 1598, 1801, 1849, 1885]","[515, 1042]","[589, 782, 1511, 1598, 1801, 1849, 1885]","[515, 1042]",2043,9,2034,2,7,2034,0
3.5,PIKEGLOBIN,"[221, 237, 474, 588, 604, 1011, 1069, 1193, 1272, 1319]","[237, 588]","[221, 474, 604, 1011, 1069, 1193, 1272, 1319]","[237, 588]",1701,10,1691,2,8,1691,0
3.5,PPGLTG,"[308, 373, 527, 662, 715, 747, 907]","[373, 662]","[308, 527, 715, 747, 907]","[373, 662]",1064,7,1057,2,5,1057,0
3.5,PPPROP2,"[63, 576, 661]",[],"[63, 576, 661]",[319],739,3,736,0,3,735,1
3.5,PPYPROP2,"[530, 615]",[],"[530, 615]",[272],688,2,686,0,2,685,1
3.5,PTAZGLO,"[441, 840, 943, 965, 974, 1062, 1086, 1603, 1648, 1652, 1679, 1707, 1721, 1749, 1791, 1833, 1947, 1991, 2120, 2162, 2176, 2244, 2253, 2987, 3065, 3077, 3124]","[1603, 3077]","[441, 840, 943, 965, 974, 1062, 1086, 1648, 1652, 1679, 1707, 1721, 1749, 1791, 1833, 1947, 1991, 2120, 2162, 2176, 2244, 2253, 2987, 3065, 3124]","[1603, 3077]",3609,27,3582,2,25,3582,0
3.5,PTGGGLOG,"[162, 200, 431, 545, 641, 891, 1064, 1076]","[200, 545]","[162, 431, 641, 891, 1064, 1076]","[200, 545]",1814,8,1806,2,6,1806,0
3.5,PTPPINS,"[688, 728, 933, 1028, 1054, 1140, 1410, 1985, 2010, 2095, 2201, 2469]",[1410],"[688, 728, 933, 1028, 1054, 1140, 1985, 2010, 2095, 2201, 2469]",[1410],2475,12,2463,1,11,2463,0
3.5,PTPROP2,"[74, 588, 673]",[],"[74, 588, 673]",[330],750,3,747,0,3,746,1
3.5,PVU11715,"[250, 288, 519, 586, 633, 1021, 1272, 1340, 1368]","[288, 633]","[250, 519, 586, 1021, 1272, 1340, 1368]","[288, 633]",1781,9,1772,2,7,1772,0
3.5,QULNFLW,"[15, 260, 762, 867, 961, 1222, 1338, 1548, 1667, 2169, 2301, 2364, 2405, 2425, 2461, 2703, 2972, 3329, 3662, 3720, 3794, 4139, 4443, 4587, 4656, 4817, 5192, 5612, 5849, 5873, 5894, 5921, 5972, 6211, 6672, 6808, 7255, 7385]","[3794, 4656, 5921]","[15, 260, 762, 867, 961, 1222, 1338, 1548, 1667, 2169, 2301, 2364, 2405, 2425, 2461, 2703, 2972, 3329, 3662, 3720, 4139, 4443, 4587, 4817, 5192, 5612, 5849, 5873, 5894, 5972, 6211, 6672, 6808, 7255, 7385]","[3794, 4656, 5921]",7925,38,7887,3,35,7887,0
3.5,QULTROPIA,"[67, 240, 469, 591, 678, 689, 694, 1449, 1505, 1858, 1998, 2156, 2186, 2210, 2360, 2707, 3004, 3033, 3149, 3437, 3638, 4007, 4020, 4047, 4052, 4225, 4229, 4336, 4544, 4565, 4823, 4981]","[2186, 2360, 3004, 3437, 4047, 4336]","[67, 240, 469, 591, 678, 689, 694, 1449, 1505, 1858, 1998, 2156, 2210, 2707, 3033, 3149, 3638, 4007, 4020, 4052, 4225, 4229, 4544, 4565, 4823, 4981]","[2186, 2360, 3004, 3437, 4047, 4336]",4956,32,4924,6,26,4924,0
3.5,RABCRP,"[397, 402, 416, 509, 579, 990, 1221]",[397],"[402, 416, 509, 579, 990, 1221]",[397],1430,7,1423,1,6,1423,0
3.5,RABDNP3AA,"[370, 654, 742, 816, 906, 924, 995, 1030, 1865, 1974, 2156, 2435, 2483, 2540]",[2156],"[370, 654, 742, 816, 906, 924, 995, 1030, 1865, 1974, 2435, 2483, 2540]",[2156],3082,14,3068,1,13,3068,0
3.5,RABSURFA,"[378, 471, 503, 530, 636, 679, 780, 795, 928, 1038, 1175, 1431, 1539, 1642, 2209, 2320, 2556, 2926, 2947, 3239, 3281, 3290, 3423, 3443, 3447, 3455, 3550, 4033, 4166, 4188, 4361, 4370, 4584, 4636, 4857, 4987, 5088, 5622, 5899, 6219, 6359, 6529, 7268, 7344, 7760]","[4033, 4361, 5088]","[378, 471, 503, 530, 636, 679, 780, 795, 928, 1038, 1175, 1431, 1539, 1642, 2209, 2320, 2556, 2926, 2947, 3239, 3281, 3290, 3423, 3443, 3447, 3455, 3550, 4166, 4188, 4370, 4584, 4636, 4857, 4987, 5622, 5899, 6219, 6359, 6529, 7268, 7344, 7760]","[4033, 4361, 5088]",8089,45,8044,3,42,8044,0
3.5,RABTNF,"[261, 503, 600, 851, 1355, 1481, 1563, 1761, 1792, 2139, 2268, 3034]","[851, 1355, 1563]","[261, 503, 600, 1481, 1761, 1792, 2139, 2268, 3034]","[851, 1355, 1563]",3192,12,3180,3,9,3180,0
3.5,RATCYC,"[70, 270, 362, 572, 636, 833, 1333, 1400, 2350]",[1333],"[70, 270, 362, 572, 636, 833, 1400, 2350]",[1333],2520,9,2511,1,8,2511,0
3.5,RATCYSS,"[81, 119, 356, 445, 641, 1006, 1119, 1174, 1217, 1221, 1268, 1630, 1686, 2500, 4026, 4083, 4200, 4283]","[1006, 4026]","[81, 119, 356, 445, 641, 1119, 1174, 1217, 1221, 1268, 1630, 1686, 2500, 4083, 4200, 4283]","[1006, 4026]",5555,18,5537,2,16,5537,0
3.5,RATDCCOVB,"[13, 211, 788, 880, 1545, 1559, 1599, 1943, 1951, 2267, 2292, 2471, 2478, 2864, 3126, 3498, 3716, 3782, 4349, 4709, 5129]","[2267, 2864, 3126]","[13, 211, 788, 880, 1545, 1559, 1599, 1943, 1951, 2292, 2471, 2478, 3498, 3716, 3782, 4349, 4709, 5129]","[2267, 2864, 3126]",5323,21,5302,3,18,5302,0
3.5,RATGRG,"[83, 204, 286, 331, 658, 719, 1291, 1302, 1397, 1494, 1554, 1622, 1696, 1732, 1918, 1942, 2106, 2187, 2319, 2392, 2546, 2616, 2994, 3290, 3552, 3715, 3763]","[83, 286, 1291, 1494, 1696, 1942, 2187, 2319, 2616, 2994, 3290]","[204, 331, 658, 719, 1302, 1397, 1554, 1622, 1732, 1918, 2106, 2392, 2546, 3552, 3715, 3763]","[83, 286, 1291, 1494, 1696, 1942, 2187, 2319, 2616, 2994, 3290]",3880,27,3853,11,16,3853,0
3.5,RATGROS,"[397, 406, 621, 746, 1178, 1219, 1349, 1390, 1482, 1587, 2001, 2131]","[1178, 1390, 1587]","[397, 406, 621, 746, 1219, 1349, 1482, 2001, 2131]","[1178, 1390, 1587]",2488,12,2476,3,9,2476,0
3.5,RATGSTY,"[659, 663, 718, 884, 996, 1310, 1495, 1647, 1862, 1918, 1959, 2060, 2086, 2416, 2830, 3003, 3022, 3180, 3225, 3376, 3576, 3804, 3854, 3958, 4115, 4123, 4646, 4691, 4772, 4804, 5009, 5214, 5813, 5926, 5995]","[659, 996, 1495, 1862, 2060, 3180, 3376]","[663, 718, 884, 1310, 1647, 1918, 1959, 2086, 2416, 2830, 3003, 3022, 3225, 3576, 3804, 3854, 3958, 4115, 4123, 4646, 4691, 4772, 4804, 5009, 5214, 5813, 5926, 5995]","[659, 996, 1495, 1862, 2060, 3180, 3376]",6286,35,6251,7,28,6251,0
3.5,RATIGFBA,"[526, 850, 1002, 1097, 1242, 1381, 1455, 1788, 1948, 2034, 2082, 2203, 2240, 2396, 3002, 3105, 3214, 3262, 3312, 3450, 3496, 3828, 3873, 3924, 4000, 4127, 4362, 4512, 4546, 4578, 4620]","[526, 2034, 3002]","[850, 1002, 1097, 1242, 1381, 1455, 1788, 1948, 2082, 2203, 2240, 2396, 3105, 3214, 3262, 3312, 3450, 3496, 3828, 3873, 3924, 4000, 4127, 4362, 4512, 4546, 4578, 4620]","[526, 2034, 3002]",4992,31,4961,3,28,4961,0
3.5,RATJE,"[417, 682, 1191, 1299, 1816, 1989, 2417, 2777, 2986]","[1191, 1989]","[417, 682, 1299, 1816, 2417, 2777, 2986]","[1191, 1989]",3097,9,3088,2,7,3088,0
3.5,RATKALA,"[225, 435, 618, 945, 992, 1062, 1275, 1296, 3167, 3282, 3753, 4061, 4424, 4476, 4652, 4709, 4729, 4734, 4826, 4915, 5334, 5376, 5689, 5818, 6007, 6132]","[1275, 3282, 4476, 4709]","[225, 435, 618, 945, 992, 1062, 1296, 3167, 3753, 4061, 4424, 4652, 4729, 4734, 4826, 4915, 5334, 5376, 5689, 5818, 6007, 6132]","[1275, 3282, 4476, 4709]",6249,26,6223,4,22,6223,0
3.5,RATLHB,"[621, 763, 784, 793, 817, 825, 837, 934, 959, 1028, 1230, 1247, 1293, 1359, 1510]","[817, 1230]","[621, 763, 784, 793, 825, 837, 934, 959, 1028, 1247, 1293, 1359, 1510]","[817, 1230]",1790,15,1775,2,13,1775,0
3.5,RATLITHOST,"[397, 992, 2013, 2464, 2496, 2847, 3117, 3471, 3475, 3902, 3906, 4022, 4229, 4652, 4715, 5343]","[2847, 3471, 3902, 4652]","[397, 992, 2013, 2464, 2496, 3117, 3475, 3906, 4022, 4229, 4715, 5343]","[2847, 3471, 3902, 4652]",5399,16,5383,4,12,5383,0
3.5,RATLYSOZYM,"[38, 342, 960, 1561, 1736, 1941, 2210, 2220, 3255, 3588, 3999, 4136, 4367, 4446, 4497, 4558, 4907, 5174, 5339, 5443, 5691, 6270, 6404, 6539]","[1561, 3255, 5174]","[38, 342, 960, 1736, 1941, 2210, 2220, 3588, 3999, 4136, 4367, 4446, 4497, 4558, 4907, 5339, 5443, 5691, 6270, 6404, 6539]","[1561, 3255, 5174]",6732,24,6708,3,21,6708,0
3.5,RATLYSZYM,"[6, 113, 306, 319, 323, 508, 574, 749, 1007, 1099, 1108, 1392, 1667, 1671, 2101, 2558, 2676, 2912, 2937, 3830, 3840, 4290, 4624, 5036, 5192, 5423, 5502, 5553, 5614, 5963, 6230, 6395, 6499, 6746, 7325, 7461, 7596]","[574, 4290, 6230]","[6, 113, 306, 319, 323, 508, 749, 1007, 1099, 1108, 1392, 1667, 1671, 2101, 2558, 2676, 2912, 2937, 3830, 3840, 4624, 5036, 5192, 5423, 5502, 5553, 5614, 5963, 6395, 6499, 6746, 7325, 7461, 7596]","[574, 4290, 6230]",7943,37,7906,3,34,7906,0
3.5,RATOSCAL,"[261, 1072, 1192, 1373, 1540, 1586, 1633, 1828, 1832, 2085]","[1192, 1373, 1586]","[261, 1072, 1540, 1633, 1828, 1832, 2085]","[1192, 1373, 1586]",2119,10,2109,3,7,2109,0
3.5,RATPAP,"[624, 633, 662, 863, 921, 1048, 1076, 1308, 1648, 1737, 1795, 2295, 3305, 3432, 3570, 3715]","[1308, 1648, 2295, 3305]","[624, 633, 662, 863, 921, 1048, 1076, 1737, 1795, 3432, 3570, 3715]","[1308, 1648, 2295, 2604, 3305]",4863,16,4847,4,12,4846,1
3.5,RATPAPIIB,"[27, 474, 1916, 2291, 2298, 2332, 2532, 2701, 2751, 3021, 3387, 3473, 3587, 3817, 3834, 4107, 4297]","[2298, 3473, 4107]","[27, 474, 1916, 2291, 2332, 2532, 2701, 2751, 3021, 3387, 3587, 3817, 3834, 4297]","[2298, 3140, 3473, 4107]",4717,17,4700,3,14,4699,1
3.5,RATPPP,"[118, 740, 1249, 1406, 1497, 1538, 1586, 1893, 1983, 2002, 2261, 2451, 2521, 2718, 2927, 2986, 3065, 3270, 3500, 3732, 4400, 4464]",[2261],"[118, 740, 1249, 1406, 1497, 1538, 1586, 1893, 1983, 2002, 2451, 2521, 2718, 2927, 2986, 3065, 3270, 3500, 3732, 4400, 4464]",[2261],4534,22,4512,1,21,4512,0
3.5,RATPTBZR02,"[224, 326, 669, 673, 727, 871, 909, 1206, 1222, 1306, 1535, 1927, 2066, 2123, 2200, 2598, 2719, 2988, 3110, 3232, 3245]","[1306, 2066]","[224, 326, 669, 673, 727, 871, 909, 1206, 1222, 1535, 1927, 2123, 2200, 2598, 2719, 2988, 3110, 3232, 3245]","[1306, 2066]",3426,21,3405,2,19,3405,0
3.5,RATRGPI,"[261, 857, 1879, 2329, 2361, 2712, 2984, 3339, 3343, 3770, 3774, 3890, 4097, 4521, 4584, 5211]","[2712, 3339, 3770, 4521]","[261, 857, 1879, 2329, 2361, 2984, 3343, 3774, 3890, 4097, 4584, 5211]","[2712, 3339, 3770, 4521]",5237,16,5221,4,12,5221,0
3.5,RATRPIII,"[1226, 1601, 1608, 1642, 2017, 2067, 2337, 2456, 2704, 2790, 2905, 3135, 3152, 3426, 3617, 4044]","[1608, 2456, 2790, 3426]","[1226, 1601, 1642, 2017, 2067, 2337, 2704, 2905, 3135, 3152, 3617, 4044]","[1608, 2456, 2790, 3426]",4133,16,4117,4,12,4117,0
3.5,RATSVSIV1,"[72, 244, 380, 659, 721, 814, 892]",[244],"[72, 380, 659, 721, 814, 892]",[244],972,7,965,1,6,965,0
3.5,RATTSHB,"[260, 265, 435, 661, 880, 1661, 1758, 2177, 2183, 2483, 2711, 2874, 3202, 3462, 3999, 4299, 4375, 4781]",[4375],"[260, 265, 435, 661, 880, 1661, 1758, 2177, 2183, 2483, 2711, 2874, 3202, 3462, 3999, 4299, 4781]",[4375],5159,18,5141,1,17,5141,0
3.5,RN0B2GLOB,"[9, 31, 80, 84, 316, 500, 558, 579, 693, 796, 1134, 1702, 1766]",[693],"[9, 31, 80, 84, 316, 500, 558, 579, 796, 1134, 1702, 1766]","[354, 693]",1789,13,1776,1,12,1775,1
3.5,RN2BGLOB,"[264, 394, 432, 571, 629, 650, 764, 1217, 1710, 1760, 1769]","[432, 764]","[264, 394, 571, 629, 650, 1217, 1710, 1760, 1769]","[432, 764]",1876,11,1865,2,9,1865,0
3.5,RN3B2GLOB,"[84, 122, 267, 325, 346, 460, 867, 1360, 1421]","[122, 460]","[84, 267, 325, 346, 867, 1360, 1421]","[122, 460]",1436,9,1427,2,7,1427,0
3.5,RN3B3GLOB,"[75, 125, 129, 365, 403, 546, 604, 625, 739, 1146, 1642]","[403, 739]","[75, 125, 129, 365, 546, 604, 625, 1146, 1642]","[403, 739]",1738,11,1727,2,9,1727,0
3.5,RN3BGLOB,"[250, 288, 433, 491, 512, 626, 1028, 1522]","[288, 626]","[250, 433, 491, 512, 1028, 1522]","[288, 626]",1526,8,1518,2,6,1518,0
3.5,RNAC01,"[127, 131, 309, 374, 513, 582, 734, 758, 844, 1207, 1367, 1463, 1467, 1694, 1992, 2190, 2419, 2528, 2597, 2631, 2685, 2867, 3335, 3556, 3767, 3850, 3984, 4000]","[1367, 1694, 2597, 2867]","[127, 131, 309, 374, 513, 582, 734, 758, 844, 1207, 1463, 1467, 1992, 2190, 2419, 2528, 2631, 2685, 3335, 3556, 3767, 3850, 3984, 4000]","[1367, 1694, 2597, 2867]",4083,28,4055,4,24,4055,0
3.5,RNAC02,"[251, 262, 480, 636, 1368, 1471, 1475, 1526, 1787, 1820, 2138, 2180, 2243, 2561, 2637, 2681, 2759]","[1368, 1787, 2138]","[251, 262, 480, 636, 1471, 1475, 1526, 1820, 2180, 2243, 2561, 2637, 2681, 2759]","[1368, 1787, 2138, 2429, 2743]",3192,17,3175,3,14,3173,2
3.5,RNANTANT,"[62, 88, 236, 476, 1017, 1295, 1339, 1524, 1678, 1808, 2904, 2969, 3023, 3119, 3263, 3301, 3420, 3609, 3646, 3777, 3883, 3993, 4213, 4532]","[1524, 3263, 3883]","[62, 88, 236, 476, 1017, 1295, 1339, 1678, 1808, 2904, 2969, 3023, 3119, 3301, 3420, 3609, 3646, 3777, 3993, 4213, 4532]","[1524, 3263, 3883]",5117,24,5093,3,21,5093,0
3.5,RNAPOEG,"[459, 499, 615, 620, 1077, 1152, 1293, 1327, 1440, 1746, 1812, 1955, 2069, 2536, 2692, 2705, 2863, 2867, 2884, 3203]","[1293, 1955]","[459, 499, 615, 620, 1077, 1152, 1327, 1440, 1746, 1812, 2069, 2536, 2692, 2705, 2863, 2867, 2884, 3203]","[1293, 1955]",3229,20,3209,2,18,3209,0
3.5,RNCALBD9,"[24, 161, 373, 469, 596, 984, 1041, 1399, 1532, 1621, 1739, 1779, 1793, 1831, 2285, 2499, 2736, 3177, 3254, 3508, 4062, 4310, 4587, 4711]",[2736],"[24, 161, 373, 469, 596, 984, 1041, 1399, 1532, 1621, 1739, 1779, 1793, 1831, 2285, 2499, 3177, 3254, 3508, 4062, 4310, 4587, 4711]",[2736],4883,24,4859,1,23,4859,0
3.5,RNGAMT,"[486, 497, 799, 1531, 1552, 1564, 2173, 2752, 3141, 3319, 3760, 3797, 3802, 4003, 4390, 4441, 4635, 4704, 4715, 4876]","[2173, 3141, 3319, 3760, 4003]","[486, 497, 799, 1531, 1552, 1564, 2752, 3797, 3802, 4390, 4441, 4635, 4704, 4715, 4876]","[2173, 3141, 3319, 3760, 4003]",4956,20,4936,5,15,4936,0
3.5,RNGMTG,"[92, 440, 620, 741, 1011, 1016, 1226, 1267, 1406, 1682, 1818, 2067, 2117, 2433, 2443, 2987, 3249, 3357, 3428, 3481, 3555, 3918, 4048, 4063, 4120, 4158, 4425, 4432, 4463, 4548, 4624, 5122, 5252, 5306, 5347]","[1682, 3249, 3918, 4463]","[92, 440, 620, 741, 1011, 1016, 1226, 1267, 1406, 1818, 2067, 2117, 2433, 2443, 2987, 3357, 3428, 3481, 3555, 4048, 4063, 4120, 4158, 4425, 4432, 4548, 4624, 5122, 5252, 5306, 5347]","[1682, 3249, 3918, 4254, 4463]",5391,35,5356,4,31,5355,1
3.5,RNGROW3,"[89, 216, 365, 471, 543, 817, 1096, 1652, 1751, 1973]","[471, 817, 1652, 1973]","[89, 216, 365, 543, 1096, 1751]","[471, 817, 1652, 1973]",2549,10,2539,4,6,2539,0
3.5,RNHSC73,"[498, 522, 570, 954, 1244, 1528, 1713, 1982, 2062, 2258, 2297, 2506, 2618, 2664, 3034, 3259, 3448, 3542, 3766, 3795, 3942]","[1244, 1713, 1982, 2618, 3034, 3448, 3766]","[498, 522, 570, 954, 1528, 2062, 2258, 2297, 2506, 2664, 3259, 3542, 3795, 3942]","[1244, 1713, 1982, 2618, 3034, 3448, 3766]",4312,21,4291,7,14,4291,0
3.5,RNLALB01,"[39, 347, 351, 821, 877, 971, 1101, 1237, 1242, 1354, 1414, 1914, 2096, 2419, 2897, 2974, 3297, 3482, 3800]","[1414, 1914, 2419]","[39, 347, 351, 821, 877, 971, 1101, 1237, 1242, 1354, 2096, 2897, 2974, 3297, 3482, 3800]","[1414, 1914, 2419]",3812,19,3793,3,16,3793,0
3.5,RNLPKG,"[33, 102, 1022, 1729, 1911, 2062, 2169, 2183, 2847, 3195, 3374, 3634, 3949, 4076, 4253, 4321, 4493, 5605, 5806, 5836, 6009, 6284, 6457, 6463, 6605, 6805, 7192, 7321, 7481, 7582, 7818, 8078, 8286, 8465, 9121, 9142, 9414, 9480, 9838, 9919, 10214, 10935, 11648, 11834, 12180, 12649, 12724, 12937]","[3949, 6009, 6284, 6605, 7192, 7818, 8078, 9480]","[33, 102, 1022, 1729, 1911, 2062, 2169, 2183, 2847, 3195, 3374, 3634, 4076, 4253, 4321, 4493, 5605, 5806, 5836, 6457, 6463, 6805, 7321, 7481, 7582, 8286, 8465, 9121, 9142, 9414, 9838, 9919, 10214, 10935, 11648, 11834, 12180, 12649, 12724, 12937]","[3219, 3949, 6009, 6284, 6605, 7192, 7453, 7818, 8078, 9480]",13003,48,12955,8,40,12953,2
3.5,RNODC,"[115, 883, 1097, 1279, 1339, 1344, 1554, 1568, 2666, 3174, 3305, 3525, 3618, 3918, 4073, 4095, 4182, 4517, 4698, 4953, 4982, 5347, 5631, 5650, 5825, 5851, 5974, 5997, 6178, 6291, 6350, 6412, 6582, 6692, 7326, 7755]","[3525, 3918, 4182, 4517, 4698, 4953, 5631, 5825, 6291]","[115, 883, 1097, 1279, 1339, 1344, 1554, 1568, 2666, 3174, 3305, 3618, 4073, 4095, 4982, 5347, 5650, 5851, 5974, 5997, 6178, 6350, 6412, 6582, 6692, 7326, 7755]","[3525, 3918, 4182, 4517, 4698, 4953, 5631, 5825, 6291]",7768,36,7732,9,27,7732,0
3.5,RNP9KA,"[22, 30, 172, 207, 248, 723, 727, 736, 823, 905, 910, 937, 1227, 1468, 1612, 2118, 2220, 2224, 2311]",[1227],"[22, 30, 172, 207, 248, 723, 727, 736, 823, 905, 910, 937, 1468, 1612, 2118, 2220, 2224, 2311]",[1227],2332,19,2313,1,18,2313,0
3.5,RNPBPG,"[21, 231, 501, 980, 1117, 1155, 1180, 2100, 2592, 2638, 2950, 3190, 3363, 3756, 4056, 4073]","[1117, 2950]","[21, 231, 501, 980, 1155, 1180, 2100, 2592, 2638, 3190, 3363, 3756, 4056, 4073]","[1117, 2950]",6021,16,6005,2,14,6005,0
3.5,RNPGMUT,"[17, 32, 63, 370, 1216, 1273, 1412, 1515, 1596, 1605, 1734, 1912, 2242, 2287, 2291]",[1596],"[17, 32, 63, 370, 1216, 1273, 1412, 1515, 1605, 1734, 1912, 2242, 2287, 2291]","[1596, 1872]",2420,15,2405,1,14,2404,1
3.5,RNPROST22,"[45, 237, 438, 444, 499, 528, 733, 876, 1262, 1870, 2200, 2321, 3647, 3835, 3841, 3916, 4048, 4279, 4526, 4727, 4820, 5680, 6009, 6680, 6890, 6974, 7004, 7034, 7412]","[876, 3647, 4526]","[45, 237, 438, 444, 499, 528, 733, 1262, 1870, 2200, 2321, 3835, 3841, 3916, 4048, 4279, 4727, 4820, 5680, 6009, 6680, 6890, 6974, 7004, 7034, 7412]","[876, 3647, 4526]",7667,29,7638,3,26,7638,0
3.5,RNREVSV2A,"[12, 67, 121, 290, 754, 762, 848, 1201, 1304, 1341]","[67, 1304]","[12, 121, 290, 754, 762, 848, 1201, 1341]","[67, 1304]",1730,10,1720,2,8,1720,0
3.5,RNSDHG,"[160, 177, 199, 285, 290, 379, 1007, 1224, 1286, 1376, 1536, 1775, 1777, 1993, 2205, 2256, 2697, 3035, 3480, 3554, 3975, 4077, 4179, 4413, 4705, 5079, 5590, 5691, 5866, 6052, 6095, 6213, 6253, 6479, 6512, 6576, 6634, 6641, 6877, 6984, 7081, 7600, 7962, 8014, 8314, 8671, 8888, 9541]","[5691, 6052, 6253, 6984, 8671]","[160, 177, 199, 285, 290, 379, 1007, 1224, 1286, 1376, 1536, 1775, 1777, 1993, 2205, 2256, 2697, 3035, 3480, 3554, 3975, 4077, 4179, 4413, 4705, 5079, 5590, 5866, 6095, 6213, 6479, 6512, 6576, 6634, 6641, 6877, 7081, 7600, 7962, 8014, 8314, 8888, 9541]","[4640, 5691, 6052, 6253, 6984, 8671]",9570,48,9522,5,43,9521,1
3.5,RNSVFG,"[213, 500, 636, 670, 709, 1018, 1250, 1267, 1347, 1919]",[500],"[213, 636, 670, 709, 1018, 1250, 1267, 1347, 1919]",[500],1841,10,1831,1,9,1831,0
3.5,RNTHYCSG,"[68, 318, 326, 355, 679, 1071, 1105, 1229, 1237, 1366, 1450, 1906, 2203, 2271]","[68, 1071]","[318, 326, 355, 679, 1105, 1229, 1237, 1366, 1450, 1906, 2203, 2271]","[68, 1071]",2855,14,2841,2,12,2841,0
3.5,RNU03551,"[46, 64, 219, 578, 584, 715, 766, 832, 1545, 1969, 2115, 2183, 2263, 2418, 2461, 2552, 3083, 3176, 3226, 3360]","[832, 2418, 3083]","[46, 64, 219, 578, 584, 715, 766, 1545, 1969, 2115, 2183, 2263, 2461, 2552, 3176, 3226, 3360]","[832, 2418, 3083]",3590,20,3570,3,17,3570,0
3.5,RNU09193,"[402, 438, 469, 1727, 2084, 2295, 2630, 2749, 3084, 3600, 3612, 3787, 3899, 3910]","[2084, 2749, 3084, 3787]","[402, 438, 469, 1727, 2295, 2630, 3600, 3612, 3899, 3910]","[2084, 2749, 3084, 3787]",4187,14,4173,4,10,4173,0
3.5,RNU12250,"[293, 325, 424, 464, 473, 826, 1704, 1708, 1769]","[293, 473]","[325, 424, 464, 826, 1704, 1708, 1769]","[293, 473]",1863,9,1854,2,7,1854,0
3.5,RNUCPG,"[112, 255, 380, 848, 1135, 1396, 1424, 1519, 1663, 1730, 1834, 1881, 1908, 2382, 2428, 2812, 3539, 3598, 3801, 4110, 4187, 4310, 4818, 4822, 4896, 4965, 5157, 5476, 5677, 5744, 6018, 6121, 6426, 6470, 6660, 6983, 7007, 7395, 7852, 7996, 8157, 8180, 9172, 9401, 9441, 10198, 10292, 10300, 10603, 10871, 11061, 11092, 11481, 11722]","[4310, 5157, 8157, 9401]","[112, 255, 380, 848, 1135, 1396, 1424, 1519, 1663, 1730, 1834, 1881, 1908, 2382, 2428, 2812, 3539, 3598, 3801, 4110, 4187, 4818, 4822, 4896, 4965, 5476, 5677, 5744, 6018, 6121, 6426, 6470, 6660, 6983, 7007, 7395, 7852, 7996, 8180, 9172, 9441, 10198, 10292, 10300, 10603, 10871, 11061, 11092, 11481, 11722]","[4310, 5157, 7964, 8157, 9401]",12496,54,12442,4,50,12441,1
3.5,RNVEGP1,"[305, 400, 926, 1043, 1156, 1262, 1286, 1623, 1629, 1635, 1834, 1935, 1994, 2076, 2108, 2628, 2777, 3032, 3940, 4037, 4126, 4140, 4452, 4844, 4962, 5195, 5630, 5948]","[1262, 1834, 3032, 4037]","[305, 400, 926, 1043, 1156, 1286, 1623, 1629, 1635, 1935, 1994, 2076, 2108, 2628, 2777, 3940, 4126, 4140, 4452, 4844, 4962, 5195, 5630, 5948]","[1262, 1834, 3032, 4037, 4611]",5948,28,5920,4,24,5919,1
3.5,RNVEGP2C,"[430, 536, 1041, 1159, 1272, 1378, 1402, 1739, 1745, 1751, 1950, 2048, 2105, 2182, 2213, 2875, 3128, 4146, 4671, 4960, 5078, 5566]","[1378, 1950, 3128, 4146]","[430, 536, 1041, 1159, 1272, 1402, 1739, 1745, 1751, 2048, 2105, 2182, 2213, 2875, 4671, 4960, 5078, 5566]","[1378, 1950, 3128, 4146, 4723]",5742,22,5720,4,18,5719,1
3.5,RRU04320,"[838, 1077, 1105, 1126, 1538, 1559, 2004, 2008, 2107, 2118, 2500, 2592, 2606, 3080, 3099, 3139, 3301, 3412, 3643, 4216, 5366, 5456, 6213]","[2500, 3643]","[838, 1077, 1105, 1126, 1538, 1559, 2004, 2008, 2107, 2118, 2592, 2606, 3080, 3099, 3139, 3301, 3412, 4216, 5366, 5456, 6213]","[2500, 3643]",6798,23,6775,2,21,6775,0
3.5,S46763,"[186, 336, 479, 535, 699, 777, 1006, 1235, 1252, 1406, 1690, 1787, 2111, 2487, 2722, 2775, 2946, 3209, 3245, 3278, 3563, 3954, 4052, 4256, 4358, 4424, 4801, 5060, 5469, 6085, 6880, 7078, 7334, 7349, 7953, 8012, 8037, 8056, 8294, 8344]","[1235, 2487, 2775, 4052, 5060, 5469, 6880, 7334, 8012, 8294]","[186, 336, 479, 535, 699, 777, 1006, 1252, 1406, 1690, 1787, 2111, 2722, 2946, 3209, 3245, 3278, 3563, 3954, 4256, 4358, 4424, 4801, 6085, 7078, 7349, 7953, 8037, 8056, 8344]","[1235, 2487, 2775, 4052, 4528, 5060, 5469, 6880, 7334, 8012, 8294]",10035,40,9995,10,30,9994,1
3.5,S49651,"[246, 471, 823, 1117, 1652, 2378, 2476, 3255, 3566, 3571, 3856, 4137, 4577]","[1652, 3255, 4137]","[246, 471, 823, 1117, 2378, 2476, 3566, 3571, 3856, 4577]","[1652, 2786, 3255, 4137]",5440,13,5427,3,10,5426,1
3.5,S57980,"[44, 236, 437, 443, 498, 527, 732, 875, 1261, 1869, 2198, 2319, 3645, 3833, 3839, 3914, 4046, 4277, 4524, 4725, 4818, 5678, 6007, 6678, 6888, 6972, 7002, 7032, 7410]","[875, 3645, 4524]","[44, 236, 437, 443, 498, 527, 732, 1261, 1869, 2198, 2319, 3833, 3839, 3914, 4046, 4277, 4725, 4818, 5678, 6007, 6678, 6888, 6972, 7002, 7032, 7410]","[875, 3645, 4524]",7665,29,7636,3,26,7636,0
3.5,S62287,"[190, 555, 570, 1266, 1673, 1965, 1970, 2470, 2535, 2619, 2808, 3077, 3108, 3167]",[1266],"[190, 555, 570, 1673, 1965, 1970, 2470, 2535, 2619, 2808, 3077, 3108, 3167]",[1266],3425,14,3411,1,13,3411,0
3.5,S63697,"[92, 159, 280, 504, 829]","[280, 829]","[92, 159, 504]","[280, 829]",1331,5,1326,2,3,1326,0
3.5,S66606,"[152, 238, 248, 340, 379, 865, 1076, 1859, 1875, 2506, 2706, 3613, 3675, 3723, 3899, 3982, 4067, 4530, 4598, 4706, 5644, 5936, 5958, 6167, 6171, 6296]","[2506, 2706, 3899, 4598]","[152, 238, 248, 340, 379, 865, 1076, 1859, 1875, 3613, 3675, 3723, 3982, 4067, 4530, 4706, 5644, 5936, 5958, 6167, 6171, 6296]","[2506, 2706, 3899, 4598]",6359,26,6333,4,22,6333,0
3.5,S67057,"[83, 98, 322, 840, 953]",[840],"[83, 98, 322, 953]",[840],1746,5,1741,1,4,1741,0
3.5,S69277,"[142, 151, 207, 857, 1706, 1967, 1971, 2058, 2074, 2101, 2103, 2538, 3072, 3098, 3229, 3316, 3521, 3723, 3839, 4103, 4215, 4385, 4556, 4726, 4852, 5063]","[3098, 3316, 3521, 3839, 4103]","[142, 151, 207, 857, 1706, 1967, 1971, 2058, 2074, 2101, 2103, 2538, 3072, 3229, 3723, 4215, 4385, 4556, 4726, 4852, 5063]","[3098, 3316, 3521, 3839, 4103]",5516,26,5490,5,21,5490,0
3.5,S69278,"[84, 279, 323, 547, 846, 861, 1184, 1402, 1406, 1500, 1529, 1597, 2564, 2590, 2739, 2826, 3031, 3231, 3347, 3561, 3662, 3832, 4004, 4174, 4236]","[2590, 2826, 3031, 3347, 3561]","[84, 279, 323, 547, 846, 861, 1184, 1402, 1406, 1500, 1529, 1597, 2564, 2739, 3231, 3662, 3832, 4004, 4174, 4236]","[2590, 2826, 3031, 3347, 3561]",5015,25,4990,5,20,4990,0
3.5,S69350,"[235, 566, 676, 1179, 1866, 2124, 2149]",[235],"[566, 676, 1179, 1866, 2124, 2149]",[235],2152,7,2145,1,6,2145,0
3.5,SAIEGLOBIM,"[221, 237, 346, 474, 588, 604, 983, 1194, 1317, 1329, 1397, 1425, 1444]","[237, 588]","[221, 346, 474, 604, 983, 1194, 1317, 1329, 1397, 1425, 1444]","[237, 588]",1826,13,1813,2,11,1813,0
3.5,SMIGCU,"[696, 799, 911, 1233, 1631, 1779, 1805, 1946, 2139, 2173, 2514, 2624]","[799, 1233, 1631]","[696, 911, 1779, 1805, 1946, 2139, 2173, 2514, 2624]","[799, 1233, 1631]",2833,12,2821,3,9,2821,0
3.5,SMNPRP1A,"[215, 236, 310]",[215],"[236, 310]",[215],623,3,620,1,2,620,0
3.5,SOEEGLOBIN,"[17, 220, 236, 344, 472, 586, 602, 1060, 1183, 1195, 1263, 1291, 1310]","[236, 586]","[17, 220, 344, 472, 602, 1060, 1183, 1195, 1263, 1291, 1310]","[236, 586]",1688,13,1675,2,11,1675,0
3.5,SSBAT1G,"[260, 285, 482, 518, 1316, 1344, 1471, 1681, 1843, 2215, 2323, 2425, 2501, 2582, 2592, 2610, 2616, 2716, 2814, 2990, 3618, 3837, 4001, 4538, 4875, 5056, 5449, 5527, 5890, 6021, 6104, 6290, 6390, 6533, 6678, 6735, 6908, 6978, 6999, 7799, 8238, 8708, 8767, 9144, 9331, 9388, 9674, 9965, 10370]","[1316, 2215, 2582, 4538, 8238, 9144, 9388, 9674]","[260, 285, 482, 518, 1344, 1471, 1681, 1843, 2323, 2425, 2501, 2592, 2610, 2616, 2716, 2814, 2990, 3618, 3837, 4001, 4875, 5056, 5449, 5527, 5890, 6021, 6104, 6290, 6390, 6533, 6678, 6735, 6908, 6978, 6999, 7799, 8708, 8767, 9331, 9965, 10370]","[1316, 2215, 2582, 4538, 5771, 8238, 9144, 9388, 9674]",10666,49,10617,8,41,10616,1
3.5,SSIKBAGE,"[60, 788, 956, 1247, 1729, 2377, 2469, 2501, 2528, 3151, 3334, 3520, 3620, 3713, 3766, 3823, 3850, 3954, 4091, 4470, 4600, 5251, 5304, 5601, 5628]","[2469, 3151, 3713, 4091, 4470]","[60, 788, 956, 1247, 1729, 2377, 2501, 2528, 3334, 3520, 3620, 3766, 3823, 3850, 3954, 4600, 5251, 5304, 5601, 5628]","[2469, 3151, 3713, 4091, 4470]",5756,25,5731,5,20,5731,0
3.5,SSPINT1B,"[88, 185, 206, 1081, 1518, 1536, 1615, 1933, 1971, 2127, 2252, 2551, 2673, 2759, 3399, 3407, 3903, 4159, 4582, 4793, 5245, 6247, 6605, 6609, 6774, 6790, 7761, 8049, 8233, 8246, 8448, 8541, 8611]","[1971, 2551, 3903, 5245, 6605]","[88, 185, 206, 1081, 1518, 1536, 1615, 1933, 2127, 2252, 2673, 2759, 3399, 3407, 4159, 4582, 4793, 6247, 6609, 6774, 6790, 7761, 8049, 8233, 8246, 8448, 8541, 8611]","[1971, 2551, 3903, 5245, 6605]",8743,33,8710,5,28,8710,0
3.5,TAPROTP1,[7],[],[7],[230],547,1,546,0,1,545,1
3.5,TARHBE,"[76, 103, 119, 351, 400, 418, 465, 1202]","[119, 465]","[76, 103, 351, 400, 418, 1202]","[119, 465]",1682,8,1674,2,6,1674,0
3.5,TARHBG,"[58, 227, 265, 608, 704, 1032, 1217, 1488, 1822, 2059, 2072]",[265],"[58, 227, 608, 704, 1032, 1217, 1488, 1822, 2059, 2072]","[265, 612]",2139,11,2128,1,10,2127,1
3.5,TFLPA2P1,"[266, 272, 326, 374, 589, 596, 650, 670, 972, 1293, 1311, 1749, 1848, 2031, 2035, 2108, 2240, 2495]","[596, 972, 1749]","[266, 272, 326, 374, 589, 650, 670, 1293, 1311, 1848, 2031, 2035, 2108, 2240, 2495]","[596, 972, 1749]",2708,18,2690,3,15,2690,0
3.5,TFLPA2P2,"[266, 368, 583, 590, 644, 664, 900, 935, 966, 1017, 1286, 1304, 1565, 1783, 1882, 2068, 2072, 2274]","[590, 966, 1783]","[266, 368, 583, 644, 664, 900, 935, 1017, 1286, 1304, 1565, 1882, 2068, 2072, 2274]","[590, 966, 1783]",2431,18,2413,3,15,2413,0
3.5,TFLPA2P3,"[266, 272, 326, 374, 589, 596, 650, 670, 972, 1293, 1311, 1749, 1848, 2031, 2035, 2108, 2240, 2495]","[596, 972, 1749]","[266, 272, 326, 374, 589, 650, 670, 1293, 1311, 1848, 2031, 2035, 2108, 2240, 2495]","[596, 972, 1749]",2708,18,2690,3,15,2690,0
3.5,TFLPA2P4,"[266, 368, 583, 590, 644, 664, 900, 935, 966, 1017, 1286, 1304, 1565, 1783, 1882, 2068, 2072, 2274]","[590, 966, 1783]","[266, 368, 583, 644, 664, 900, 935, 1017, 1286, 1304, 1565, 1882, 2068, 2072, 2274]","[590, 966, 1783]",2431,18,2413,3,15,2413,0
3.5,TGLHBB,"[155, 519, 712, 774, 888, 1106, 1214, 1256, 1742, 2034, 2233]","[519, 888]","[155, 712, 774, 1106, 1214, 1256, 1742, 2034, 2233]","[519, 888]",2300,11,2289,2,9,2289,0
3.5,TIOPRP1A,"[212, 233]",[212],[233],[212],556,2,554,1,1,554,0
3.5,U00432,"[237, 793, 975, 1101, 1203, 1312, 1459]","[237, 793, 1101, 1312]","[975, 1203, 1459]","[83, 237, 793, 1101, 1312]",1575,7,1568,4,3,1567,1
3.5,U00433,"[83, 267, 752, 936, 1245, 1270, 1424]","[83, 267, 752, 1270]","[936, 1245, 1424]","[83, 267, 752, 1062, 1270]",1545,7,1538,4,3,1537,1
3.5,U00454,"[131, 413, 772, 849, 1031, 1062, 1090, 1263, 1598, 1631, 1749, 1967, 2071, 2315, 2382, 2781, 2823, 3043, 3464, 3905, 4179, 4276, 4328, 4362, 4529, 4653, 4824, 4862, 5011, 5303, 5625, 5820, 6565, 6782, 6800, 6887, 7057]","[1598, 4862]","[131, 413, 772, 849, 1031, 1062, 1090, 1263, 1631, 1749, 1967, 2071, 2315, 2382, 2781, 2823, 3043, 3464, 3905, 4179, 4276, 4328, 4362, 4529, 4653, 4824, 5011, 5303, 5625, 5820, 6565, 6782, 6800, 6887, 7057]","[1598, 4862]",7192,37,7155,2,35,7155,0
3.5,U00938,"[60, 71, 102, 247, 556, 832, 912, 1133, 1169, 1173, 1454, 1465, 1516, 2179, 2207, 2384, 2611, 2715, 2719, 2742, 2824, 3017, 3079, 3311, 3397, 3587, 3617, 3702, 4070, 4796, 5155, 5202, 5261, 5452, 5640, 5745, 5809, 5962, 6009, 6198, 6482, 6711, 6763]","[1169, 4070, 5155]","[60, 71, 102, 247, 556, 832, 912, 1133, 1173, 1454, 1465, 1516, 2179, 2207, 2384, 2611, 2715, 2719, 2742, 2824, 3017, 3079, 3311, 3397, 3587, 3617, 3702, 4796, 5202, 5261, 5452, 5640, 5745, 5809, 5962, 6009, 6198, 6482, 6711, 6763]","[1169, 4070, 5155]",6780,43,6737,3,40,6737,0
3.5,U01026,"[52, 428, 492, 1105, 1153, 1357, 1364, 1419, 1746, 1927, 2071, 2154, 2316, 2537, 2636, 2760, 2826, 3028]","[1364, 1746, 2537]","[52, 428, 492, 1105, 1153, 1357, 1419, 1927, 2071, 2154, 2316, 2636, 2760, 2826, 3028]","[1364, 1746, 2537]",3216,18,3198,3,15,3198,0
3.5,U01027,"[248, 309, 357, 564, 571, 625, 947, 1128, 1272, 1290, 1710, 1809, 1982, 1999, 2054, 2192, 2740]","[571, 947, 1710]","[248, 309, 357, 564, 625, 1128, 1272, 1290, 1809, 1982, 1999, 2054, 2192, 2740]","[571, 947, 1710]",2761,17,2744,3,14,2744,0
3.5,U01844,"[64, 304, 476, 623, 663, 684, 1307, 1472, 1559, 1589, 1770, 1919, 1986, 2090, 2395, 2474, 2585, 2653, 3211, 3256, 3403, 3781, 3843]","[1986, 2474, 2653, 3211]","[64, 304, 476, 623, 663, 684, 1307, 1472, 1559, 1589, 1770, 1919, 2090, 2395, 2585, 3256, 3403, 3781, 3843]","[1986, 2141, 2474, 2653, 3211]",4219,23,4196,4,19,4195,1
3.5,XELCRPGA,"[285, 726, 837, 842, 892, 1096, 1686, 1871, 2377, 2504, 2961, 3199, 3338, 3497, 3794]",[1096],"[285, 726, 837, 842, 892, 1686, 1871, 2377, 2504, 2961, 3199, 3338, 3497, 3794]",[1096],3891,15,3876,1,14,3876,0
3.5,XELCRYB,"[162, 170, 196, 582, 592, 605, 706, 911, 945, 1326, 1500]","[706, 1326]","[162, 170, 196, 582, 592, 605, 911, 945, 1500]","[706, 1326]",2049,11,2038,2,9,2038,0
3.5,XELHBBC,"[263, 678, 715, 1418, 1832, 1844]","[263, 678]","[715, 1418, 1832, 1844]","[263, 678]",1981,6,1975,2,4,1975,0
3.5,XLACTA,"[553, 1260, 1349, 2591, 3197, 3422, 3556, 3815, 3868, 3913, 3994, 4138, 4592, 4667, 4845, 4946, 4961, 5012, 5128, 5338, 5509, 5898]","[2591, 3868, 4138, 4845, 5128]","[553, 1260, 1349, 3197, 3422, 3556, 3815, 3913, 3994, 4592, 4667, 4946, 4961, 5012, 5338, 5509, 5898]","[2591, 3868, 4138, 4845, 5128]",5946,22,5924,5,17,5924,0
3.5,XLACTCAG,"[831, 855, 1201, 1338, 1600, 1605, 1638, 2094, 2398, 2473, 3023, 3128, 3298, 3302, 3353, 3386, 3561, 3591, 3614, 4364, 4412, 4769, 4787, 4931, 5493, 5562, 6279, 6294, 6355, 6461, 7511, 7853, 8347, 8410, 8892]","[2473, 3614, 4931, 5562, 6461]","[831, 855, 1201, 1338, 1600, 1605, 1638, 2094, 2398, 3023, 3128, 3298, 3302, 3353, 3386, 3561, 3591, 4364, 4412, 4769, 4787, 5493, 6279, 6294, 6355, 7511, 7853, 8347, 8410, 8892]","[2473, 3614, 4931, 5562, 6461]",8900,35,8865,5,30,8865,0
3.5,XLBGL3,"[388, 1040, 1175, 1851, 2443, 2638]","[388, 1175]","[1040, 1851, 2443, 2638]","[388, 1175]",2964,6,2958,2,4,2958,0
3.5,XLGLAA1,"[137, 502, 559, 590, 659]","[137, 502]","[559, 590, 659]","[137, 502]",1192,5,1187,2,3,1187,0
3.5,XLGLAA2,"[138, 248, 519, 586, 601, 1163]","[138, 519]","[248, 586, 601, 1163]","[138, 519]",1192,6,1186,2,4,1186,0
3.5,XLK81A1G,"[1517, 1618, 1671, 2294, 2369, 2734, 2900, 3026, 3145, 3240, 3388, 3409, 3531, 3647, 3849, 4127, 4170, 4425, 4769, 5223, 5318, 5672]","[2294, 2734, 3026, 3531, 3849, 4170]","[1517, 1618, 1671, 2369, 2900, 3145, 3240, 3388, 3409, 3647, 4127, 4425, 4769, 5223, 5318, 5672]","[1759, 2294, 2734, 3026, 3531, 3849, 4170]",5892,22,5870,6,16,5869,1
3.5,XLRPL14,"[377, 709, 912, 1292, 1499, 1601, 1605, 1837, 2087, 2140, 2145, 2560, 2624, 2713, 3051, 3085, 3651, 3897, 4037, 4978, 5232, 5287, 5356, 5856, 6146, 6485, 6804, 7158, 7239, 7618, 7840, 7904, 8659, 9072, 9108]","[912, 2087, 4978, 5356, 7904]","[377, 709, 1292, 1499, 1601, 1605, 1837, 2140, 2145, 2560, 2624, 2713, 3051, 3085, 3651, 3897, 4037, 5232, 5287, 5856, 6146, 6485, 6804, 7158, 7239, 7618, 7840, 8659, 9072, 9108]","[912, 1891, 2087, 4978, 5356, 7904]",9116,35,9081,5,30,9080,1
3.5,XLRPL1AG,"[308, 339, 503, 512, 634, 1078, 1597, 2105, 2121, 2390, 2638, 2695, 2818, 2964, 3137, 3717, 3735, 3831, 3844, 4013, 4433, 4533, 4573, 4994, 5179, 5232, 5303, 5643, 5757, 5825, 5916, 5925, 6206, 6451]","[512, 2121, 2818, 3137, 3831, 4573, 5179, 5757]","[308, 339, 503, 634, 1078, 1597, 2105, 2390, 2638, 2695, 2964, 3717, 3735, 3844, 4013, 4433, 4533, 4994, 5232, 5303, 5643, 5825, 5916, 5925, 6206, 6451]","[512, 2121, 2438, 2818, 3137, 3831, 4573, 5179, 5757]",6949,34,6915,8,26,6914,1
3.5,XLS8,"[164, 692, 804, 1006, 1530, 1867, 1874, 2032, 2326, 2865, 2893, 3505, 3938, 3957, 3963, 4181, 4498, 4856, 5432, 5708, 5849, 5912, 6119, 6325, 6381, 6468, 6931, 7181, 7381, 8071, 8411, 8508, 8542, 9259, 9325, 9832, 9886, 10366, 10822, 12265, 12388, 12527, 12978, 13088, 13107, 13234]","[2032, 3938, 5912, 7381]","[164, 692, 804, 1006, 1530, 1867, 1874, 2326, 2865, 2893, 3505, 3957, 3963, 4181, 4498, 4856, 5432, 5708, 5849, 6119, 6325, 6381, 6468, 6931, 7181, 8071, 8411, 8508, 8542, 9259, 9325, 9832, 9886, 10366, 10822, 12265, 12388, 12527, 12978, 13088, 13107, 13234]","[2032, 3938, 5912, 7381, 12177]",13512,46,13466,4,42,13465,1
3.5,XLTUBAG,"[272, 591, 595, 678, 1023, 1030, 1280, 1323, 1541, 1555, 1613, 1680, 1885, 2006, 2020, 2440, 2610, 2870, 3080, 3094, 3268, 3684, 4024, 4179, 4224, 4401, 4775, 4898, 5039, 5214, 5431, 5575, 6312, 6494, 6577, 6604, 6612, 6618, 6630, 6686]","[678, 4401, 5575]","[272, 591, 595, 1023, 1030, 1280, 1323, 1541, 1555, 1613, 1680, 1885, 2006, 2020, 2440, 2610, 2870, 3080, 3094, 3268, 3684, 4024, 4179, 4224, 4775, 4898, 5039, 5214, 5431, 6312, 6494, 6577, 6604, 6612, 6618, 6630, 6686]","[678, 4401, 5575]",6888,40,6848,3,37,6848,0
3.5,XLXANF1A,"[1460, 1789, 1960, 2204, 2647, 2706, 4595, 4631]","[1460, 1960, 2706]","[1789, 2204, 2647, 4595, 4631]","[1460, 1960, 2706]",4878,8,4870,3,5,4870,0
3.5,XTGLA,"[235, 286, 419, 731, 1323, 1752, 2034, 2283, 2838, 2861, 3340, 3493, 4013, 4344, 4437]","[731, 2838]","[235, 286, 419, 1323, 1752, 2034, 2283, 2861, 3340, 3493, 4013, 4344, 4437]","[731, 2838]",4838,15,4823,2,13,4823,0
3.5,XTGLAA,"[416, 541, 1036, 1156, 1411, 1493]","[1036, 1411]","[416, 541, 1156, 1493]","[1036, 1411]",1992,6,1986,2,4,1986,0
3.5,XTGLB,"[21, 169, 212, 389, 1398, 1823, 2384, 2643, 2836, 3061, 3539, 4034]","[2384, 2836]","[21, 169, 212, 389, 1398, 1823, 2643, 3061, 3539, 4034]","[2384, 2836]",4043,12,4031,2,10,4031,0
3.5,ZEFB2MICB,"[304, 1187, 1323, 1345]","[304, 1187]","[1323, 1345]","[304, 1187]",2193,4,2189,2,2,2189,0
