Threshold,Locus,Predict Sites,Positive Sites,Negative Sites,Actual Donor Sites,Predict Num,Predict Positive Num,Predict Negative Num,TP,FP,TN,FN
2.5,ACU08131,"[70, 158, 322, 387, 463, 642, 710, 845, 925, 1024, 1230, 1255, 1363, 1437, 1603, 1735, 1994, 2025, 2029, 2079, 2104, 2179, 2212, 2245, 2350, 2498, 2537, 2598, 2637, 2803, 2840, 2986, 3032, 3042, 3336, 3798, 3914, 4038, 4167, 4306, 4452, 4504, 4512, 5170, 5176, 5313, 5324, 5345]","[642, 1363, 2029, 2803, 3798]","[70, 158, 322, 387, 463, 710, 845, 925, 1024, 1230, 1255, 1437, 1603, 1735, 1994, 2025, 2079, 2104, 2179, 2212, 2245, 2350, 2498, 2537, 2598, 2637, 2840, 2986, 3032, 3042, 3336, 3914, 4038, 4167, 4306, 4452, 4504, 4512, 5170, 5176, 5313, 5324, 5345]","[642, 1363, 2029, 2803, 3798]",5384,48,5336,5,43,5336,0
2.5,AGGGLINE,"[32, 70, 80, 805, 812, 869, 935, 1082, 1466, 1571, 1605, 2325, 2347, 2658, 2685, 2697, 2946, 2963, 3120, 3158, 3168, 3390, 3457, 3504, 3600, 3673, 3850, 4035, 4088, 4094, 4098, 4253, 4309, 4313, 4411, 4456, 4611, 4651, 4685, 4720, 4756, 4849, 5175, 5187, 5228, 5259, 5307, 5357, 5585, 5592, 5648, 5864, 6176, 6262, 6277, 6387, 6421, 6780, 6980, 6984, 7054, 7300]","[3158, 3504]","[32, 70, 80, 805, 812, 869, 935, 1082, 1466, 1571, 1605, 2325, 2347, 2658, 2685, 2697, 2946, 2963, 3120, 3168, 3390, 3457, 3600, 3673, 3850, 4035, 4088, 4094, 4098, 4253, 4309, 4313, 4411, 4456, 4611, 4651, 4685, 4720, 4756, 4849, 5175, 5187, 5228, 5259, 5307, 5357, 5585, 5592, 5648, 5864, 6176, 6262, 6277, 6387, 6421, 6780, 6980, 6984, 7054, 7300]","[3158, 3504]",7220,62,7158,2,60,7158,0
2.5,AGU04852,"[40, 86, 174, 183, 348, 491, 536, 631, 653, 734, 1104, 1142, 1232, 1464, 1652, 2073, 2117, 2302, 2478, 2482, 2624, 2784, 2917, 2972, 3022, 3038, 3116, 3133, 3176, 3211, 3402, 3404, 3693, 3701, 3732, 3788, 3877, 3956, 4342, 4566, 4701, 4780, 4788, 4800, 4809, 4863, 4906, 5066, 5252, 5350, 5517, 5529, 5533, 5876, 5912, 6203, 6224, 6383, 6731, 6740, 6883, 7105, 7128, 7509, 7636, 7669, 7927, 7960, 8026, 8085, 8122, 8229, 8252, 8301, 8349, 8354, 8358, 8635, 8694, 8817, 8877, 8934, 8961, 9083, 9261, 9622, 9856, 10029, 10753, 10812, 10820, 10937, 10961]","[3956, 5517, 5912, 6740]","[40, 86, 174, 183, 348, 491, 536, 631, 653, 734, 1104, 1142, 1232, 1464, 1652, 2073, 2117, 2302, 2478, 2482, 2624, 2784, 2917, 2972, 3022, 3038, 3116, 3133, 3176, 3211, 3402, 3404, 3693, 3701, 3732, 3788, 3877, 4342, 4566, 4701, 4780, 4788, 4800, 4809, 4863, 4906, 5066, 5252, 5350, 5529, 5533, 5876, 6203, 6224, 6383, 6731, 6883, 7105, 7128, 7509, 7636, 7669, 7927, 7960, 8026, 8085, 8122, 8229, 8252, 8301, 8349, 8354, 8358, 8635, 8694, 8817, 8877, 8934, 8961, 9083, 9261, 9622, 9856, 10029, 10753, 10812, 10820, 10937, 10961]","[3956, 5517, 5912, 6740]",10976,93,10883,4,89,10883,0
2.5,ALOEGLOBIM,"[21, 221, 237, 271, 469, 536, 583, 599, 1043, 1049, 1154, 1170, 1176, 1182, 1200, 1250, 1297, 1399, 1404, 1410, 1455, 1511]","[237, 583]","[21, 221, 271, 469, 536, 599, 1043, 1049, 1154, 1170, 1176, 1182, 1200, 1250, 1297, 1399, 1404, 1410, 1455, 1511]","[237, 583]",1683,22,1661,2,20,1661,0
2.5,ALOEGLOBIN,"[221, 237, 271, 469, 536, 583, 599, 1043, 1049, 1154, 1170, 1176, 1182, 1200, 1250, 1297, 1399, 1404, 1410, 1455, 1511]","[237, 583]","[221, 271, 469, 536, 599, 1043, 1049, 1154, 1170, 1176, 1182, 1200, 1250, 1297, 1399, 1404, 1410, 1455, 1511]","[237, 583]",1683,21,1662,2,19,1662,0
2.5,ALOPROTP1A,"[7, 59, 166, 170, 186, 267]",[166],"[7, 59, 170, 186, 267]",[166],410,6,404,1,5,404,0
2.5,AMU12024,"[85, 257, 534, 632, 667, 872, 1125, 1583, 1594, 1695, 1797, 1864, 1960, 2013, 2126, 2482, 2605, 2685, 2801, 3332, 3458, 3606]","[257, 667, 1864, 2126, 2482]","[85, 534, 632, 872, 1125, 1583, 1594, 1695, 1797, 1960, 2013, 2605, 2685, 2801, 3332, 3458, 3606]","[257, 667, 1864, 2126, 2482]",3644,22,3622,5,17,3622,0
2.5,AMU12025,"[205, 271, 301, 321, 527, 529, 859, 1049, 1080, 1143, 1412, 1640, 1697, 1830, 2010, 2250, 2359, 2485, 2554, 2654, 2689, 2705, 2736, 2789, 2902, 3278, 3313, 3343, 3649, 4481, 4541]","[1412, 1830, 2654, 2902, 3278]","[205, 271, 301, 321, 527, 529, 859, 1049, 1080, 1143, 1640, 1697, 2010, 2250, 2359, 2485, 2554, 2689, 2705, 2736, 2789, 3313, 3343, 3649, 4481, 4541]","[1412, 1830, 2654, 2902, 3278]",5375,31,5344,5,26,5344,0
2.5,AOIRHODOPS,"[44, 141, 255, 620, 894, 1115, 1314, 1393, 1702, 1749, 1925, 1953, 1969, 2025, 2754, 2812, 2855, 2949, 3012, 3488, 4005, 4067, 4109, 4336, 4385, 4391, 4430, 4479, 4598, 4840, 4933, 4953, 5014, 5116, 5207, 5373, 5426, 5452, 5483, 5494, 5601, 5716, 5796, 5892, 6243, 6372, 6400, 6806, 7039, 7056, 7095, 7481, 7580, 7600, 7614, 7622, 7630, 7800, 8003, 8156, 8197, 8308, 8614, 8837, 8863, 9057, 9133, 9304, 9371, 9410]","[1702, 4067, 5373, 6243]","[44, 141, 255, 620, 894, 1115, 1314, 1393, 1749, 1925, 1953, 1969, 2025, 2754, 2812, 2855, 2949, 3012, 3488, 4005, 4109, 4336, 4385, 4391, 4430, 4479, 4598, 4840, 4933, 4953, 5014, 5116, 5207, 5426, 5452, 5483, 5494, 5601, 5716, 5796, 5892, 6372, 6400, 6806, 7039, 7056, 7095, 7481, 7580, 7600, 7614, 7622, 7630, 7800, 8003, 8156, 8197, 8308, 8614, 8837, 8863, 9057, 9133, 9304, 9371, 9410]","[1702, 4067, 5373, 6243]",9915,70,9845,4,66,9845,0
2.5,ASPROP2,"[75, 120, 325, 589]",[325],"[75, 120, 589]",[325],664,4,660,1,3,660,0
2.5,ASYRVISP,"[99, 260, 625, 634, 656, 909, 1007, 1042, 1166, 1240, 1305, 1335, 1419, 1569, 1585, 1916, 1968, 2021, 2051]","[625, 1042, 1335, 1585, 1916]","[99, 260, 634, 656, 909, 1007, 1166, 1240, 1305, 1419, 1569, 1968, 2021, 2051]","[625, 1042, 1335, 1585, 1916]",2221,19,2202,5,14,2202,0
2.5,ATREGLOBIN,"[221, 237, 271, 474, 541, 588, 604, 1058, 1187, 1193, 1217, 1267, 1295, 1314, 1407, 1412, 1418, 1463, 1519]","[237, 588]","[221, 271, 474, 541, 604, 1058, 1187, 1193, 1217, 1267, 1295, 1314, 1407, 1412, 1418, 1463, 1519]","[237, 588]",1691,19,1672,2,17,1672,0
2.5,BABAPOE,"[33, 60, 146, 198, 267, 272, 408, 481, 486, 501, 550, 688, 754, 897, 1003, 1029, 1080, 1374, 1702, 1746, 1953, 1985, 2109, 2144, 2262, 2312, 2468, 2668, 2680, 2803, 2847, 2881, 3537, 3615, 3648, 3852, 3916, 3978, 3990, 3999, 4131, 4288]","[897, 2847]","[33, 60, 146, 198, 267, 272, 408, 481, 486, 501, 550, 688, 754, 1003, 1029, 1080, 1374, 1702, 1746, 1953, 1985, 2109, 2144, 2262, 2312, 2468, 2668, 2680, 2803, 2881, 3537, 3615, 3648, 3852, 3916, 3978, 3990, 3999, 4131, 4288]","[897, 2847]",4754,42,4712,2,40,4712,0
2.5,BATROX,"[222, 237, 292, 341, 769, 875, 1839, 1903, 1944, 2032, 2078, 2307, 2428, 2446, 2450, 2471, 2890, 2948, 2959, 3011, 3183, 3556, 3593, 3638, 3849, 3878, 3924, 3967, 3975, 3979, 4044, 4110, 4276, 4495, 4681, 4705, 4798, 4836, 5035, 5085, 5123, 5204, 5705, 5790, 6111, 6329, 6360, 6449, 6775, 6789, 6874, 6923, 6950, 6955, 7120, 7262, 7297, 7378, 7567, 7655, 7660, 7889, 7980, 7992]","[341, 3011, 5035, 6955]","[222, 237, 292, 769, 875, 1839, 1903, 1944, 2032, 2078, 2307, 2428, 2446, 2450, 2471, 2890, 2948, 2959, 3183, 3556, 3593, 3638, 3849, 3878, 3924, 3967, 3975, 3979, 4044, 4110, 4276, 4495, 4681, 4705, 4798, 4836, 5085, 5123, 5204, 5705, 5790, 6111, 6329, 6360, 6449, 6775, 6789, 6874, 6923, 6950, 7120, 7262, 7297, 7378, 7567, 7655, 7660, 7889, 7980, 7992]","[341, 3011, 5035, 6955]",8092,64,8028,4,60,8028,0
2.5,BCHEGLOBIN,"[221, 237, 271, 469, 536, 583, 599, 1054, 1060, 1166, 1184, 1190, 1196, 1214, 1264, 1311, 1412, 1417, 1423, 1468, 1524]","[237, 583]","[221, 271, 469, 536, 599, 1054, 1060, 1166, 1184, 1190, 1196, 1214, 1264, 1311, 1412, 1417, 1423, 1468, 1524]","[237, 583]",1697,21,1676,2,19,1676,0
2.5,BOVANPA,"[334, 393, 433, 598, 858, 1299, 1677, 1687]","[433, 858]","[334, 393, 598, 1299, 1677, 1687]","[433, 858]",1761,8,1753,2,6,1753,0
2.5,BOVCOX7AL,"[16, 263, 295, 322, 469, 679, 683, 694, 936, 956, 1056, 1461, 1484, 1497, 1501, 1540, 1570, 1596, 1733, 1826, 1924, 1954, 2108, 2141, 2351, 2432, 2470, 2630, 2812, 2867, 2874, 3003, 3047, 3328, 3627, 3721, 3969, 4284, 4555, 4648, 4866, 4995, 5049, 5488, 5521, 5699, 5934, 6089, 6167, 6500, 6648]","[1540, 2812, 5049]","[16, 263, 295, 322, 469, 679, 683, 694, 936, 956, 1056, 1461, 1484, 1497, 1501, 1570, 1596, 1733, 1826, 1924, 1954, 2108, 2141, 2351, 2432, 2470, 2630, 2867, 2874, 3003, 3047, 3328, 3627, 3721, 3969, 4284, 4555, 4648, 4866, 4995, 5488, 5521, 5699, 5934, 6089, 6167, 6500, 6648]","[1540, 2812, 5049]",6848,51,6797,3,48,6797,0
2.5,BOVGAS,"[192, 406, 751, 806, 996]",[751],"[192, 406, 806, 996]",[751],1058,5,1053,1,4,1053,0
2.5,BOVIAP,"[174, 194, 320, 437, 457, 533, 602, 916, 926, 1080, 1116, 1318, 1568, 1764, 1835, 1895, 1994, 2033, 2057, 2107, 2159, 2200, 2269, 2309, 2354, 2450, 2504, 2518, 2606, 2643, 2646, 2670, 2674, 2725, 2734, 2749, 2756, 2784, 2793, 2804, 2864, 2999, 3024, 3092, 3157, 3352, 3392, 3420, 3440, 3535, 3667, 3782, 3844, 3879, 3996, 4009, 4024, 4731, 5007, 5074, 5136, 5241, 5262, 5290]","[1568, 1764, 1994, 2354, 2606, 2999, 3157, 3392, 3667, 3996]","[174, 194, 320, 437, 457, 533, 602, 916, 926, 1080, 1116, 1318, 1835, 1895, 2033, 2057, 2107, 2159, 2200, 2269, 2309, 2450, 2504, 2518, 2643, 2646, 2670, 2674, 2725, 2734, 2749, 2756, 2784, 2793, 2804, 2864, 3024, 3092, 3352, 3420, 3440, 3535, 3782, 3844, 3879, 4009, 4024, 4731, 5007, 5074, 5136, 5241, 5262, 5290]","[1568, 1764, 1994, 2354, 2606, 2999, 3157, 3392, 3667, 3996]",5391,64,5327,10,54,5327,0
2.5,BOVIRBP,"[129, 552, 888, 936, 994, 1284, 1434, 1482, 1509, 1584, 1629, 1812, 1896, 1948, 2004, 2331, 2388, 2421, 2586, 2649, 2769, 2928, 3042, 3090, 3174, 3723, 3773, 3801, 3895, 4136, 4176, 4189, 4212, 4571, 4582, 4806, 4970, 4983, 5048, 5349, 5507, 5595, 5643, 5761, 5857, 5876, 6214, 6271, 6292, 6494, 6540, 6779, 7019, 7126, 7206, 7416, 7514, 7669, 7699, 7773, 7957, 8915, 8920, 8937, 9058, 9146, 9190, 9214, 9309, 9426, 9435, 9775, 9959, 10082, 10191, 10443, 10749, 10841, 10914, 10997, 11020, 11326, 11500, 11753]","[3174, 5595, 7699]","[129, 552, 888, 936, 994, 1284, 1434, 1482, 1509, 1584, 1629, 1812, 1896, 1948, 2004, 2331, 2388, 2421, 2586, 2649, 2769, 2928, 3042, 3090, 3723, 3773, 3801, 3895, 4136, 4176, 4189, 4212, 4571, 4582, 4806, 4970, 4983, 5048, 5349, 5507, 5643, 5761, 5857, 5876, 6214, 6271, 6292, 6494, 6540, 6779, 7019, 7126, 7206, 7416, 7514, 7669, 7773, 7957, 8915, 8920, 8937, 9058, 9146, 9190, 9214, 9309, 9426, 9435, 9775, 9959, 10082, 10191, 10443, 10749, 10841, 10914, 10997, 11020, 11326, 11500, 11753]","[3174, 5595, 7699]",11785,84,11701,3,81,11701,0
2.5,BOVLHB,"[233, 244, 419, 592, 615, 749, 761, 803, 875, 914, 944, 1005, 1057, 1062, 1272, 1294, 1401, 1460, 1526, 1562]","[803, 1272]","[233, 244, 419, 592, 615, 749, 761, 875, 914, 944, 1005, 1057, 1062, 1294, 1401, 1460, 1526, 1562]","[803, 1272]",1856,20,1836,2,18,1836,0
2.5,BOVLYSOZMA,"[70, 322, 397, 944, 1707, 2057, 2089, 2115, 2263, 2268, 2374, 2402, 2758, 2819, 2872, 2973, 3039, 3078, 3208, 3255, 3424, 3672, 3767, 4066, 4100, 4163, 4245, 4290, 4314, 4372, 4417, 4694, 5256, 5771, 5936, 5955, 6103, 6433, 6864, 6932, 6973, 7196, 7212, 7260, 7327, 7512, 7741, 7928, 8112, 8632, 8654, 8685, 8811, 9056, 9247, 9304, 9327, 9453, 9603, 9943, 10024, 10062, 10409, 10777, 10799, 11050, 11525, 11634]","[3039, 5771, 8654]","[70, 322, 397, 944, 1707, 2057, 2089, 2115, 2263, 2268, 2374, 2402, 2758, 2819, 2872, 2973, 3078, 3208, 3255, 3424, 3672, 3767, 4066, 4100, 4163, 4245, 4290, 4314, 4372, 4417, 4694, 5256, 5936, 5955, 6103, 6433, 6864, 6932, 6973, 7196, 7212, 7260, 7327, 7512, 7741, 7928, 8112, 8632, 8685, 8811, 9056, 9247, 9304, 9327, 9453, 9603, 9943, 10024, 10062, 10409, 10777, 10799, 11050, 11525, 11634]","[3039, 5771, 8654]",12214,68,12146,3,65,12146,0
2.5,BOVLYSOZMB,"[35, 90, 140, 215, 461, 646, 696, 739, 834, 941, 1229, 1253, 1432, 1662, 1885, 1890, 1993, 2023, 2346, 2453, 2506, 2607, 2673, 2843, 2902, 2907, 3007, 3414, 3717, 3743, 4005, 4056, 4135, 4675, 4797, 5148, 5241, 5478, 5594, 5708, 5732, 5934, 6190, 6212, 6301, 6344, 6557, 6683, 6722, 6807, 6895, 6917, 6928, 7058, 7118, 7511, 7862, 8185, 8354, 8610, 8728, 9580, 9662, 9897, 9958, 9988, 10002, 10007, 10198]","[2673, 4005, 6212]","[35, 90, 140, 215, 461, 646, 696, 739, 834, 941, 1229, 1253, 1432, 1662, 1885, 1890, 1993, 2023, 2346, 2453, 2506, 2607, 2843, 2902, 2907, 3007, 3414, 3717, 3743, 4056, 4135, 4675, 4797, 5148, 5241, 5478, 5594, 5708, 5732, 5934, 6190, 6301, 6344, 6557, 6683, 6722, 6807, 6895, 6917, 6928, 7058, 7118, 7511, 7862, 8185, 8354, 8610, 8728, 9580, 9662, 9897, 9958, 9988, 10002, 10007, 10198]","[2673, 4005, 6212]",10204,69,10135,3,66,10135,0
2.5,BOVLYSOZMC,"[304, 685, 738, 839, 905, 1086, 1274, 1279, 1498, 2107, 2323, 2503, 2637, 2826, 2933, 3292, 3388, 3652, 3749, 3910, 4147, 4172, 4194, 4462, 4508, 4801, 4908, 4941, 4964, 5321, 5325, 5429, 6235, 6245, 6302, 6532, 6620, 7479]","[905, 2323, 4194]","[304, 685, 738, 839, 1086, 1274, 1279, 1498, 2107, 2503, 2637, 2826, 2933, 3292, 3388, 3652, 3749, 3910, 4147, 4172, 4462, 4508, 4801, 4908, 4941, 4964, 5321, 5325, 5429, 6235, 6245, 6302, 6532, 6620, 7479]","[905, 2323, 4194]",8043,38,8005,3,35,8005,0
2.5,BOVMYF5A,"[273, 359, 403, 557, 620, 698, 770, 827, 1095, 1398, 1433, 1446, 1463, 1625, 1824, 1852, 1952, 1955, 2273, 2483, 2815, 2895, 2918, 3085, 3107, 3199, 3272, 3338, 3947, 4171, 4204, 4326, 4335, 4402, 4412, 4537, 4583, 4629, 4829, 4851, 5000]","[698, 1625]","[273, 359, 403, 557, 620, 770, 827, 1095, 1398, 1433, 1446, 1463, 1824, 1852, 1952, 1955, 2273, 2483, 2815, 2895, 2918, 3085, 3107, 3199, 3272, 3338, 3947, 4171, 4204, 4326, 4335, 4402, 4412, 4537, 4583, 4629, 4829, 4851, 5000]","[698, 1625]",5211,41,5170,2,39,5170,0
2.5,BRHOX22,"[530, 542, 574, 600, 623, 791, 824, 835, 843, 1122, 1425, 1431, 1590, 1815, 2301, 2493, 2572, 2851, 3018, 3039, 3122, 3304]",[1431],"[530, 542, 574, 600, 623, 791, 824, 835, 843, 1122, 1425, 1590, 1815, 2301, 2493, 2572, 2851, 3018, 3039, 3122, 3304]",[1431],3434,22,3412,1,21,3412,0
2.5,BRHOX34A,"[60, 64, 246, 460, 475, 588, 613, 764, 778, 981, 1190, 1248, 1359, 1751, 1791, 1819, 2191, 2217, 2313, 2441, 2510, 2675, 2903, 2963, 3339, 3491]",[981],"[60, 64, 246, 460, 475, 588, 613, 764, 778, 1190, 1248, 1359, 1751, 1791, 1819, 2191, 2217, 2313, 2441, 2510, 2675, 2903, 2963, 3339, 3491]",[981],3490,26,3464,1,25,3464,0
2.5,BRU12895,"[674, 793, 799, 1135, 1526, 1612, 1616, 1620, 1630, 1644, 1651, 1986, 1998, 2140, 2232, 2341, 2392, 2827, 3045]",[1135],"[674, 793, 799, 1526, 1612, 1616, 1620, 1630, 1644, 1651, 1986, 1998, 2140, 2232, 2341, 2392, 2827, 3045]",[1135],3232,19,3213,1,18,3213,0
2.5,BTATPAAA,"[55, 296, 565, 580, 628, 740, 826, 908, 1111, 1146, 1160, 1166, 1200, 1229, 2314, 2377, 2501, 2615, 2702, 2761, 2777, 2838, 2912, 2987, 3383, 3630, 3636, 3647, 3683, 3707, 3951, 4106, 4183, 4188, 4236, 4249, 4280, 4511, 4537, 4650, 4854, 5021, 5210, 5345, 5350, 5427, 5492, 5556, 5709, 5729, 5886, 5953, 5984, 6109, 6155, 6315, 6337, 6472, 6865, 6922, 6975, 6990, 7098, 7151, 7185, 7325, 7445, 7693, 7770, 7878, 7885, 7915, 8023, 8311, 8394, 8556, 8748, 8831, 9129, 9158, 9211, 9527, 9733, 9844]","[740, 2314, 3707, 5729, 5984, 6337, 7151, 7770, 8023, 9129]","[55, 296, 565, 580, 628, 826, 908, 1111, 1146, 1160, 1166, 1200, 1229, 2377, 2501, 2615, 2702, 2761, 2777, 2838, 2912, 2987, 3383, 3630, 3636, 3647, 3683, 3951, 4106, 4183, 4188, 4236, 4249, 4280, 4511, 4537, 4650, 4854, 5021, 5210, 5345, 5350, 5427, 5492, 5556, 5709, 5886, 5953, 6109, 6155, 6315, 6472, 6865, 6922, 6975, 6990, 7098, 7185, 7325, 7445, 7693, 7878, 7885, 7915, 8311, 8394, 8556, 8748, 8831, 9158, 9211, 9527, 9733, 9844]","[740, 2314, 3707, 5729, 5984, 6337, 6827, 7151, 7770, 8023, 9129]",9907,84,9823,10,74,9822,1
2.5,BTEBGL2,"[201, 294, 310, 327, 414, 482, 611, 658, 766, 920, 1129, 1171, 1254, 1620]","[310, 658]","[201, 294, 327, 414, 482, 611, 766, 920, 1129, 1171, 1254, 1620]","[310, 658]",1833,14,1819,2,12,1819,0
2.5,BTEBGL4,"[4, 201, 294, 310, 327, 482, 544, 611, 658, 763, 815, 1128, 1617]","[310, 658]","[4, 201, 294, 327, 482, 544, 611, 763, 815, 1128, 1617]","[310, 658]",1828,13,1815,2,11,1815,0
2.5,BTGL01,"[72, 98, 176, 327, 349, 365, 389, 503, 549, 711, 873, 894, 910, 961, 1008, 1439, 1671, 1681]","[365, 1008]","[72, 98, 176, 327, 349, 389, 503, 549, 711, 873, 894, 910, 961, 1439, 1671, 1681]","[365, 1008]",2040,18,2022,2,16,2022,0
2.5,BTHOR02,"[16, 169, 484, 939, 957, 975, 1123, 1230, 1268, 1357, 1920, 1936, 2130, 2345]","[484, 1920]","[16, 169, 939, 957, 975, 1123, 1230, 1268, 1357, 1936, 2130, 2345]","[484, 1920]",2419,14,2405,2,12,2405,0
2.5,BTKER6B,"[198, 554, 826, 938, 1008, 1074, 1160, 1331, 1355, 1593, 1602, 1678, 1820, 1830, 1836, 1865, 1925, 2044, 2171, 2219, 2300, 2346, 2559, 2618, 2798, 2913, 2926, 3070, 3184, 3315, 3530, 3626, 4056, 4192, 4335, 4666, 4906, 5029, 5142, 5608, 5686]","[1678, 2559, 3070, 3315, 3530, 4056, 4666]","[198, 554, 826, 938, 1008, 1074, 1160, 1331, 1355, 1593, 1602, 1820, 1830, 1836, 1865, 1925, 2044, 2171, 2219, 2300, 2346, 2618, 2798, 2913, 2926, 3184, 3626, 4192, 4335, 4906, 5029, 5142, 5608, 5686]","[1678, 2559, 3070, 3315, 3530, 4056, 4666]",5718,41,5677,7,34,5677,0
2.5,BTSPDNA,"[84, 177, 201, 333, 643, 648, 685, 744, 960, 1054, 1155, 1221, 1541, 1546, 1554, 1563, 1682, 1713, 1876, 2123]",[1541],"[84, 177, 201, 333, 643, 648, 685, 744, 960, 1054, 1155, 1221, 1546, 1554, 1563, 1682, 1713, 1876, 2123]",[1541],2148,20,2128,1,19,2128,0
2.5,BTSVSP109,"[52, 74, 321, 353, 554, 799, 826, 983, 1122, 1357, 1452, 1604, 2189, 2258, 2359, 2387, 2555, 2648, 2834, 2853, 2863, 2922, 3457, 3573, 3984, 4068, 4199, 4248, 4348, 4469, 4515, 4675, 4688, 5056, 5292, 5315, 5388, 5411, 5517, 5643, 5667, 5767, 6016, 6096, 6115, 6131, 6164, 6200, 6240, 6451, 6730]","[2359, 3984, 5292]","[52, 74, 321, 353, 554, 799, 826, 983, 1122, 1357, 1452, 1604, 2189, 2258, 2387, 2555, 2648, 2834, 2853, 2863, 2922, 3457, 3573, 4068, 4199, 4248, 4348, 4469, 4515, 4675, 4688, 5056, 5315, 5388, 5411, 5517, 5643, 5667, 5767, 6016, 6096, 6115, 6131, 6164, 6200, 6240, 6451, 6730]","[2359, 3984, 5292]",6948,51,6897,3,48,6897,0
2.5,BTTNP2G,"[24, 125, 710, 728, 774, 847, 852, 1029, 1115, 1210, 1326, 1342, 1716]",[774],"[24, 125, 710, 728, 847, 852, 1029, 1115, 1210, 1326, 1342, 1716]",[774],1841,13,1828,1,12,1828,0
2.5,BTU02285,"[21, 248, 434, 461, 516, 914, 996, 1139, 1238, 1445, 1476, 1584, 1620, 1633, 1788, 1858, 2118, 2131, 2137, 2334, 2341, 2347, 2367, 2438, 2481, 2825, 2855, 2873, 2888, 2936, 2980, 3100, 3112, 3388, 3418, 3717, 3792, 3866, 3906, 3977, 4169, 4222, 4325, 4487, 4711, 4780, 4950, 4986, 5056, 5087, 5240, 5530, 5654, 5943, 6024, 6075, 6100]","[3792, 4222, 4487, 4780, 5056]","[21, 248, 434, 461, 516, 914, 996, 1139, 1238, 1445, 1476, 1584, 1620, 1633, 1788, 1858, 2118, 2131, 2137, 2334, 2341, 2347, 2367, 2438, 2481, 2825, 2855, 2873, 2888, 2936, 2980, 3100, 3112, 3388, 3418, 3717, 3866, 3906, 3977, 4169, 4325, 4711, 4950, 4986, 5087, 5240, 5530, 5654, 5943, 6024, 6075, 6100]","[3792, 4222, 4487, 4780, 5056]",6388,57,6331,5,52,6331,0
2.5,CALEGLOBIM,"[220, 236, 270, 345, 473, 540, 587, 603, 1062, 1167, 1185, 1191, 1197, 1215, 1265, 1293, 1312, 1406, 1518]","[236, 587]","[220, 270, 345, 473, 540, 603, 1062, 1167, 1185, 1191, 1197, 1215, 1265, 1293, 1312, 1406, 1518]","[236, 587]",1690,19,1671,2,17,1671,0
2.5,CBUEGLOBIM,"[220, 236, 270, 345, 473, 540, 587, 603, 874, 1062, 1167, 1185, 1191, 1197, 1215, 1265, 1293, 1312, 1406, 1518]","[236, 587]","[220, 270, 345, 473, 540, 603, 874, 1062, 1167, 1185, 1191, 1197, 1215, 1265, 1293, 1312, 1406, 1518]","[236, 587]",1690,20,1670,2,18,1670,0
2.5,CCALAC,"[194, 203, 436, 440, 797, 899, 932, 945, 997, 1047, 1128, 1138, 1178, 1252, 1298, 1358, 1763, 1798, 1852, 1994, 2367, 2409, 2603, 2646, 2916, 2958, 2973, 3275, 3279, 3333, 3397, 3499]","[1358, 1852, 2409]","[194, 203, 436, 440, 797, 899, 932, 945, 997, 1047, 1128, 1138, 1178, 1252, 1298, 1763, 1798, 1994, 2367, 2603, 2646, 2916, 2958, 2973, 3275, 3279, 3333, 3397, 3499]","[1358, 1852, 2409]",3619,32,3587,3,29,3587,0
2.5,CCBEGLOBIM,"[221, 237, 270, 473, 540, 587, 603, 759, 1173, 1191, 1197, 1203, 1221, 1271, 1318, 1414, 1419, 1425, 1470, 1526]","[237, 587]","[221, 270, 473, 540, 603, 759, 1173, 1191, 1197, 1203, 1221, 1271, 1318, 1414, 1419, 1425, 1470, 1526]","[237, 587]",1695,20,1675,2,18,1675,0
2.5,CCBEGLOBIN,"[222, 238, 272, 475, 542, 589, 605, 761, 1064, 1070, 1176, 1194, 1200, 1206, 1224, 1274, 1321, 1417, 1422, 1428, 1473, 1529]","[238, 589]","[222, 272, 475, 542, 605, 761, 1064, 1070, 1176, 1194, 1200, 1206, 1224, 1274, 1321, 1417, 1422, 1428, 1473, 1529]","[238, 589]",1698,22,1676,2,20,1676,0
2.5,CCGHG,"[283, 497, 592, 706, 863, 1051, 1281, 1389, 1709, 1778, 1818, 2305]","[283, 706, 1051, 1778]","[497, 592, 863, 1281, 1389, 1709, 1818, 2305]","[283, 706, 1051, 1778]",2830,12,2818,4,8,2818,0
2.5,CCGONBS1,"[197, 306, 317, 431, 844, 882, 1550, 1599, 1649, 1767, 1974, 2072, 2195, 2286, 2401, 2688, 3427]","[1767, 2072]","[197, 306, 317, 431, 844, 882, 1550, 1599, 1649, 1974, 2195, 2286, 2401, 2688, 3427]","[1767, 2072]",3463,17,3446,2,15,3446,0
2.5,CCGONBS2,"[192, 302, 313, 433, 632, 840, 878, 1568, 1617, 1667, 1785, 1993, 2091, 2213, 2344, 2419, 2656, 2707, 3442, 3446]","[1785, 2091]","[192, 302, 313, 433, 632, 840, 878, 1568, 1617, 1667, 1993, 2213, 2344, 2419, 2656, 2707, 3442, 3446]","[1785, 2091]",3482,20,3462,2,18,3462,0
2.5,CCGTHA1,"[26, 106, 166, 302, 390, 572, 644, 1071, 1104]","[302, 572]","[26, 106, 166, 390, 644, 1071, 1104]","[302, 572]",1144,9,1135,2,7,1135,0
2.5,CCT64CLU,"[274, 516, 563, 1060, 1176, 1467, 1644, 1664, 1688, 1705, 1721, 1781, 1822, 1873, 2667, 2757, 2761, 2766, 2993, 3005, 3120, 3496, 3833, 3893, 4429, 4436, 4510, 4514, 4518, 4565, 4572, 4577, 4600, 4643, 4836, 4891, 4930, 5065, 5272, 5337, 5401, 5528, 5534, 5659, 5874, 5939, 5962, 6019, 6121, 6277]","[1644, 2757, 3005, 3496, 4514, 5272, 5659]","[274, 516, 563, 1060, 1176, 1467, 1664, 1688, 1705, 1721, 1781, 1822, 1873, 2667, 2761, 2766, 2993, 3120, 3833, 3893, 4429, 4436, 4510, 4518, 4565, 4572, 4577, 4600, 4643, 4836, 4891, 4930, 5065, 5337, 5401, 5528, 5534, 5874, 5939, 5962, 6019, 6121, 6277]","[1644, 2757, 3005, 3496, 4514, 5272, 5659]",6276,50,6226,7,43,6226,0
2.5,CEPPINS,"[245, 464, 490, 591, 794, 858, 1106, 1218, 1399, 1408, 1424, 1441, 1445, 1487, 1509, 1513, 1517, 1615, 1760, 1878]",[858],"[245, 464, 490, 591, 794, 1106, 1218, 1399, 1408, 1424, 1441, 1445, 1487, 1509, 1513, 1517, 1615, 1760, 1878]",[858],1901,20,1881,1,19,1881,0
2.5,CHBLG,"[21, 166, 270, 484, 698, 832, 928, 932, 1284, 1395, 1425, 1465, 1472, 1479, 1556, 1638, 2052, 2301, 2308, 2472, 2564, 2672, 2807, 2950, 3030, 3090, 3149, 3207, 3390, 3640, 3788, 3794, 4019, 4122, 4235, 4266, 4298, 4302, 4357, 4700, 4861, 4919, 4939, 4985, 5029, 5246, 5306, 5349, 5416, 5461, 5573, 5619, 5756, 5846, 6025, 6094, 6131, 6255, 6269, 6280, 6323, 6336, 6376, 6520, 6535, 6539, 6555, 6629, 6907, 7208, 7222, 7577, 7664, 7846, 7918]","[3090, 4019, 5246, 6025]","[21, 166, 270, 484, 698, 832, 928, 932, 1284, 1395, 1425, 1465, 1472, 1479, 1556, 1638, 2052, 2301, 2308, 2472, 2564, 2672, 2807, 2950, 3030, 3149, 3207, 3390, 3640, 3788, 3794, 4122, 4235, 4266, 4298, 4302, 4357, 4700, 4861, 4919, 4939, 4985, 5029, 5306, 5349, 5416, 5461, 5573, 5619, 5756, 5846, 6094, 6131, 6255, 6269, 6280, 6323, 6336, 6376, 6520, 6535, 6539, 6555, 6629, 6907, 7208, 7222, 7577, 7664, 7846, 7918]","[2285, 3090, 4019, 5246, 6025]",8080,75,8005,4,71,8004,1
2.5,CHEBGLI,"[177, 456, 570, 599, 795, 844, 862, 909, 1136, 1213, 2067]","[570, 909]","[177, 456, 599, 795, 844, 862, 1136, 1213, 2067]","[570, 909]",2204,11,2193,2,9,2193,0
2.5,CHEBGLII,"[17, 152, 217, 454, 547, 563, 580, 736, 798, 912, 923, 1020, 1049, 1072, 1145, 1383, 1426, 1493, 1870, 2084, 2193, 2213]","[563, 912]","[17, 152, 217, 454, 547, 580, 736, 798, 923, 1020, 1049, 1072, 1145, 1383, 1426, 1493, 1870, 2084, 2193, 2213]","[563, 912]",2258,22,2236,2,20,2236,0
2.5,CHKALDB,"[318, 447, 535, 552, 564, 606, 657, 796, 1062, 1385, 1452, 1488, 1506, 1801, 1912, 1922, 1927, 2015, 2460, 2629, 2874, 2878, 2952, 3077, 3115, 3135, 3409, 3545, 3685, 4004, 4016, 4046, 4388, 4462, 4630, 4802, 4853, 5731, 5748, 6172, 6392, 6452, 6652, 6664, 6955, 6960, 6983, 7007, 7149, 7265, 7360, 7487, 7504, 7518, 7523, 7600, 7705, 8145, 8166, 8170, 8186, 8617, 8742, 8842, 8925, 9012, 9185, 9214, 9313, 9485, 9577, 9626, 9736, 10415, 10435, 10577, 10705, 10844, 11487]","[6172, 6664, 6955, 7265, 8186, 8842, 9185]","[318, 447, 535, 552, 564, 606, 657, 796, 1062, 1385, 1452, 1488, 1506, 1801, 1912, 1922, 1927, 2015, 2460, 2629, 2874, 2878, 2952, 3077, 3115, 3135, 3409, 3545, 3685, 4004, 4016, 4046, 4388, 4462, 4630, 4802, 4853, 5731, 5748, 6392, 6452, 6652, 6960, 6983, 7007, 7149, 7360, 7487, 7504, 7518, 7523, 7600, 7705, 8145, 8166, 8170, 8617, 8742, 8925, 9012, 9214, 9313, 9485, 9577, 9626, 9736, 10415, 10435, 10577, 10705, 10844, 11487]","[6172, 6664, 6955, 7265, 8186, 8842, 9185]",11643,79,11564,7,72,11564,0
2.5,CHKAPOII,"[64, 282, 454, 787, 917, 989, 1000, 1090, 1246, 1328, 1339, 1397, 1532, 1576, 1626, 1839, 1864, 1891, 1901, 1978, 2131, 2320, 2620, 2781, 2798, 3243, 3317, 3381, 3444, 3509, 3771, 3820, 3906, 3912, 3946, 3952, 3957, 3975, 3980, 4017, 4026, 4047, 4340, 4472, 4488, 4492]","[3317, 3820]","[64, 282, 454, 787, 917, 989, 1000, 1090, 1246, 1328, 1339, 1397, 1532, 1576, 1626, 1839, 1864, 1891, 1901, 1978, 2131, 2320, 2620, 2781, 2798, 3243, 3381, 3444, 3509, 3771, 3906, 3912, 3946, 3952, 3957, 3975, 3980, 4017, 4026, 4047, 4340, 4472, 4488, 4492]","[3317, 3820]",4953,46,4907,2,44,4907,0
2.5,CHKDPCP,"[92, 276, 347, 364, 637, 1624, 1649, 1878, 1890]",[637],"[92, 276, 347, 364, 1624, 1649, 1878, 1890]",[637],1902,9,1893,1,8,1893,0
2.5,CHKMAX,"[27, 121, 281, 517, 632, 727, 785, 789, 974, 978, 1133, 1236, 1299, 1816, 2115, 2127, 2190, 2200, 2291, 2313, 2372, 2435, 2499, 2639, 2712, 2716, 2761, 2832, 2882, 2958, 3052, 3090, 3172, 3189, 3219, 3273, 3327, 3400, 3510, 3575, 3764, 3768, 3928, 4050, 4063, 4079, 4295, 4931, 5037, 5130, 5134, 5173, 5289, 5369, 5407]","[2127, 2291, 3928, 4295]","[27, 121, 281, 517, 632, 727, 785, 789, 974, 978, 1133, 1236, 1299, 1816, 2115, 2190, 2200, 2313, 2372, 2435, 2499, 2639, 2712, 2716, 2761, 2832, 2882, 2958, 3052, 3090, 3172, 3189, 3219, 3273, 3327, 3400, 3510, 3575, 3764, 3768, 4050, 4063, 4079, 4931, 5037, 5130, 5134, 5173, 5289, 5369, 5407]","[2127, 2291, 3928, 4295]",5690,55,5635,4,51,5635,0
2.5,CHKMYOD,"[131, 316, 984, 1166, 1268, 1738, 2106, 2292, 2361, 2682, 2754, 2885, 3066, 3379, 3468, 3990, 3996, 4038, 4281, 4521, 4596, 4794, 4849, 4941, 5065, 5145, 5257, 5517, 5592, 5660, 5764, 6150, 6284, 6321, 6456, 6527]","[4941, 6150]","[131, 316, 984, 1166, 1268, 1738, 2106, 2292, 2361, 2682, 2754, 2885, 3066, 3379, 3468, 3990, 3996, 4038, 4281, 4521, 4596, 4794, 4849, 5065, 5145, 5257, 5517, 5592, 5660, 5764, 6284, 6321, 6456, 6527]","[4941, 6150]",7381,36,7345,2,34,7345,0
2.5,CHKOVAL,"[368, 434, 779, 952, 1289, 1293, 1390, 1492, 1898, 1923, 1984, 2449, 2657, 2924, 3009, 3164, 3466, 3812, 3837, 3915, 4176, 4694, 4699, 4720, 4890, 4915, 5081, 5120, 5144, 5170, 5327, 5795, 6282, 6496, 6975, 7022, 7079, 7134, 7148, 7355, 7691, 8125, 8130, 8334, 8410, 8420, 8456, 8592, 8791, 9028, 9105, 9201]","[3164, 3466, 4176, 4694, 5795, 6282]","[368, 434, 779, 952, 1289, 1293, 1390, 1492, 1898, 1923, 1984, 2449, 2657, 2924, 3009, 3812, 3837, 3915, 4699, 4720, 4890, 4915, 5081, 5120, 5144, 5170, 5327, 6496, 6975, 7022, 7079, 7134, 7148, 7355, 7691, 8125, 8130, 8334, 8410, 8420, 8456, 8592, 8791, 9028, 9105, 9201]","[3164, 3466, 4176, 4694, 5795, 6282]",9198,52,9146,6,46,9146,0
2.5,CHKRPL30,"[527, 545, 571, 594, 612, 671, 749, 801, 878, 916, 1219, 1382, 1397, 1466, 1471, 1541, 1580, 1684, 1765, 1778, 1872, 1918, 1957, 2113, 2158, 2250, 2272, 2753, 2816, 2837, 2850, 2990, 3052, 3403, 3478, 3799, 3838]","[801, 1872, 2753]","[527, 545, 571, 594, 612, 671, 749, 878, 916, 1219, 1382, 1397, 1466, 1471, 1541, 1580, 1684, 1765, 1778, 1918, 1957, 2113, 2158, 2250, 2272, 2816, 2837, 2850, 2990, 3052, 3403, 3478, 3799, 3838]","[801, 1872, 2753]",3884,37,3847,3,34,3847,0
2.5,CHKRPL37A,"[16, 57, 183, 201, 476, 547, 691, 798, 962, 996, 1035, 1067, 1265, 1274, 1278, 1319, 1376, 1540, 1558, 1618, 1678, 1946, 2125, 2255, 2340, 2386, 2739, 2838, 3052, 3179, 3376]","[798, 1376, 2386]","[16, 57, 183, 201, 476, 547, 691, 962, 996, 1035, 1067, 1265, 1274, 1278, 1319, 1540, 1558, 1618, 1678, 1946, 2125, 2255, 2340, 2739, 2838, 3052, 3179, 3376]","[798, 1376, 2386]",3465,31,3434,3,28,3434,0
2.5,CHKRPL5G,"[99, 153, 300, 355, 498, 512, 785, 1022, 1036, 1173, 1227, 1319, 1419, 1540, 1599, 1632, 1637, 2017, 2138, 2148, 2397, 2428, 2473, 2618, 2952, 2974, 3092, 3100, 3126, 3137, 3157, 3345, 3433, 3467, 3637, 3955, 4062, 4166, 4259, 4309, 4405, 4535, 4620, 4638, 4658, 4746, 5165, 5334, 5562, 5958, 6060, 6064, 6248, 6478, 6639, 6690, 6897, 7049, 7223, 7675, 7787, 7986, 8058, 8075]","[498, 1419, 1632, 3157, 3955, 5165, 6897]","[99, 153, 300, 355, 512, 785, 1022, 1036, 1173, 1227, 1319, 1540, 1599, 1637, 2017, 2138, 2148, 2397, 2428, 2473, 2618, 2952, 2974, 3092, 3100, 3126, 3137, 3345, 3433, 3467, 3637, 4062, 4166, 4259, 4309, 4405, 4535, 4620, 4638, 4658, 4746, 5334, 5562, 5958, 6060, 6064, 6248, 6478, 6639, 6690, 7049, 7223, 7675, 7787, 7986, 8058, 8075]","[498, 1419, 1632, 3157, 3955, 5165, 6897]",8313,64,8249,7,57,8249,0
2.5,CHKTUB4B,"[65, 75, 188, 243, 264, 323, 340, 437, 699, 706, 762, 779, 849, 949, 1082, 1150, 1188, 1199, 1280, 1469, 1521, 1531, 1573, 1710, 1778, 1790, 1803, 1851, 1895, 1955, 2053, 2483, 2740, 2779, 2998, 3110, 3136]","[437, 949, 1573]","[65, 75, 188, 243, 264, 323, 340, 699, 706, 762, 779, 849, 1082, 1150, 1188, 1199, 1280, 1469, 1521, 1531, 1710, 1778, 1790, 1803, 1851, 1895, 1955, 2053, 2483, 2740, 2779, 2998, 3110, 3136]","[437, 949, 1573]",3145,37,3108,3,34,3108,0
2.5,CHKY,"[214, 319, 514, 641, 691, 794, 805, 863, 887, 1112, 1495, 1560, 1616, 1650, 1664, 1892, 2091, 2096, 2197, 2674, 2692, 2725, 2730, 2799, 2858, 2891, 2926, 3082, 3200, 3255, 3577, 3603, 3953, 3963, 4199, 4435, 4439, 4683, 4709, 4750, 4835, 5049, 5056, 5082, 5186, 5213, 5282, 5648, 5723, 6012, 6249, 6383, 6407, 6473, 6815, 7072, 7846, 7884, 8349, 8361]","[3603, 4199, 4683, 5648, 6012, 6249]","[214, 319, 514, 641, 691, 794, 805, 863, 887, 1112, 1495, 1560, 1616, 1650, 1664, 1892, 2091, 2096, 2197, 2674, 2692, 2725, 2730, 2799, 2858, 2891, 2926, 3082, 3200, 3255, 3577, 3953, 3963, 4435, 4439, 4709, 4750, 4835, 5049, 5056, 5082, 5186, 5213, 5282, 5723, 6383, 6407, 6473, 6815, 7072, 7846, 7884, 8349, 8361]","[3603, 4199, 4683, 5648, 6012, 6249]",8364,60,8304,6,54,8304,0
2.5,CHPPHYGEN,"[22, 120, 191, 300, 370, 543, 555, 637, 821, 919, 964, 988, 1193, 1263, 1328, 1341, 1599, 1664, 1736, 1802, 1818, 1830, 1902, 2214, 2284, 2350, 2485, 2499, 3020, 3054, 3516, 3672, 3764, 3786, 4096, 4125, 4387, 4561, 4599, 4609, 4831, 4945, 5043, 5114, 5286, 5459, 5471, 5521, 5547, 5557, 5741, 5839, 5884, 5908, 6115, 6150, 6244, 6444, 6592, 6609, 6623, 6693, 6791, 7000, 7011, 7072, 7138, 7206, 7379, 7738, 7815, 7830, 7843, 8202, 8430, 8472, 8609, 8742, 8746, 8823, 8841, 8862, 9244, 9306, 9395, 9894, 9910, 9942, 9995, 10066, 10103, 10416, 10450, 10818, 10833, 10849, 10853, 10873, 11000, 11079, 11193, 11552, 11636, 11645, 11681, 11685, 11689, 11693, 11811, 11828, 11903, 11936, 12237, 12560, 12575, 12603, 12943, 12968, 13318, 13493, 13548]","[4599, 4945]","[22, 120, 191, 300, 370, 543, 555, 637, 821, 919, 964, 988, 1193, 1263, 1328, 1341, 1599, 1664, 1736, 1802, 1818, 1830, 1902, 2214, 2284, 2350, 2485, 2499, 3020, 3054, 3516, 3672, 3764, 3786, 4096, 4125, 4387, 4561, 4609, 4831, 5043, 5114, 5286, 5459, 5471, 5521, 5547, 5557, 5741, 5839, 5884, 5908, 6115, 6150, 6244, 6444, 6592, 6609, 6623, 6693, 6791, 7000, 7011, 7072, 7138, 7206, 7379, 7738, 7815, 7830, 7843, 8202, 8430, 8472, 8609, 8742, 8746, 8823, 8841, 8862, 9244, 9306, 9395, 9894, 9910, 9942, 9995, 10066, 10103, 10416, 10450, 10818, 10833, 10849, 10853, 10873, 11000, 11079, 11193, 11552, 11636, 11645, 11681, 11685, 11689, 11693, 11811, 11828, 11903, 11936, 12237, 12560, 12575, 12603, 12943, 12968, 13318, 13493, 13548]","[4599, 4945]",13689,121,13568,2,119,13568,0
2.5,CHPPROTP1A,"[6, 58, 159, 179]",[159],"[6, 58, 179]",[159],397,4,393,1,3,393,0
2.5,CHPPROTP1B,"[4, 56, 160, 180]",[160],"[4, 56, 180]",[160],396,4,392,1,3,392,0
2.5,CHWEGLOBIM,"[221, 237, 271, 474, 541, 588, 604, 761, 1063, 1069, 1175, 1193, 1199, 1222, 1319, 1417, 1422, 1428, 1473, 1529]","[237, 588]","[221, 271, 474, 541, 604, 761, 1063, 1069, 1175, 1193, 1199, 1222, 1319, 1417, 1422, 1428, 1473, 1529]","[237, 588]",1701,20,1681,2,18,1681,0
2.5,CIGH,"[452, 457, 1249, 1281, 1520, 1577, 1691, 2011, 2029, 2062, 2130, 2280, 2536, 2593, 2705, 2889, 2960, 3750, 3797]","[1281, 1691, 2280, 2889]","[452, 457, 1249, 1520, 1577, 2011, 2029, 2062, 2130, 2536, 2593, 2705, 2960, 3750, 3797]","[1281, 1691, 2280, 2889]",3967,19,3948,4,15,3948,0
2.5,CITEGLOBIM,"[220, 236, 270, 345, 473, 540, 587, 603, 890, 894, 1056, 1062, 1168, 1186, 1192, 1198, 1216, 1266, 1294, 1313, 1407, 1412, 1418, 1463, 1519]","[236, 587]","[220, 270, 345, 473, 540, 603, 890, 894, 1056, 1062, 1168, 1186, 1192, 1198, 1216, 1266, 1294, 1313, 1407, 1412, 1418, 1463, 1519]","[236, 587]",1691,25,1666,2,23,1666,0
2.5,CJAEGLOBIN,"[221, 237, 271, 474, 541, 588, 604, 761, 1063, 1069, 1175, 1193, 1199, 1222, 1272, 1319, 1418, 1423, 1429, 1474, 1530]","[237, 588]","[221, 271, 474, 541, 604, 761, 1063, 1069, 1175, 1193, 1199, 1222, 1272, 1319, 1418, 1423, 1429, 1474, 1530]","[237, 588]",1702,21,1681,2,19,1681,0
2.5,CJINTERFG,"[191, 512, 862, 1143, 1571, 1588, 1860, 2343, 2428, 2635, 2881, 3126, 3158, 3268, 3303, 3346, 3602, 3607, 4072, 4125, 4187, 4286, 4373, 4465, 4702, 4730, 4734, 4750, 4887, 5078, 5524, 5657, 5822, 5944, 6036, 6127, 6251, 6397, 6469, 6760, 6901, 6949, 7324, 7468, 7647, 8152, 8324, 8352, 8418, 8486, 8503]","[2881, 4187, 4465]","[191, 512, 862, 1143, 1571, 1588, 1860, 2343, 2428, 2635, 3126, 3158, 3268, 3303, 3346, 3602, 3607, 4072, 4125, 4286, 4373, 4702, 4730, 4734, 4750, 4887, 5078, 5524, 5657, 5822, 5944, 6036, 6127, 6251, 6397, 6469, 6760, 6901, 6949, 7324, 7468, 7647, 8152, 8324, 8352, 8418, 8486, 8503]","[2881, 4187, 4465]",8519,51,8468,3,48,8468,0
2.5,CL54K,"[119, 132, 141, 183, 408, 512, 535, 543, 649, 653, 706, 771, 959, 1177, 1186, 1190, 1238, 1248, 1294, 1538, 1926, 2403, 2581, 2696, 2715, 2726, 2753, 2778, 2797, 2871, 2954, 3218, 3376]",[512],"[119, 132, 141, 183, 408, 535, 543, 649, 653, 706, 771, 959, 1177, 1186, 1190, 1238, 1248, 1294, 1538, 1926, 2403, 2581, 2696, 2715, 2726, 2753, 2778, 2797, 2871, 2954, 3218, 3376]",[512],3407,33,3374,1,32,3374,0
2.5,CMBGA2B2,"[217, 383, 463, 718, 810, 956, 989, 1027, 1235, 1597, 1749, 1861, 2380, 2390, 2475, 2479, 2566, 2596]","[383, 718]","[217, 463, 810, 956, 989, 1027, 1235, 1597, 1749, 1861, 2380, 2390, 2475, 2479, 2566, 2596]","[383, 718]",2684,18,2666,2,16,2666,0
2.5,CMEGA2E2,"[416, 486, 492, 663, 718, 753, 805, 873, 918, 922, 1075, 1196, 1258, 1294, 1506, 1747, 1779]","[416, 753]","[486, 492, 663, 718, 805, 873, 918, 922, 1075, 1196, 1258, 1294, 1506, 1747, 1779]","[416, 753]",2046,17,2029,2,15,2029,0
2.5,CMU11711,"[15, 204, 214, 234, 337, 589, 790, 826, 906, 1018, 1058, 1250, 1647, 1685, 1984, 2031, 2601, 2627, 2669, 2890, 2896, 2941, 2997]","[1685, 2031]","[15, 204, 214, 234, 337, 589, 790, 826, 906, 1018, 1058, 1250, 1647, 1984, 2601, 2627, 2669, 2890, 2896, 2941, 2997]","[1685, 2031]",3163,23,3140,2,21,3140,0
2.5,CPPROT1GN,"[102, 144, 164, 255, 267]",[164],"[102, 144, 255, 267]",[164],390,5,385,1,4,385,0
2.5,CRASEQB,"[79, 669, 783, 881, 933, 1044, 1194, 1260, 1471, 1584, 1701, 1804, 1920, 2123, 2734, 2825, 3018, 3434, 3449, 3452, 3464, 3482, 3593, 3617, 3635, 3641, 3647, 3785, 3812, 3833, 3946, 4298, 4351, 4825, 4931, 4959]","[1920, 2825]","[79, 669, 783, 881, 933, 1044, 1194, 1260, 1471, 1584, 1701, 1804, 2123, 2734, 3018, 3434, 3449, 3452, 3464, 3482, 3593, 3617, 3635, 3641, 3647, 3785, 3812, 3833, 3946, 4298, 4351, 4825, 4931, 4959]","[1920, 2825]",5120,36,5084,2,34,5084,0
2.5,CRUCH7AHYD,"[37, 803, 971, 1205, 1339, 1731, 1887, 1995, 2110, 2387, 2690, 2827, 2919, 2936, 2941, 3016, 3151, 3186, 3206, 3418, 3651, 3792, 3841, 4121, 4201, 4264, 4542, 4774, 4938, 5095, 5283, 5559, 5619, 5795, 6076, 6613, 6768, 6819, 6840, 6963, 7135, 7866, 7901, 7955, 8154, 8235, 8376, 8863, 8924, 9330, 9375, 9626, 9849, 10243, 10316, 10327, 10564]","[1731, 3651, 4938, 6076, 7866]","[37, 803, 971, 1205, 1339, 1887, 1995, 2110, 2387, 2690, 2827, 2919, 2936, 2941, 3016, 3151, 3186, 3206, 3418, 3792, 3841, 4121, 4201, 4264, 4542, 4774, 5095, 5283, 5559, 5619, 5795, 6613, 6768, 6819, 6840, 6963, 7135, 7901, 7955, 8154, 8235, 8376, 8863, 8924, 9330, 9375, 9626, 9849, 10243, 10316, 10327, 10564]","[1731, 3651, 4938, 6076, 7866]",10606,57,10549,5,52,10549,0
2.5,CRUGAD45A,"[189, 208, 215, 233, 654, 691, 760, 782, 859, 902, 929, 1033, 1375, 1509, 1744, 1811, 1877, 1971, 2036, 2063, 2195, 2306, 2411, 2417, 2500, 2521, 2553, 2604, 2759, 3052, 3148, 3398, 3428, 3555, 3605, 4003, 4108, 4368]","[1877, 2063, 2417]","[189, 208, 215, 233, 654, 691, 760, 782, 859, 902, 929, 1033, 1375, 1509, 1744, 1811, 1971, 2036, 2195, 2306, 2411, 2500, 2521, 2553, 2604, 2759, 3052, 3148, 3398, 3428, 3555, 3605, 4003, 4108, 4368]","[1877, 2063, 2417]",4427,38,4389,3,35,4389,0
2.5,DMPROTP1,"[33, 249, 377, 546]",[249],"[33, 377, 546]",[249],616,4,612,1,3,612,0
2.5,DMU11712,"[16, 182, 218, 238, 340, 592, 636, 792, 1405, 1667, 1705, 1929, 1996, 2043, 2619, 2655, 2685, 2703, 2757, 2774, 2781, 2903, 2909, 3010]","[1705, 2043]","[16, 182, 218, 238, 340, 592, 636, 792, 1405, 1667, 1929, 1996, 2619, 2655, 2685, 2703, 2757, 2774, 2781, 2903, 2909, 3010]","[1705, 2043]",3019,24,2995,2,22,2995,0
2.5,DOGCOLIP,"[212, 224, 249, 416, 600, 789, 817, 904, 1108, 1148, 1343, 1411, 1602, 1747, 2114, 2126, 2378, 2394, 2399, 2431, 2503, 2508, 2512, 2550, 2582, 2602, 2694, 2821, 2839, 2845, 2918, 3108, 3119]","[1108, 2378]","[212, 224, 249, 416, 600, 789, 817, 904, 1148, 1343, 1411, 1602, 1747, 2114, 2126, 2394, 2399, 2431, 2503, 2508, 2512, 2550, 2582, 2602, 2694, 2821, 2839, 2845, 2918, 3108, 3119]","[1108, 2378]",3156,33,3123,2,31,3123,0
2.5,DOGIL8T,"[118, 223, 434, 475, 577, 579, 671, 686, 1206, 1287, 1406, 1549, 1710, 1769, 1918, 1956]","[118, 1406, 1769]","[223, 434, 475, 577, 579, 671, 686, 1206, 1287, 1549, 1710, 1918, 1956]","[118, 1406, 1769]",2229,16,2213,3,13,2213,0
2.5,ECGLOAP1,"[105, 298, 363, 543, 657, 725, 770, 889, 893, 962, 968, 995]","[363, 657]","[105, 298, 543, 725, 770, 889, 893, 962, 968, 995]","[363, 657]",1133,12,1121,2,10,1121,0
2.5,ECPZA2GL,"[19, 59, 193, 383, 570, 767, 810, 818, 954, 1055, 1067, 1263, 1560, 1585, 1600, 1611, 1615, 1623, 1648, 1671, 1675, 1728, 2012, 2153, 2166, 2176, 2307, 2516, 2613, 2672, 3208, 3234, 3269, 3484, 3527, 3532, 3552, 3576, 3650, 3924, 3945, 4059, 4140, 4304, 4478, 4610, 4647, 4657, 4877, 5046, 5060, 5077]","[3576, 4059]","[19, 59, 193, 383, 570, 767, 810, 818, 954, 1055, 1067, 1263, 1560, 1585, 1600, 1611, 1615, 1623, 1648, 1671, 1675, 1728, 2012, 2153, 2166, 2176, 2307, 2516, 2613, 2672, 3208, 3234, 3269, 3484, 3527, 3532, 3552, 3650, 3924, 3945, 4140, 4304, 4478, 4610, 4647, 4657, 4877, 5046, 5060, 5077]","[3576, 4059]",5081,52,5029,2,50,5029,0
2.5,ECZGL1,"[66, 176, 190, 213, 274, 345, 700, 725, 740, 751, 755, 763, 835, 845, 874, 1033, 1420, 1534, 1566, 1571, 1580, 1588, 1965, 1983]","[700, 1534]","[66, 176, 190, 213, 274, 345, 725, 740, 751, 755, 763, 835, 845, 874, 1033, 1420, 1566, 1571, 1580, 1588, 1965, 1983]","[700, 1534]",1993,24,1969,2,22,1969,0
2.5,ECZGL2,"[255, 280, 295, 306, 310, 318, 390, 400, 429, 588, 970, 1084, 1116, 1121, 1130, 1138, 1515, 1533]","[255, 1084]","[280, 295, 306, 310, 318, 390, 400, 429, 588, 970, 1116, 1121, 1130, 1138, 1515, 1533]","[255, 1084]",1555,18,1537,2,16,1537,0
2.5,ELMETL,"[29, 651, 1097, 1120, 1282, 1291, 1514, 1518, 1615, 1733, 1745]","[1097, 1291]","[29, 651, 1120, 1282, 1514, 1518, 1615, 1733, 1745]","[1097, 1291]",1865,11,1854,2,9,1854,0
2.5,FDFELDI2,"[131, 248, 276, 349, 571, 641, 678, 703, 970, 1070, 1235, 1362, 1643, 1658, 1710, 1882, 2011, 2015, 2019, 2089, 2149, 2246]","[276, 970]","[131, 248, 349, 571, 641, 678, 703, 1070, 1235, 1362, 1643, 1658, 1710, 1882, 2011, 2015, 2019, 2089, 2149, 2246]","[276, 970]",2417,22,2395,2,20,2395,0
2.5,FDTNFA,"[87, 187, 260, 273, 291, 547, 661, 695, 790, 885, 972, 1011, 1396, 1590, 1634]","[187, 790, 972]","[87, 260, 273, 291, 547, 661, 695, 885, 1011, 1396, 1590, 1634]","[187, 790, 972]",1714,15,1699,3,12,1699,0
2.5,GDMYF5G,"[138, 344, 461, 524, 561, 639, 655, 716, 860, 1036, 1104, 1121]","[639, 1036]","[138, 344, 461, 524, 561, 655, 716, 860, 1104, 1121]","[639, 1036]",1601,12,1589,2,10,1589,0
2.5,GGAC01,"[22, 116, 150, 273, 443, 634, 774, 778, 782, 790, 808, 833, 904, 914, 947, 954, 958, 970, 995, 1057, 1119, 1240, 1343, 1384, 1586, 1645, 1666, 1683, 1716, 1812, 1873, 1903, 1995, 1999, 2026, 2050, 2083, 2226, 2261, 2585, 2602, 2687, 2698, 2782, 2812, 2835, 2853, 3011, 3120, 3154, 3189, 3276, 3330, 3338, 3431, 3495, 3561, 3571, 3597, 3677, 3723, 3831, 3857, 3982, 4055, 4130, 4309, 4499, 4695, 4898, 4928, 4996]","[1666, 2226, 3189, 3677]","[22, 116, 150, 273, 443, 634, 774, 778, 782, 790, 808, 833, 904, 914, 947, 954, 958, 970, 995, 1057, 1119, 1240, 1343, 1384, 1586, 1645, 1683, 1716, 1812, 1873, 1903, 1995, 1999, 2026, 2050, 2083, 2261, 2585, 2602, 2687, 2698, 2782, 2812, 2835, 2853, 3011, 3120, 3154, 3276, 3330, 3338, 3431, 3495, 3561, 3571, 3597, 3723, 3831, 3857, 3982, 4055, 4130, 4309, 4499, 4695, 4898, 4928, 4996]","[1666, 2226, 3189, 3677]",5038,72,4966,4,68,4966,0
2.5,GGACTAC,"[229, 311, 339, 351, 533, 614, 779, 791, 795, 821, 871, 970, 1266, 1472, 1554, 1737, 1756, 1811, 1815, 1842, 1866, 2074, 2104, 2127, 2277, 2520, 2552, 2690, 2703, 2752, 2770, 2914, 3032, 3167, 3218, 3254, 3948, 4140, 4216, 4282, 4292, 4336, 4398, 4680, 4693, 4697, 4726, 4942, 5278]","[970, 2127, 2914, 3218, 4398]","[229, 311, 339, 351, 533, 614, 779, 791, 795, 821, 871, 1266, 1472, 1554, 1737, 1756, 1811, 1815, 1842, 1866, 2074, 2104, 2277, 2520, 2552, 2690, 2703, 2752, 2770, 3032, 3167, 3254, 3948, 4140, 4216, 4282, 4292, 4336, 4680, 4693, 4697, 4726, 4942, 5278]","[970, 2127, 2914, 3218, 4398]",5455,49,5406,5,44,5406,0
2.5,GGACTI,"[153, 404, 431, 448, 525, 529, 580, 788, 818, 841, 929, 975, 999, 1030, 1368, 1554, 1659, 1735, 1761, 1771, 1779, 1841, 2182, 2279]","[404, 841, 1554, 1841]","[153, 431, 448, 525, 529, 580, 788, 818, 929, 975, 999, 1030, 1368, 1659, 1735, 1761, 1771, 1779, 2182, 2279]","[404, 841, 1137, 1554, 1841]",2418,24,2394,4,20,2393,1
2.5,GGCALB,"[288, 386, 398, 416, 421, 520, 589, 596, 733, 790, 866, 889, 944, 1016, 1105, 1150, 1272, 1292, 1358, 1514, 1542, 1724, 1835, 1863, 1948, 2289, 2549, 2791, 2890, 2993, 3062, 3378, 3467, 3509, 3617, 3629, 3693, 3720, 3793, 4235, 4414, 4749, 4894, 5205, 5262, 5404, 5524, 5818, 5825, 5867, 5933, 6033, 6045, 6149, 6181, 6190, 6321, 6526, 6673, 6694, 6724, 6784, 7035, 7145, 7188, 7244, 7824, 7865, 8105, 8141, 8249, 8400, 8537, 8667, 8718, 8722, 8728, 8739, 8776, 8829, 8987, 9004, 9052, 9082, 9228, 9384, 9394, 9634, 9685, 9689, 9778, 9880, 9916, 10030, 10195, 10219, 10454, 10487, 10530, 10551, 10647]","[386, 1863, 2289, 3467, 3793, 4235, 4894, 5205, 5933, 6784, 7035, 7824, 8718, 9052, 9685, 10195]","[288, 398, 416, 421, 520, 589, 596, 733, 790, 866, 889, 944, 1016, 1105, 1150, 1272, 1292, 1358, 1514, 1542, 1724, 1835, 1948, 2549, 2791, 2890, 2993, 3062, 3378, 3509, 3617, 3629, 3693, 3720, 4414, 4749, 5262, 5404, 5524, 5818, 5825, 5867, 6033, 6045, 6149, 6181, 6190, 6321, 6526, 6673, 6694, 6724, 7145, 7188, 7244, 7865, 8105, 8141, 8249, 8400, 8537, 8667, 8722, 8728, 8739, 8776, 8829, 8987, 9004, 9082, 9228, 9384, 9394, 9634, 9689, 9778, 9880, 9916, 10030, 10219, 10454, 10487, 10530, 10551, 10647]","[386, 1863, 2289, 3467, 3793, 4235, 4894, 5205, 5933, 6784, 7035, 7824, 8718, 9052, 9685, 10195]",11060,101,10959,16,85,10959,0
2.5,GGCRYD1,"[95, 203, 217, 267, 378, 388, 441, 570, 910, 1734, 2077, 2081, 2085, 2090, 2251, 2539, 2622, 2742, 3150, 3516, 3944, 4036, 4297, 4332, 4528, 4766, 4889, 4907, 5234, 5498, 5690, 5899, 6003, 6138, 6231, 6395, 6734, 6791, 6829, 6835, 6841, 6934, 7213, 7251, 7373, 7424, 7435, 7529, 7779, 8021]","[441, 1734, 2742, 3150, 3516, 3944, 4332, 4528, 4907, 5234, 5899, 6138, 6395, 6734, 7213]","[95, 203, 217, 267, 378, 388, 570, 910, 2077, 2081, 2085, 2090, 2251, 2539, 2622, 4036, 4297, 4766, 4889, 5498, 5690, 6003, 6231, 6791, 6829, 6835, 6841, 6934, 7251, 7373, 7424, 7435, 7529, 7779, 8021]","[441, 1734, 2742, 3150, 3516, 3944, 4332, 4528, 4907, 5234, 5899, 6138, 6395, 6734, 7213]",8152,50,8102,15,35,8102,0
2.5,GGGL03,"[44, 188, 251, 329, 340, 432, 654, 768, 996, 1160, 1187]","[432, 768]","[44, 188, 251, 329, 340, 654, 996, 1160, 1187]","[432, 768]",1199,11,1188,2,9,1188,0
2.5,GGGNRHIA,"[338, 363, 607, 1661, 1684, 1699, 1950, 2154, 2315, 2577, 2592, 2787, 2822, 2904, 2941, 2951, 3048, 3380, 3422, 3510, 3627, 3641, 3744, 3783, 3815, 3820, 4018, 4184, 4195, 4392, 4470, 4472, 4479, 4544, 4655, 5111, 5248, 5447, 5575, 5640, 5742, 5763, 5885, 6091, 6095, 6120]","[3627, 4392]","[338, 363, 607, 1661, 1684, 1699, 1950, 2154, 2315, 2577, 2592, 2787, 2822, 2904, 2941, 2951, 3048, 3380, 3422, 3510, 3641, 3744, 3783, 3815, 3820, 4018, 4184, 4195, 4470, 4472, 4479, 4544, 4655, 5111, 5248, 5447, 5575, 5640, 5742, 5763, 5885, 6091, 6095, 6120]","[3627, 4392]",6274,46,6228,2,44,6228,0
2.5,GGNFM1D,"[145, 610, 789, 859, 874, 932, 1112, 1135, 1295, 1406, 1541, 1721, 1817, 2008, 2051, 2149, 2187, 2194, 2224, 2228, 2285, 2304, 2451, 2540, 2760, 3184, 3354, 3389, 3448, 3462, 3595, 4084, 4092, 4194, 4284, 4356, 4395, 4596, 4617, 4656, 4663, 4746, 4768, 4810, 4835, 4851, 4869, 5014, 5057, 5509]",[2451],"[145, 610, 789, 859, 874, 932, 1112, 1135, 1295, 1406, 1541, 1721, 1817, 2008, 2051, 2149, 2187, 2194, 2224, 2228, 2285, 2304, 2540, 2760, 3184, 3354, 3389, 3448, 3462, 3595, 4084, 4092, 4194, 4284, 4356, 4395, 4596, 4617, 4656, 4663, 4746, 4768, 4810, 4835, 4851, 4869, 5014, 5057, 5509]","[2132, 2451]",5630,50,5580,1,49,5579,1
2.5,GGPROP2,"[51, 307, 564]",[307],"[51, 564]",[307],640,3,637,1,2,637,0
2.5,GGRIHBGEN,"[163, 202, 219, 234, 254, 322, 469, 562, 612, 633, 676, 712, 801, 825, 961, 981, 990, 1038, 1165, 1237, 1390, 1973, 2050, 2088, 2139, 2149, 2207, 2381, 2450, 2644, 2666, 2863, 2870, 2982, 2998, 3219, 3317, 3343, 3394, 3411, 3454]","[2982, 3219, 3454]","[163, 202, 219, 234, 254, 322, 469, 562, 612, 633, 676, 712, 801, 825, 961, 981, 990, 1038, 1165, 1237, 1390, 1973, 2050, 2088, 2139, 2149, 2207, 2381, 2450, 2644, 2666, 2863, 2870, 2998, 3317, 3343, 3394, 3411]","[2982, 3219, 3454]",3878,41,3837,3,38,3837,0
2.5,GGVITIIG,"[50, 54, 190, 380, 442, 567, 830, 913, 1067, 1110, 1146, 1219, 1318, 1596, 1740, 1952, 2021, 2339, 2351, 2362, 2545, 2561, 2640, 2694, 2698, 2733, 2948, 2952, 2957, 2977, 3056, 3064, 3138, 3145, 3267, 3543, 3791, 3876, 4114, 4225, 4295, 4818, 4876, 5081, 5129, 5262, 5298, 5441, 5494, 5507, 5604, 5647, 5848, 6011, 6062, 6229, 6395, 6408, 6443, 6814, 6832, 7039, 7045, 7123, 7127, 7268, 7393, 7615, 7740, 7809, 7813, 7817, 8026, 8202, 8258, 8302, 8314, 8321, 8374, 8447, 8481, 8597, 8678, 8702, 8858, 9149, 9439, 9467, 10104, 10448, 10618, 10703, 10714, 10920, 10930, 10951, 10971, 11265, 11663, 11667, 11757, 12101, 12272, 12547, 12615, 12750, 12775, 12791, 13067, 13168, 13180, 13186, 13267, 13416, 13452, 13505, 13798, 13819, 14002, 14077, 14134, 14139, 14247, 14252, 14386, 14413, 14485, 14589, 14613, 14704, 14938, 15283, 15348, 15710, 15771, 15820, 15880, 15999, 16378, 16552, 16917, 16955, 17013, 17019, 17193, 17299, 17447, 17481, 17492, 17815, 17864, 17913, 18132, 18359, 18520, 18829, 18851, 18882, 19081, 19128, 19337, 19348, 19440, 19513, 19515, 19538, 19562, 19638, 19933, 20037, 20096, 20126, 20178]","[54, 190, 442, 2021, 2694, 2948, 3267, 3543, 3791, 4818, 5441, 6229, 6443, 7045, 7268, 8026, 8302, 9149, 9467, 10104, 10448, 10714, 11757, 12272, 12615, 13267, 13505, 14704, 15348, 15771, 16955, 17864, 19081]","[50, 380, 567, 830, 913, 1067, 1110, 1146, 1219, 1318, 1596, 1740, 1952, 2339, 2351, 2362, 2545, 2561, 2640, 2698, 2733, 2952, 2957, 2977, 3056, 3064, 3138, 3145, 3876, 4114, 4225, 4295, 4876, 5081, 5129, 5262, 5298, 5494, 5507, 5604, 5647, 5848, 6011, 6062, 6395, 6408, 6814, 6832, 7039, 7123, 7127, 7393, 7615, 7740, 7809, 7813, 7817, 8202, 8258, 8314, 8321, 8374, 8447, 8481, 8597, 8678, 8702, 8858, 9439, 10618, 10703, 10920, 10930, 10951, 10971, 11265, 11663, 11667, 12101, 12547, 12750, 12775, 12791, 13067, 13168, 13180, 13186, 13416, 13452, 13798, 13819, 14002, 14077, 14134, 14139, 14247, 14252, 14386, 14413, 14485, 14589, 14613, 14938, 15283, 15710, 15820, 15880, 15999, 16378, 16552, 16917, 17013, 17019, 17193, 17299, 17447, 17481, 17492, 17815, 17913, 18132, 18359, 18520, 18829, 18851, 18882, 19128, 19337, 19348, 19440, 19513, 19515, 19538, 19562, 19638, 19933, 20037, 20096, 20126, 20178]","[54, 190, 442, 2021, 2694, 2948, 3267, 3543, 3791, 4818, 5441, 6229, 6443, 7045, 7268, 8026, 8302, 9149, 9467, 10104, 10448, 10714, 11757, 12272, 12615, 13267, 13505, 14028, 14704, 15348, 15771, 16955, 17864, 19081]",20335,173,20162,33,140,20161,1
2.5,GIBPROTP1A,"[4, 56, 160, 179, 260]",[160],"[4, 56, 179, 260]",[160],393,5,388,1,4,388,0
2.5,GORAFPA,"[75, 699, 919, 999, 1201, 1205, 1243, 1860, 1931, 1939, 2163, 2174, 2268, 2395, 2455, 2530, 2784, 2871, 2883, 2955, 3126, 3434, 3684, 3924, 4002, 4151, 4192, 4232, 4363, 4369, 4522, 4564, 4596, 4744, 4757, 5295, 5324, 5457, 5476, 5550, 5557, 5602, 6046, 6121, 6220, 6396, 6663, 6760, 6976, 6990, 7046, 7156, 7227, 7445, 7527, 7766, 7795, 8370, 8503, 8836, 9394, 9445, 9548, 10041, 10364, 10408, 10422, 10727, 10807, 10815, 10903, 11145, 11629, 11737, 11823, 12272, 12491, 12575, 12941, 13421, 13688, 13737, 14087, 14183, 14424, 14496, 14672, 14707, 14791, 14852, 15195, 15202, 15251, 15555, 15801, 15832, 15935, 15952, 16067, 16181, 16581, 16906, 17064, 17195, 17207, 17467, 17567, 17576, 17585, 17601, 17834, 18115, 18426, 18434, 18713, 18723, 18728, 18761, 18940, 19118, 19231, 19603, 19676, 20187, 20297, 20301, 20326, 20420, 20427, 20434, 20444, 20474, 20478, 20565, 20617, 20718, 20741, 21186, 21207, 22316, 22488, 22550, 22649, 22828, 22937, 22983, 22986, 23096, 23104, 23140, 23158, 23229, 23233, 23410, 23533, 23613, 23763, 23937, 24060, 24387]","[999, 1860, 2955, 5457, 6760, 7766, 9445, 11629, 13421, 14087, 14707, 16581, 17834]","[75, 699, 919, 1201, 1205, 1243, 1931, 1939, 2163, 2174, 2268, 2395, 2455, 2530, 2784, 2871, 2883, 3126, 3434, 3684, 3924, 4002, 4151, 4192, 4232, 4363, 4369, 4522, 4564, 4596, 4744, 4757, 5295, 5324, 5476, 5550, 5557, 5602, 6046, 6121, 6220, 6396, 6663, 6976, 6990, 7046, 7156, 7227, 7445, 7527, 7795, 8370, 8503, 8836, 9394, 9548, 10041, 10364, 10408, 10422, 10727, 10807, 10815, 10903, 11145, 11737, 11823, 12272, 12491, 12575, 12941, 13688, 13737, 14183, 14424, 14496, 14672, 14791, 14852, 15195, 15202, 15251, 15555, 15801, 15832, 15935, 15952, 16067, 16181, 16906, 17064, 17195, 17207, 17467, 17567, 17576, 17585, 17601, 18115, 18426, 18434, 18713, 18723, 18728, 18761, 18940, 19118, 19231, 19603, 19676, 20187, 20297, 20301, 20326, 20420, 20427, 20434, 20444, 20474, 20478, 20565, 20617, 20718, 20741, 21186, 21207, 22316, 22488, 22550, 22649, 22828, 22937, 22983, 22986, 23096, 23104, 23140, 23158, 23229, 23233, 23410, 23533, 23613, 23763, 23937, 24060, 24387]","[999, 1860, 2955, 5457, 6760, 7766, 9445, 11629, 13421, 14087, 14707, 16581, 17834]",24599,160,24439,13,147,24439,0
2.5,GORPROTP1A,"[8, 60, 164, 184]",[164],"[8, 60, 184]",[164],404,4,400,1,3,400,0
2.5,GPIINS,"[203, 526, 587, 696, 703, 807, 943, 950, 1023, 1175, 1358]",[526],"[203, 587, 696, 703, 807, 943, 950, 1023, 1175, 1358]",[526],1464,11,1453,1,10,1453,0
2.5,HAMAMYLP,"[48, 446, 618, 735, 1138, 1394, 1414, 1473, 1549, 1794, 2308, 2419, 2562, 2740, 3116, 3415, 3543, 3934, 3968, 4334, 4536, 4561, 4851, 5005, 5045, 5424, 5541, 5690]",[2308],"[48, 446, 618, 735, 1138, 1394, 1414, 1473, 1549, 1794, 2419, 2562, 2740, 3116, 3415, 3543, 3934, 3968, 4334, 4536, 4561, 4851, 5005, 5045, 5424, 5541, 5690]",[2308],5947,28,5919,1,27,5919,0
2.5,HAMHG5,"[10, 609, 615, 640, 724, 781, 1253, 1333, 1373, 1385, 1640, 1817, 1905, 1919, 1982, 2153, 2464, 2623, 2679, 2817, 3152, 3433, 3461, 3547, 3609, 3620, 3933, 3950, 4022, 4237, 4319, 4662, 4856, 5212, 5421, 5439, 5517, 5603, 5637, 5841, 6188, 6348, 6597, 6694, 6827, 6978, 7011, 7060, 7156, 7240, 7287, 7441, 7668, 7956, 8108, 8258, 8295, 8396, 8881, 9013, 9035, 9223, 9231, 9260, 9284]","[4856, 5517, 6188, 6597, 7441]","[10, 609, 615, 640, 724, 781, 1253, 1333, 1373, 1385, 1640, 1817, 1905, 1919, 1982, 2153, 2464, 2623, 2679, 2817, 3152, 3433, 3461, 3547, 3609, 3620, 3933, 3950, 4022, 4237, 4319, 4662, 5212, 5421, 5439, 5603, 5637, 5841, 6348, 6694, 6827, 6978, 7011, 7060, 7156, 7240, 7287, 7668, 7956, 8108, 8258, 8295, 8396, 8881, 9013, 9035, 9223, 9231, 9260, 9284]","[4856, 5517, 6188, 6597, 7441]",9711,65,9646,5,60,9646,0
2.5,HROAMD1,"[137, 237, 259, 289, 546, 896, 1072, 1369, 1539, 1566, 1585, 1647, 1664, 1955, 2322, 2579, 2687, 2835, 3239, 3348, 3357, 3486, 3494, 3830, 3928, 4081, 4181, 4347, 4700, 4795, 4816, 4823, 5134, 5260, 5311, 5341, 5383, 5413, 5723, 5734, 5962, 6212, 6415, 6531, 6799, 6863, 6978, 6983]","[2687, 3486, 4700]","[137, 237, 259, 289, 546, 896, 1072, 1369, 1539, 1566, 1585, 1647, 1664, 1955, 2322, 2579, 2835, 3239, 3348, 3357, 3494, 3830, 3928, 4081, 4181, 4347, 4795, 4816, 4823, 5134, 5260, 5311, 5341, 5383, 5413, 5723, 5734, 5962, 6212, 6415, 6531, 6799, 6863, 6978, 6983]","[2687, 3486, 4700]",7091,48,7043,3,45,7043,0
2.5,HROMA2,"[41, 292, 358, 423, 427, 511, 686, 739, 808, 838, 902, 1174, 1285, 1351, 1405, 1417, 1450, 1486, 1640]","[739, 1174]","[41, 292, 358, 423, 427, 511, 686, 808, 838, 902, 1285, 1351, 1405, 1417, 1450, 1486, 1640]","[739, 1174]",1779,19,1760,2,17,1760,0
2.5,HROMA4A,"[45, 69, 411, 661, 727, 792, 880, 1055, 1108, 1126, 1304, 1334, 1398, 1670, 1774, 1840, 1894, 1906, 1975, 2129, 2287]","[1108, 1670]","[45, 69, 411, 661, 727, 792, 880, 1055, 1126, 1304, 1334, 1398, 1774, 1840, 1894, 1906, 1975, 2129, 2287]","[1108, 1670]",2331,21,2310,2,19,2310,0
2.5,HRSPRMI,"[247, 340, 416, 551, 573, 722, 1211, 1245, 1605, 1826, 1880, 2047, 2197]",[722],"[247, 340, 416, 551, 573, 1211, 1245, 1605, 1826, 1880, 2047, 2197]",[722],2198,13,2185,1,12,2185,0
2.5,HS1D3HLH,"[173, 185, 271, 467, 659, 757, 778, 901, 937, 982, 1039, 1117, 1231, 1382, 1394, 1447, 1548, 1596, 1607, 1634, 1750, 2003, 2146]",[1039],"[173, 185, 271, 467, 659, 757, 778, 901, 937, 982, 1117, 1231, 1382, 1394, 1447, 1548, 1596, 1607, 1634, 1750, 2003, 2146]",[1039],2473,23,2450,1,22,2450,0
2.5,HS2OXOC,"[116, 755, 901, 1047, 1095, 1162, 1421, 1451, 1456, 1694, 1719, 1723, 1825, 1878, 1894, 2227]","[116, 1162, 1421, 1694, 1825]","[755, 901, 1047, 1095, 1451, 1456, 1719, 1723, 1878, 1894, 2227]","[116, 871, 1162, 1421, 1694, 1825]",2510,16,2494,5,11,2493,1
2.5,HSABLGR1,"[221, 319, 371, 749, 845, 860, 902, 1080, 1112, 1165, 1224, 1236, 1279, 1516, 1670, 1788, 1860, 1981, 2265, 2274, 2923, 2977, 3020, 3054, 3130, 3140, 3178, 3265, 3344, 3519, 3551, 3603, 3636, 3683, 3857, 4148, 4166, 4198, 4243, 4321, 4356, 4479, 4506, 4528, 4865, 4960, 5108, 5218, 5284, 5296, 5312, 5317, 5465, 5666, 5890, 6125, 6479, 6508, 6567, 6604, 6617, 6708, 6743, 6778, 6820, 6904, 6977, 7049, 7070, 7168, 7197, 7212, 7507, 7754, 8039, 8265, 8293, 8332, 8356, 8470, 8720, 9075, 9294, 9310, 9330, 9340, 9367, 9507, 9652, 10016, 10043, 10073, 10112, 10400, 10413, 10509, 10535, 10539, 10623, 10950, 10991, 11005, 11052, 11090, 11094, 11118, 11135, 11167, 11354, 11370, 11597, 11872, 11895, 11929, 11951, 11988, 11992, 12007, 12168, 12239, 12325, 12396, 12401, 12434, 12880, 12948, 12989, 13058, 13205, 13262, 13683, 13782, 13875, 14267, 14754, 14789, 14973, 15060, 15224, 15400, 15442, 15444, 15514, 15589, 15741, 15893, 15907, 15929, 16019, 16304, 16407, 16572, 16750, 16811, 16978, 17036, 17116, 17249, 17342, 17547, 17757, 17886, 17922, 17942, 17991, 18028, 18092, 18211, 18462, 18588, 18803, 18974, 19026, 19158, 19199, 19244, 19282, 19297, 19316, 19469, 19672, 19728, 19816, 19888, 19906, 19972, 20007, 20015, 20105, 20121, 20150, 20270, 20282, 20317, 20325, 20665, 20758, 20991, 21053, 21132, 21219, 21401, 21558, 21832, 22256, 22368, 22421, 22886, 23084, 23126, 23128, 23330, 23393, 23472, 23507, 23529, 23584, 23730, 23851, 23938, 23981, 24042, 24066, 24277, 24298, 24656, 24758, 24805, 24853, 24896, 24979, 25073, 25146, 25221, 25253, 25292, 25453, 25534, 25818, 25849, 25902, 25906, 25973, 26031, 26127, 26145, 26177, 26288, 26300, 26508, 26554, 26725, 26789, 27114, 27158, 27209, 27538, 28260, 28400, 28596, 28759, 28886, 29268, 29760, 29810, 30175, 30234, 30405, 30552, 30721, 30729, 30738, 31027, 31031, 31138, 31182, 31270, 31290, 31307, 31493, 31699, 32007, 32126, 32128, 32233, 32282, 32296, 32327, 32399, 32606, 32910, 32939, 33100, 33307, 33591, 33629, 33664, 33787, 33826, 33869, 33888, 34121, 34153, 34205, 34314, 34322, 34563, 34596, 34658, 35102, 35331, 35343, 35464, 35562, 35657, 35751, 35835, 35898]","[8720, 10400, 12434, 15741, 17116, 17991]","[221, 319, 371, 749, 845, 860, 902, 1080, 1112, 1165, 1224, 1236, 1279, 1516, 1670, 1788, 1860, 1981, 2265, 2274, 2923, 2977, 3020, 3054, 3130, 3140, 3178, 3265, 3344, 3519, 3551, 3603, 3636, 3683, 3857, 4148, 4166, 4198, 4243, 4321, 4356, 4479, 4506, 4528, 4865, 4960, 5108, 5218, 5284, 5296, 5312, 5317, 5465, 5666, 5890, 6125, 6479, 6508, 6567, 6604, 6617, 6708, 6743, 6778, 6820, 6904, 6977, 7049, 7070, 7168, 7197, 7212, 7507, 7754, 8039, 8265, 8293, 8332, 8356, 8470, 9075, 9294, 9310, 9330, 9340, 9367, 9507, 9652, 10016, 10043, 10073, 10112, 10413, 10509, 10535, 10539, 10623, 10950, 10991, 11005, 11052, 11090, 11094, 11118, 11135, 11167, 11354, 11370, 11597, 11872, 11895, 11929, 11951, 11988, 11992, 12007, 12168, 12239, 12325, 12396, 12401, 12880, 12948, 12989, 13058, 13205, 13262, 13683, 13782, 13875, 14267, 14754, 14789, 14973, 15060, 15224, 15400, 15442, 15444, 15514, 15589, 15893, 15907, 15929, 16019, 16304, 16407, 16572, 16750, 16811, 16978, 17036, 17249, 17342, 17547, 17757, 17886, 17922, 17942, 18028, 18092, 18211, 18462, 18588, 18803, 18974, 19026, 19158, 19199, 19244, 19282, 19297, 19316, 19469, 19672, 19728, 19816, 19888, 19906, 19972, 20007, 20015, 20105, 20121, 20150, 20270, 20282, 20317, 20325, 20665, 20758, 20991, 21053, 21132, 21219, 21401, 21558, 21832, 22256, 22368, 22421, 22886, 23084, 23126, 23128, 23330, 23393, 23472, 23507, 23529, 23584, 23730, 23851, 23938, 23981, 24042, 24066, 24277, 24298, 24656, 24758, 24805, 24853, 24896, 24979, 25073, 25146, 25221, 25253, 25292, 25453, 25534, 25818, 25849, 25902, 25906, 25973, 26031, 26127, 26145, 26177, 26288, 26300, 26508, 26554, 26725, 26789, 27114, 27158, 27209, 27538, 28260, 28400, 28596, 28759, 28886, 29268, 29760, 29810, 30175, 30234, 30405, 30552, 30721, 30729, 30738, 31027, 31031, 31138, 31182, 31270, 31290, 31307, 31493, 31699, 32007, 32126, 32128, 32233, 32282, 32296, 32327, 32399, 32606, 32910, 32939, 33100, 33307, 33591, 33629, 33664, 33787, 33826, 33869, 33888, 34121, 34153, 34205, 34314, 34322, 34563, 34596, 34658, 35102, 35331, 35343, 35464, 35562, 35657, 35751, 35835, 35898]","[8720, 10400, 12434, 14200, 15741, 17116, 17991]",35954,318,35636,6,312,35635,1
2.5,HSALDCG,"[88, 105, 126, 148, 265, 349, 555, 801, 962, 1014, 1283, 1421, 1914, 1921, 1952, 2098, 2481, 2486, 2637, 2641, 2663, 2668, 2674, 2939, 3110, 3121, 3162, 3186, 3250, 3289, 3366, 3386, 3402, 3411, 3551, 3567, 3700, 3894, 3994, 4097, 4326, 4340, 4346, 4350, 4434, 4460, 4817, 5029, 5038]","[2641, 2939, 3110, 3366, 3567, 3994, 4326]","[88, 105, 126, 148, 265, 349, 555, 801, 962, 1014, 1283, 1421, 1914, 1921, 1952, 2098, 2481, 2486, 2637, 2663, 2668, 2674, 3121, 3162, 3186, 3250, 3289, 3386, 3402, 3411, 3551, 3700, 3894, 4097, 4340, 4346, 4350, 4434, 4460, 4817, 5029, 5038]","[2641, 2939, 3110, 3366, 3567, 3994, 4326]",5190,49,5141,7,42,5141,0
2.5,HSAPC3A,"[102, 110, 172, 226, 357, 433, 636, 715, 859, 876, 919, 930, 1161, 1178, 1246, 1271, 1829, 1937, 2140, 2325, 2363, 2515, 2570, 2680, 2778, 3022, 3106, 3212, 3383, 3387, 3409, 3492, 3734, 3763, 3769, 3832, 3863, 3874, 3924, 3995, 4086, 4222, 4460, 4585, 4618, 4662, 4679, 5222, 5280, 5444, 5823]","[919, 1178]","[102, 110, 172, 226, 357, 433, 636, 715, 859, 876, 930, 1161, 1246, 1271, 1829, 1937, 2140, 2325, 2363, 2515, 2570, 2680, 2778, 3022, 3106, 3212, 3383, 3387, 3409, 3492, 3734, 3763, 3769, 3832, 3863, 3874, 3924, 3995, 4086, 4222, 4460, 4585, 4618, 4662, 4679, 5222, 5280, 5444, 5823]","[919, 1178]",6039,51,5988,2,49,5988,0
2.5,HSAPOA2B,"[152, 156, 168, 232, 245, 267, 338, 490, 573, 682, 686, 698, 916, 1006, 1554, 1577, 1585, 1655]","[490, 916]","[152, 156, 168, 232, 245, 267, 338, 573, 682, 686, 698, 1006, 1554, 1577, 1585, 1655]","[490, 916]",1747,18,1729,2,16,1729,0
2.5,HSAPOAIA,"[57, 134, 286, 317, 563, 583, 661, 1173, 1397, 1409, 1475, 1799, 1849, 1879, 1942, 2090, 2177]","[317, 661]","[57, 134, 286, 563, 583, 1173, 1397, 1409, 1475, 1799, 1849, 1879, 1942, 2090, 2177]","[317, 661]",2183,17,2166,2,15,2166,0
2.5,HSAPOAIT,"[120, 231, 308, 460, 491, 737, 757, 835, 866, 1348, 1572, 1584, 1650, 1974, 2024, 2054, 2117, 2143, 2265, 2353]","[491, 835]","[120, 231, 308, 460, 737, 757, 866, 1348, 1572, 1584, 1650, 1974, 2024, 2054, 2117, 2143, 2265, 2353]","[491, 835]",2377,20,2357,2,18,2357,0
2.5,HSAPOC2G,"[33, 185, 231, 255, 273, 414, 526, 606, 645, 680, 790, 822, 863, 946, 981, 1049, 1153, 1276, 1494, 1505, 1553, 1572, 1903, 1935, 1971, 2021, 2037, 2069, 2121, 2148, 2191, 2226, 2287, 2346, 2358, 2401, 2479, 2701, 2714, 2943, 2999, 3041]","[2714, 3041]","[33, 185, 231, 255, 273, 414, 526, 606, 645, 680, 790, 822, 863, 946, 981, 1049, 1153, 1276, 1494, 1505, 1553, 1572, 1903, 1935, 1971, 2021, 2037, 2069, 2121, 2148, 2191, 2226, 2287, 2346, 2358, 2401, 2479, 2701, 2943, 2999]","[2714, 3041]",3832,42,3790,2,40,3790,0
2.5,HSAQUPN2,"[236, 299, 431, 497, 632, 746, 794, 917, 969]","[431, 632, 746]","[236, 299, 497, 794, 917, 969]","[431, 632, 746]",987,9,978,3,6,978,0
2.5,HSARYLA,"[275, 329, 413, 459, 560, 848, 1039, 1091, 1160, 1238, 1571, 1815, 1906, 1970, 1991, 2004, 2052, 2141, 2175, 2252, 2470, 2479, 2528, 2613, 2666, 2765, 2823, 3040, 3087, 3162, 3282, 3320, 3400, 3416, 3432, 3452, 3499, 3567, 3591]","[848, 1238, 1571, 1815, 2252, 2470, 2823]","[275, 329, 413, 459, 560, 1039, 1091, 1160, 1906, 1970, 1991, 2004, 2052, 2141, 2175, 2479, 2528, 2613, 2666, 2765, 3040, 3087, 3162, 3282, 3320, 3400, 3416, 3432, 3452, 3499, 3567, 3591]","[848, 1238, 1571, 1815, 2252, 2470, 2823]",3629,39,3590,7,32,3590,0
2.5,HSAT3,"[66, 160, 257, 280, 327, 646, 655, 825, 1841, 1936, 1953, 2122, 2218, 2225, 2451, 2678, 2846, 2885, 3311, 3723, 4422, 4447, 4516, 4715, 4746, 4823, 4931, 4978, 5095, 5305, 5311, 5717, 5947, 6015, 6059, 6120, 6235, 6645, 6811, 6858, 6879, 6934, 6938, 7102, 7225, 7231, 8050, 8072, 8128, 8152, 8303, 8344, 8536, 8551, 8570, 8733, 8836, 9045, 9095, 9139, 9260, 9625, 9717, 9730, 10089, 10131, 10133, 10189, 10195, 10205, 10336, 10401, 10429, 10547, 10591, 10621, 10689, 10776, 10948, 11051, 11168, 11303, 11320, 11660, 11718, 11748, 11773, 11977, 12007, 12023, 12165, 12249, 12547, 12555, 12719, 12793, 12834, 13056, 13092, 13451, 13487, 13589, 13625, 13775, 13806, 13850, 14099]","[646, 3311, 6059, 7102, 8303, 10401]","[66, 160, 257, 280, 327, 655, 825, 1841, 1936, 1953, 2122, 2218, 2225, 2451, 2678, 2846, 2885, 3723, 4422, 4447, 4516, 4715, 4746, 4823, 4931, 4978, 5095, 5305, 5311, 5717, 5947, 6015, 6120, 6235, 6645, 6811, 6858, 6879, 6934, 6938, 7225, 7231, 8050, 8072, 8128, 8152, 8344, 8536, 8551, 8570, 8733, 8836, 9045, 9095, 9139, 9260, 9625, 9717, 9730, 10089, 10131, 10133, 10189, 10195, 10205, 10336, 10429, 10547, 10591, 10621, 10689, 10776, 10948, 11051, 11168, 11303, 11320, 11660, 11718, 11748, 11773, 11977, 12007, 12023, 12165, 12249, 12547, 12555, 12719, 12793, 12834, 13056, 13092, 13451, 13487, 13589, 13625, 13775, 13806, 13850, 14099]","[646, 3311, 6059, 7102, 8303, 10401]",14198,107,14091,6,101,14091,0
2.5,HSATPCP1,"[26, 146, 158, 355, 496, 534, 612, 673, 705, 831, 989, 1079, 1257, 1504, 1518, 1550, 1680, 1838, 1920, 1994, 2029, 2127, 2133, 2258, 2304, 2347, 2691, 2723, 2771, 2846, 2889, 3013, 3045, 3169, 3310, 4006, 4036, 4080, 4245, 4726, 4730, 4773, 4843, 4975, 5008, 5023, 5254, 5389, 5394, 5431, 5489, 5525, 5924, 5934, 6024, 6099, 6277, 6382, 6670, 6800, 6830, 6839, 6843, 6860, 6865, 6999, 7003, 7008, 7017, 7115, 7267, 7430, 7698, 7763, 7854, 7883, 7927, 8120, 8207, 8529, 8701, 8708, 8714, 8947, 9101, 9444]","[5389, 6382, 7267]","[26, 146, 158, 355, 496, 534, 612, 673, 705, 831, 989, 1079, 1257, 1504, 1518, 1550, 1680, 1838, 1920, 1994, 2029, 2127, 2133, 2258, 2304, 2347, 2691, 2723, 2771, 2846, 2889, 3013, 3045, 3169, 3310, 4006, 4036, 4080, 4245, 4726, 4730, 4773, 4843, 4975, 5008, 5023, 5254, 5394, 5431, 5489, 5525, 5924, 5934, 6024, 6099, 6277, 6670, 6800, 6830, 6839, 6843, 6860, 6865, 6999, 7003, 7008, 7017, 7115, 7430, 7698, 7763, 7854, 7883, 7927, 8120, 8207, 8529, 8701, 8708, 8714, 8947, 9101, 9444]","[5389, 6382, 7267]",9449,86,9363,3,83,9363,0
2.5,HSATPCP2,"[6, 41, 107, 239, 1210, 1546, 1683, 1695, 1722, 1768, 1775, 2183, 2337, 2402, 2550, 2781, 2996, 3326, 3624, 3721, 3824, 3890, 4013, 4180, 4442, 4668, 4692, 4738, 4743, 4997, 5066, 5134, 5367, 5847, 6152, 6504, 6916, 7005, 7164, 7310, 7490, 7756, 7768, 7851, 8252, 8414, 8435, 8468, 8599, 8638, 8929, 8957, 9194, 9212, 9244, 9355, 9367, 9611, 9627, 9637, 9647, 9689, 9720, 9752, 9790, 9857, 9932, 9993, 10099, 10195, 10231, 10238, 10268, 10359, 10669, 10918, 10966, 11516, 11530, 11602, 11674, 11686, 11693, 11728, 11736, 11878, 11926, 12001, 12044, 12119, 12123, 12127, 12281, 12342, 12374, 12497, 13004, 13012, 13249, 13435, 13810, 13888, 14022, 14024, 14371, 14383, 14535, 14752, 14803, 14954]","[7490, 10195, 10918]","[6, 41, 107, 239, 1210, 1546, 1683, 1695, 1722, 1768, 1775, 2183, 2337, 2402, 2550, 2781, 2996, 3326, 3624, 3721, 3824, 3890, 4013, 4180, 4442, 4668, 4692, 4738, 4743, 4997, 5066, 5134, 5367, 5847, 6152, 6504, 6916, 7005, 7164, 7310, 7756, 7768, 7851, 8252, 8414, 8435, 8468, 8599, 8638, 8929, 8957, 9194, 9212, 9244, 9355, 9367, 9611, 9627, 9637, 9647, 9689, 9720, 9752, 9790, 9857, 9932, 9993, 10099, 10231, 10238, 10268, 10359, 10669, 10966, 11516, 11530, 11602, 11674, 11686, 11693, 11728, 11736, 11878, 11926, 12001, 12044, 12119, 12123, 12127, 12281, 12342, 12374, 12497, 13004, 13012, 13249, 13435, 13810, 13888, 14022, 14024, 14371, 14383, 14535, 14752, 14803, 14954]","[7490, 10195, 10918]",15008,110,14898,3,107,14898,0
2.5,HSB3A,"[158, 223, 482, 580, 779, 890, 1118, 1175, 1424, 1432, 1843, 1847, 1901, 1940, 2085, 2210, 2455, 2623, 2640, 2655, 2659, 2670, 2725, 3047, 3139, 3166, 3203, 3474]",[1843],"[158, 223, 482, 580, 779, 890, 1118, 1175, 1424, 1432, 1847, 1901, 1940, 2085, 2210, 2455, 2623, 2640, 2655, 2659, 2670, 2725, 3047, 3139, 3166, 3203, 3474]",[1843],3675,28,3647,1,27,3647,0
2.5,HSBGPG,"[29, 151, 378, 560, 817, 832, 850, 856, 1055, 1096, 1143, 1187, 1193, 1212, 1340, 1344, 1593, 1645]","[560, 850, 1096]","[29, 151, 378, 817, 832, 856, 1055, 1143, 1187, 1193, 1212, 1340, 1344, 1593, 1645]","[560, 850, 1096]",1667,18,1649,3,15,1649,0
2.5,HSBSF2,"[238, 274, 318, 335, 477, 906, 1242, 1293, 1304, 1360, 1550, 1587, 1621, 2089, 2189, 2450, 2748, 2847, 2851, 2857, 2930, 2956, 3022, 3070, 3106, 3300, 3336, 3466, 3499, 3601, 3605, 3708, 4061, 4086, 4317, 4358, 4427, 4505, 4665, 4715, 4895, 4943, 4992, 5140, 5556, 5613, 5688, 5953]","[1242, 1587, 2748, 3601]","[238, 274, 318, 335, 477, 906, 1293, 1304, 1360, 1550, 1621, 2089, 2189, 2450, 2847, 2851, 2857, 2930, 2956, 3022, 3070, 3106, 3300, 3336, 3466, 3499, 3605, 3708, 4061, 4086, 4317, 4358, 4427, 4505, 4665, 4715, 4895, 4943, 4992, 5140, 5556, 5613, 5688, 5953]","[1242, 1587, 2748, 3601]",5953,48,5905,4,44,5905,0
2.5,HSCBMYHC,"[62, 172, 278, 297, 345, 369, 536, 649, 860, 1453, 1577, 2228, 2258, 2489, 2532, 2583, 2735, 2805, 2858, 2868, 2902, 2911, 3016, 3181, 3193, 3218, 3293, 3301, 3493, 3592, 3607, 3819, 3828, 3833, 3932, 3967, 4092, 4207, 4263, 4585, 4595, 4612, 4644, 4776, 4881, 4906, 4921, 5041, 5485, 5644, 5708, 6160, 6354, 6529, 6694, 6814, 7026, 7246, 7567, 7575, 7609, 7671, 7735, 7894, 7912, 7962, 8095, 8354, 8647, 8850, 8867, 8898, 8924, 8933, 8950, 9024, 9084, 9174, 9288, 9626, 9885, 9909, 9985, 10076, 10530, 10535, 10554, 10667, 10877, 11339, 11483, 11529, 11536, 11847, 12039, 12082, 12155, 12159, 12229, 12277, 12303, 12427, 12528, 12635, 12786, 12825, 12829, 12988, 13037, 13099, 13342, 13849, 14042, 14210, 14352, 14394, 14571, 14700, 14806, 14929, 15120, 15253, 15375, 15416, 15683, 15784, 16013, 16076, 16321, 16403, 16410, 16618, 16665, 17120, 17125, 17284, 17368, 17811, 17895, 18138, 18228, 18590, 18734, 18777, 18896, 19130, 19214, 19262, 19469, 19970, 19981, 20028, 20057, 20132, 20176, 20604, 20964, 21352, 21466, 21505, 21576, 21810, 21818, 21839, 22088, 22149, 22153, 22369, 22423, 22474, 22486, 22643, 23176, 23209, 23454, 23605, 23701, 23830, 24128, 24278, 24702, 24716, 24751, 24794, 24854]","[4595, 5041, 5485, 5644, 6354, 6529, 6694, 7246, 7567, 8354, 8898, 9174, 9626, 10530, 10877, 11339, 12155, 12427, 12829, 13342, 14210, 14571, 17120, 18228, 18590, 18896, 19262, 19970, 20604, 21466, 21839, 22088, 22474, 23454, 23701]","[62, 172, 278, 297, 345, 369, 536, 649, 860, 1453, 1577, 2228, 2258, 2489, 2532, 2583, 2735, 2805, 2858, 2868, 2902, 2911, 3016, 3181, 3193, 3218, 3293, 3301, 3493, 3592, 3607, 3819, 3828, 3833, 3932, 3967, 4092, 4207, 4263, 4585, 4612, 4644, 4776, 4881, 4906, 4921, 5708, 6160, 6814, 7026, 7575, 7609, 7671, 7735, 7894, 7912, 7962, 8095, 8647, 8850, 8867, 8924, 8933, 8950, 9024, 9084, 9288, 9885, 9909, 9985, 10076, 10535, 10554, 10667, 11483, 11529, 11536, 11847, 12039, 12082, 12159, 12229, 12277, 12303, 12528, 12635, 12786, 12825, 12988, 13037, 13099, 13849, 14042, 14352, 14394, 14700, 14806, 14929, 15120, 15253, 15375, 15416, 15683, 15784, 16013, 16076, 16321, 16403, 16410, 16618, 16665, 17125, 17284, 17368, 17811, 17895, 18138, 18734, 18777, 19130, 19214, 19469, 19981, 20028, 20057, 20132, 20176, 20964, 21352, 21505, 21576, 21810, 21818, 22149, 22153, 22369, 22423, 22486, 22643, 23176, 23209, 23605, 23830, 24128, 24278, 24702, 24716, 24751, 24794, 24854]","[4595, 5041, 5485, 5644, 6354, 6529, 6694, 7246, 7567, 8354, 8898, 9174, 9626, 10530, 10877, 11339, 12155, 12427, 12829, 13342, 14210, 14571, 15900, 17120, 18228, 18590, 18896, 19262, 19970, 20319, 20604, 21466, 21839, 22088, 22474, 23454, 23701]",24992,185,24807,35,150,24805,2
2.5,HSCD14G,"[79, 159, 317, 412, 486, 514, 562, 763, 811, 986, 1114, 1318]",[159],"[79, 317, 412, 486, 514, 562, 763, 811, 986, 1114, 1318]",[159],1562,12,1550,1,11,1550,0
2.5,HSCKBG,"[98, 236, 251, 347, 381, 657, 876, 1075, 1244, 1261, 1341, 1619, 1733, 1824, 2068, 2099, 2124, 2373, 2380, 2458, 2552, 2570, 2638, 2643, 2746, 2800, 2877, 3022, 3075, 3174, 3220, 3280, 3434, 3484, 3521, 3534, 3603, 3620, 3671, 4078]","[1341, 1619, 1824, 2380, 3174, 3521]","[98, 236, 251, 347, 381, 657, 876, 1075, 1244, 1261, 1733, 2068, 2099, 2124, 2373, 2458, 2552, 2570, 2638, 2643, 2746, 2800, 2877, 3022, 3075, 3220, 3280, 3434, 3484, 3534, 3603, 3620, 3671, 4078]","[1341, 1619, 1824, 2380, 3174, 3521]",4192,40,4152,6,34,4152,0
2.5,HSCOMT2,"[197, 284, 329, 589, 600, 636, 703, 709, 911, 936, 1064, 1075, 1110, 1285, 1495, 1614, 1630, 1651, 1959, 2128, 2188, 2212, 2220, 2299, 2350, 2378, 2513, 2547, 2561, 2651, 2755, 2827, 2897, 2920, 3082, 3091, 3503, 3628]","[1630, 1959, 2378]","[197, 284, 329, 589, 600, 636, 703, 709, 911, 936, 1064, 1075, 1110, 1285, 1495, 1614, 1651, 2128, 2188, 2212, 2220, 2299, 2350, 2513, 2547, 2561, 2651, 2755, 2827, 2897, 2920, 3082, 3091, 3503, 3628]","[1630, 1959, 2378]",3643,38,3605,3,35,3605,0
2.5,HSCPH70,"[11, 205, 297, 633, 773, 829, 865, 926, 1057, 1153, 1302, 1729, 1784, 2226, 2228, 2336, 2552, 2669, 2820, 2936, 3115, 3200, 3260, 3382, 3416, 3675, 3831, 3895, 4077, 4204, 4283, 4407, 4801, 4807, 5060, 5251, 5376, 5666, 6024, 6065, 6215, 6584]","[1729, 4204, 4407, 4801]","[11, 205, 297, 633, 773, 829, 865, 926, 1057, 1153, 1302, 1784, 2226, 2228, 2336, 2552, 2669, 2820, 2936, 3115, 3200, 3260, 3382, 3416, 3675, 3831, 3895, 4077, 4283, 4807, 5060, 5251, 5376, 5666, 6024, 6065, 6215, 6584]","[1729, 4204, 4407, 4801]",6703,42,6661,4,38,6661,0
2.5,HSCSF1PO,"[359, 409, 496, 522, 534, 569, 678, 779, 984, 1290, 1415, 1433, 1815, 1965, 1983, 2119, 2385, 2428, 2591, 2619, 2704, 2816, 3283, 3327, 3471, 3691, 3732, 3740, 3777, 3815, 4479, 4703, 4825, 4843, 5053, 5071, 5252, 5393, 5398, 5400, 5510, 5647, 5682, 5857, 5956, 6017, 6165, 6173, 6274, 6579, 6651, 6702, 6706, 6732, 6793, 7061, 7314, 7376, 7572, 7831, 7943, 8091, 8115, 8121, 8250, 8287, 8459, 8486, 8645, 8680, 8694, 8699, 8725, 8843, 8847, 8876, 8888, 8943, 9217, 9445, 9575, 9595, 9637, 9654, 9665, 9758, 9774, 9857, 9882, 10134, 10227, 10249, 10389, 10444, 10448, 10517, 10783, 11059, 11063, 11092, 11111, 11483, 11515, 11536, 11661, 11707, 11723, 12101, 12110, 12153, 12228, 12296, 12362, 12404, 12436, 12482, 12710, 12899, 12926, 12953, 12975, 13021, 13038, 13044, 13281, 13389, 13421, 13436, 13526, 13628, 13657, 13951, 14345, 14485, 14499, 14645, 14683, 14719, 14890, 15036, 15082, 15556, 15733, 15783, 15792, 15804, 16061, 16088, 16103, 16105, 16720, 16740, 16787, 17132, 17256, 17409, 17480, 17882, 17968, 17972, 17990, 18046, 18105, 18156, 18208, 18274, 18299, 18350, 18356, 18425, 18465, 18756, 19403, 19552, 19724, 20123, 20151, 20159, 20177, 20257, 20336, 20510, 20870, 20924, 21307, 21311, 21348, 21405, 21438, 21444, 21461, 21515, 21611, 21638, 21973, 21988, 22040, 22203, 23086, 23163, 23198, 23238, 23437, 23668, 24053, 24059, 24072, 24247, 24260, 24264, 24430, 24611, 24703, 24749, 24806, 24822, 24903, 25151, 25196, 25234, 25492, 25661, 25690, 25783, 25817, 25831, 25977, 26033, 26044, 26090, 26095, 26486, 26605, 26721, 26732, 26764, 26815, 26837, 26841, 26888, 26963, 26983, 27465, 27659, 27837, 27905, 28041, 28345, 28627, 28660, 28964, 28989, 29084, 29206, 29410, 29782, 29786, 29926, 30172, 30327, 30341, 30549, 30657, 30823, 30890, 30897, 31040, 31077, 31133, 31141, 31158, 31254, 31270, 31351, 31408, 31663, 31739, 31764, 31836, 31855, 31903, 31942, 32010, 32108, 32146, 32301, 32398, 32402, 32862, 32894, 33017, 33041, 33091, 33463, 33698, 33729, 33743, 33816, 33832, 34006, 34015, 34027, 34038, 34158, 34182, 34399, 34417, 34668, 34831]","[1965, 7572, 8287, 10227, 11063, 15036, 17882, 18156, 18465, 20123, 26605, 26837, 27465, 28627, 30823, 31040, 32108, 32301, 33091, 34006]","[359, 409, 496, 522, 534, 569, 678, 779, 984, 1290, 1415, 1433, 1815, 1983, 2119, 2385, 2428, 2591, 2619, 2704, 2816, 3283, 3327, 3471, 3691, 3732, 3740, 3777, 3815, 4479, 4703, 4825, 4843, 5053, 5071, 5252, 5393, 5398, 5400, 5510, 5647, 5682, 5857, 5956, 6017, 6165, 6173, 6274, 6579, 6651, 6702, 6706, 6732, 6793, 7061, 7314, 7376, 7831, 7943, 8091, 8115, 8121, 8250, 8459, 8486, 8645, 8680, 8694, 8699, 8725, 8843, 8847, 8876, 8888, 8943, 9217, 9445, 9575, 9595, 9637, 9654, 9665, 9758, 9774, 9857, 9882, 10134, 10249, 10389, 10444, 10448, 10517, 10783, 11059, 11092, 11111, 11483, 11515, 11536, 11661, 11707, 11723, 12101, 12110, 12153, 12228, 12296, 12362, 12404, 12436, 12482, 12710, 12899, 12926, 12953, 12975, 13021, 13038, 13044, 13281, 13389, 13421, 13436, 13526, 13628, 13657, 13951, 14345, 14485, 14499, 14645, 14683, 14719, 14890, 15082, 15556, 15733, 15783, 15792, 15804, 16061, 16088, 16103, 16105, 16720, 16740, 16787, 17132, 17256, 17409, 17480, 17968, 17972, 17990, 18046, 18105, 18208, 18274, 18299, 18350, 18356, 18425, 18756, 19403, 19552, 19724, 20151, 20159, 20177, 20257, 20336, 20510, 20870, 20924, 21307, 21311, 21348, 21405, 21438, 21444, 21461, 21515, 21611, 21638, 21973, 21988, 22040, 22203, 23086, 23163, 23198, 23238, 23437, 23668, 24053, 24059, 24072, 24247, 24260, 24264, 24430, 24611, 24703, 24749, 24806, 24822, 24903, 25151, 25196, 25234, 25492, 25661, 25690, 25783, 25817, 25831, 25977, 26033, 26044, 26090, 26095, 26486, 26721, 26732, 26764, 26815, 26841, 26888, 26963, 26983, 27659, 27837, 27905, 28041, 28345, 28660, 28964, 28989, 29084, 29206, 29410, 29782, 29786, 29926, 30172, 30327, 30341, 30549, 30657, 30890, 30897, 31077, 31133, 31141, 31158, 31254, 31270, 31351, 31408, 31663, 31739, 31764, 31836, 31855, 31903, 31942, 32010, 32146, 32398, 32402, 32862, 32894, 33017, 33041, 33463, 33698, 33729, 33743, 33816, 33832, 34015, 34027, 34038, 34158, 34182, 34399, 34417, 34668, 34831]","[1965, 7572, 8287, 10227, 11063, 15036, 17882, 18156, 18465, 20123, 26605, 26837, 27465, 28627, 30823, 31040, 32108, 32301, 33091, 34006]",35092,309,34783,20,289,34783,0
2.5,HSCST3G,"[153, 213, 245, 271, 330, 394, 536, 888, 931, 936, 1006, 1145, 1190, 1285, 1307, 1310, 1328, 1661, 1920, 2234, 2262, 2342, 3064, 3120, 3155, 3159, 3178, 3443, 3468, 3526, 3694, 3740, 3783, 3865, 3879, 3883, 3934, 3938, 4063, 4077, 4087, 4111, 4117, 4123, 4129, 4229, 4620, 4720, 4741, 4813, 5241, 5248, 5518, 5573, 5594, 5990, 6231, 6293, 6448, 6521, 6582, 6589, 6610, 6632, 6743, 6921, 7112, 7200]","[1328, 3694]","[153, 213, 245, 271, 330, 394, 536, 888, 931, 936, 1006, 1145, 1190, 1285, 1307, 1310, 1661, 1920, 2234, 2262, 2342, 3064, 3120, 3155, 3159, 3178, 3443, 3468, 3526, 3740, 3783, 3865, 3879, 3883, 3934, 3938, 4063, 4077, 4087, 4111, 4117, 4123, 4129, 4229, 4620, 4720, 4741, 4813, 5241, 5248, 5518, 5573, 5594, 5990, 6231, 6293, 6448, 6521, 6582, 6589, 6610, 6632, 6743, 6921, 7112, 7200]","[1328, 3694]",7284,68,7216,2,66,7216,0
2.5,HSCYCLA,"[55, 274, 407, 1029, 1049, 1098, 1102, 1333, 1393, 1422, 1530, 1861, 2313, 2406, 2439, 2509, 2782, 2940, 2954, 3031, 3463, 3668, 3731, 3877, 3962, 3999, 4024, 4034, 4111, 4168, 4239, 4266, 4464, 4475, 4520, 4538, 4614, 5338, 5365, 5389, 5439, 5478, 5670, 5911, 6059, 6070, 6160, 6294, 6323, 6483, 6667, 6866, 6906, 6910, 6982, 7024, 7200, 7439, 7622, 7637, 7654, 7956, 7973, 8050, 8113]","[1393, 2406, 3731, 4168, 5338, 5911, 6667]","[55, 274, 407, 1029, 1049, 1098, 1102, 1333, 1422, 1530, 1861, 2313, 2439, 2509, 2782, 2940, 2954, 3031, 3463, 3668, 3877, 3962, 3999, 4024, 4034, 4111, 4239, 4266, 4464, 4475, 4520, 4538, 4614, 5365, 5389, 5439, 5478, 5670, 6059, 6070, 6160, 6294, 6323, 6483, 6866, 6906, 6910, 6982, 7024, 7200, 7439, 7622, 7637, 7654, 7956, 7973, 8050, 8113]","[1393, 2406, 3731, 4168, 5338, 5911, 6667]",8355,65,8290,7,58,8290,0
2.5,HSCYP216,"[255, 302, 442, 567, 629, 665, 874, 879, 908, 1088, 1278, 1466, 1475, 1836, 1888, 2153, 2215, 2239, 2402, 2549, 2710]","[255, 442, 879, 1088, 1278, 1466, 1836, 2215, 2402]","[302, 567, 629, 665, 874, 908, 1475, 1888, 2153, 2239, 2549, 2710]","[255, 442, 879, 1088, 1278, 1466, 1836, 2215, 2402]",2763,21,2742,9,12,2742,0
2.5,HSCYP45C,"[138, 185, 263, 626, 731, 805, 810, 828, 947, 1020, 1256, 1300, 1659, 1688, 1772, 1977, 2048, 2179, 2612, 2638, 2667, 2854, 3045, 3268, 3358, 3538, 3542, 3642, 3674, 3695, 3731, 3745, 3975, 4323, 4405, 4469, 4603, 4680, 4942, 4963, 4970, 5008, 5333, 5447, 5624, 5758, 5773, 5801, 5826, 6016, 6081, 6248, 6517, 6525, 6562, 6694, 6935, 7081, 7327, 7429]","[4942, 5624, 5801, 6016, 6248]","[138, 185, 263, 626, 731, 805, 810, 828, 947, 1020, 1256, 1300, 1659, 1688, 1772, 1977, 2048, 2179, 2612, 2638, 2667, 2854, 3045, 3268, 3358, 3538, 3542, 3642, 3674, 3695, 3731, 3745, 3975, 4323, 4405, 4469, 4603, 4680, 4963, 4970, 5008, 5333, 5447, 5758, 5773, 5826, 6081, 6517, 6525, 6562, 6694, 6935, 7081, 7327, 7429]","[4942, 5624, 5801, 6016, 6248]",7546,60,7486,5,55,7486,0
2.5,HSCYTOK17,"[396, 452, 488, 505, 581, 594, 958, 982, 1422, 1427, 1572, 1709, 1764, 1822, 1951, 1963, 2079, 2147, 2304, 2342, 2401, 2571, 2582, 2850, 2857, 2928, 2935, 3008, 3066, 3131, 3158, 3171, 3245, 3249, 3257, 3288, 3382, 3468, 3601, 3625, 3693, 4000, 4046, 4123, 4320, 4840, 4972, 4987]","[581, 1709, 2304, 3066, 3693, 4000, 4123]","[396, 452, 488, 505, 594, 958, 982, 1422, 1427, 1572, 1764, 1822, 1951, 1963, 2079, 2147, 2342, 2401, 2571, 2582, 2850, 2857, 2928, 2935, 3008, 3131, 3158, 3171, 3245, 3249, 3257, 3288, 3382, 3468, 3601, 3625, 4046, 4320, 4840, 4972, 4987]","[581, 1709, 2304, 3066, 3693, 4000, 4123]",5252,48,5204,7,41,5204,0
2.5,HSCYTOK20,"[60, 116, 203, 729, 1063, 1277, 1871, 2073, 2166, 2287, 2321, 2418, 2515, 2601, 2644, 3128, 3978, 4019, 4075, 4111, 4131, 4531, 4732, 4869, 5047, 5152, 5205, 5281, 5352, 6228, 6824, 7135, 7290, 7458, 7512, 7646, 7660, 7789, 8061, 8134, 8449, 8722, 8760, 8860, 8864, 9313, 9470, 9642, 9926, 9984, 10005, 10271, 10304, 10620, 10714, 10828, 10916, 10968, 11052, 11083, 11131, 11206, 11346, 11408, 11421, 11428, 11458, 11499, 11935, 11940, 11978, 12125, 12146, 12458, 12705, 12778, 12783, 12902, 12915, 13053, 13847, 13941, 14034, 14099, 14477, 14592, 15297, 15302, 15384, 15899, 15935, 15989, 16190, 16343, 16347, 16419, 16498, 16620, 16625, 16791, 17070, 17174, 17199, 17254]","[5281, 7512, 9470, 9984, 10271, 11940, 12705]","[60, 116, 203, 729, 1063, 1277, 1871, 2073, 2166, 2287, 2321, 2418, 2515, 2601, 2644, 3128, 3978, 4019, 4075, 4111, 4131, 4531, 4732, 4869, 5047, 5152, 5205, 5352, 6228, 6824, 7135, 7290, 7458, 7646, 7660, 7789, 8061, 8134, 8449, 8722, 8760, 8860, 8864, 9313, 9642, 9926, 10005, 10304, 10620, 10714, 10828, 10916, 10968, 11052, 11083, 11131, 11206, 11346, 11408, 11421, 11428, 11458, 11499, 11935, 11978, 12125, 12146, 12458, 12778, 12783, 12902, 12915, 13053, 13847, 13941, 14034, 14099, 14477, 14592, 15297, 15302, 15384, 15899, 15935, 15989, 16190, 16343, 16347, 16419, 16498, 16620, 16625, 16791, 17070, 17174, 17199, 17254]","[5281, 7512, 9470, 9984, 10271, 11940, 12705]",18053,104,17949,7,97,17949,0
2.5,HSDAO,"[129, 158, 413, 537, 588, 956, 1035, 1080, 1111, 1177, 1263, 1329, 1381, 1437, 1526, 1635, 1665, 1699, 1710, 1738, 1751, 2046, 2183, 2197, 2229, 2345, 2351, 2551, 2582, 2775, 2877, 2941, 2974, 3142, 3156, 3236, 3597, 3885, 3987, 4423, 4465, 4584, 4623, 5121, 5254, 5296, 5561, 5611, 5744, 5903, 5929, 5965, 6165, 6200, 6275, 6426, 6592, 6684, 6696, 6983, 7299, 7384, 7431, 7461, 7548, 7594, 7766, 7871, 7903, 8028, 8329, 8347, 8419, 8502, 8537, 8701, 8880, 8901, 9013, 9040, 9276, 9337, 9343, 9707]","[6426, 7431, 9013]","[129, 158, 413, 537, 588, 956, 1035, 1080, 1111, 1177, 1263, 1329, 1381, 1437, 1526, 1635, 1665, 1699, 1710, 1738, 1751, 2046, 2183, 2197, 2229, 2345, 2351, 2551, 2582, 2775, 2877, 2941, 2974, 3142, 3156, 3236, 3597, 3885, 3987, 4423, 4465, 4584, 4623, 5121, 5254, 5296, 5561, 5611, 5744, 5903, 5929, 5965, 6165, 6200, 6275, 6592, 6684, 6696, 6983, 7299, 7384, 7461, 7548, 7594, 7766, 7871, 7903, 8028, 8329, 8347, 8419, 8502, 8537, 8701, 8880, 8901, 9040, 9276, 9337, 9343, 9707]","[6426, 7431, 9013]",9895,84,9811,3,81,9811,0
2.5,HSERPG,"[143, 563, 628, 765, 868, 1015, 1115, 1303, 1340, 1683, 1774, 1900, 1943, 2026, 2069, 2119, 2253, 2290, 2423, 2474, 2509, 2768, 3230]","[628, 1340, 1683, 2474]","[143, 563, 765, 868, 1015, 1115, 1303, 1774, 1900, 1943, 2026, 2069, 2119, 2253, 2290, 2423, 2509, 2768, 3230]","[628, 1340, 1683, 2474]",3390,23,3367,4,19,3367,0
2.5,HSFAU1,"[80, 327, 335, 343, 375, 432, 484, 505, 547, 655, 824, 857, 870, 947, 1096, 1100, 1129, 1140, 1186, 1557, 1592, 1599, 1613, 1617, 1787, 1821, 2004]","[857, 1096, 1613]","[80, 327, 335, 343, 375, 432, 484, 505, 547, 655, 824, 870, 947, 1100, 1129, 1140, 1186, 1557, 1592, 1599, 1617, 1787, 1821, 2004]","[857, 1096, 1613]",2008,27,1981,3,24,1981,0
2.5,HSFESFPS,"[8, 13, 292, 353, 507, 513, 543, 608, 614, 728, 738, 771, 791, 856, 872, 1227, 1248, 1553, 1650, 1781, 1827, 1889, 1980, 2210, 2415, 2580, 2695, 2790, 2821, 3003, 3023, 3083, 3180, 3336, 3435, 3637, 3645, 3726, 3769, 3797, 3873, 3923, 4008, 4027, 4510, 4522, 4532, 4547, 4663, 5028, 5154, 5399, 5405, 5534, 5598, 5706, 5924, 6108, 6240, 6445, 6682, 6767, 6835, 6970, 6999, 7063, 7089, 7102, 7150, 7230, 7330, 7345, 7634, 7686, 7757, 7836, 7851, 8020, 8052, 8069, 8349, 8546, 8582, 8598, 8640, 8720, 8782, 9087, 9151, 9176, 9193, 9198, 9294, 9315, 9371, 9424, 9635, 9734, 9768, 10015, 10314, 10360, 10445, 10483, 10586, 10626, 10652, 10664, 10699, 10796, 10953, 10965, 10996, 11000, 11068, 11079, 11128, 11196, 11300, 11349, 11511, 11788, 11822, 11865, 12020, 12024, 12034, 12062, 12225]","[1227, 1553, 3023, 3336, 5405, 5598, 5924, 6240, 6445, 7150, 7634, 8069, 8782, 9151, 9371, 9768, 10015]","[8, 13, 292, 353, 507, 513, 543, 608, 614, 728, 738, 771, 791, 856, 872, 1248, 1650, 1781, 1827, 1889, 1980, 2210, 2415, 2580, 2695, 2790, 2821, 3003, 3083, 3180, 3435, 3637, 3645, 3726, 3769, 3797, 3873, 3923, 4008, 4027, 4510, 4522, 4532, 4547, 4663, 5028, 5154, 5399, 5534, 5706, 6108, 6682, 6767, 6835, 6970, 6999, 7063, 7089, 7102, 7230, 7330, 7345, 7686, 7757, 7836, 7851, 8020, 8052, 8349, 8546, 8582, 8598, 8640, 8720, 9087, 9176, 9193, 9198, 9294, 9315, 9424, 9635, 9734, 10314, 10360, 10445, 10483, 10586, 10626, 10652, 10664, 10699, 10796, 10953, 10965, 10996, 11000, 11068, 11079, 11128, 11196, 11300, 11349, 11511, 11788, 11822, 11865, 12020, 12024, 12034, 12062, 12225]","[1227, 1553, 3023, 3336, 5405, 5598, 5924, 6240, 6445, 7150, 7634, 8069, 8782, 9151, 9371, 9768, 10015]",12255,129,12126,17,112,12126,0
2.5,HSGCSFG,"[82, 264, 404, 540, 690, 735, 739, 744, 748, 774, 894, 970, 1230, 1521, 1999, 2040, 2048, 2121, 2180, 2296, 2481, 2514, 2770, 2790, 2802]","[404, 744, 1230, 1521]","[82, 264, 540, 690, 735, 739, 748, 774, 894, 970, 1999, 2040, 2048, 2121, 2180, 2296, 2481, 2514, 2770, 2790, 2802]","[404, 744, 1230, 1521]",2952,25,2927,4,21,2927,0
2.5,HSGEBCMA,"[334, 607, 700, 888, 970, 983, 1036, 1050, 1082, 1137, 1194, 1206, 1294, 1349, 1496, 1508, 1545, 1648, 1697, 1831, 2106, 2128, 2292, 2430, 2538, 2587, 2766, 2989, 3234, 3273, 3279, 3292, 3409, 3441, 3489, 3552, 3607]","[607, 1496]","[334, 700, 888, 970, 983, 1036, 1050, 1082, 1137, 1194, 1206, 1294, 1349, 1508, 1545, 1648, 1697, 1831, 2106, 2128, 2292, 2430, 2538, 2587, 2766, 2989, 3234, 3273, 3279, 3292, 3409, 3441, 3489, 3552, 3607]","[607, 1496]",3711,37,3674,2,35,3674,0
2.5,HSGGL2,"[164, 202, 212, 433, 547, 632, 882, 1055, 1067, 1149, 1195, 1333, 1431, 1476, 1500]","[202, 547]","[164, 212, 433, 632, 882, 1055, 1067, 1149, 1195, 1333, 1431, 1476, 1500]","[202, 547]",1620,15,1605,2,13,1605,0
2.5,HSGLA,"[94, 184, 779, 821, 852, 868, 885, 901, 937, 955, 995, 1102, 1374, 1422, 1822, 1826, 2011, 2148, 2339, 2363, 2370, 2472, 2494, 2499, 2840, 3131, 3192, 3422, 3424, 3717, 4062, 4106, 4149, 4165, 4224, 4267, 4397, 4435, 4469, 4608, 5022, 5040, 5093, 5269, 5308, 5451, 5500, 5575, 5717, 5731, 5821, 6208, 6672, 6706, 6740, 6784, 6884, 6958, 6983, 7164, 7241, 7447, 7846, 7915, 8012, 8044, 8167, 8378, 8413, 8421, 9335, 10293, 10329, 10359, 10369, 10395, 10453, 10692, 10708, 11096, 11400, 11432, 11472, 11689, 11761, 12168, 12200, 12244, 12322, 12358]","[1374, 5269, 7447, 8413, 10293, 10708]","[94, 184, 779, 821, 852, 868, 885, 901, 937, 955, 995, 1102, 1422, 1822, 1826, 2011, 2148, 2339, 2363, 2370, 2472, 2494, 2499, 2840, 3131, 3192, 3422, 3424, 3717, 4062, 4106, 4149, 4165, 4224, 4267, 4397, 4435, 4469, 4608, 5022, 5040, 5093, 5308, 5451, 5500, 5575, 5717, 5731, 5821, 6208, 6672, 6706, 6740, 6784, 6884, 6958, 6983, 7164, 7241, 7846, 7915, 8012, 8044, 8167, 8378, 8421, 9335, 10329, 10359, 10369, 10395, 10453, 10692, 11096, 11400, 11432, 11472, 11689, 11761, 12168, 12200, 12244, 12322, 12358]","[1374, 5269, 7447, 8413, 10293, 10708]",12428,90,12338,6,84,12338,0
2.5,HSGROW2,"[12, 92, 175, 211, 345, 433, 462, 471, 762, 781, 899, 951, 1091, 1349]","[345, 762, 1091, 1349]","[12, 92, 175, 211, 433, 462, 471, 781, 899, 951]","[345, 762, 1091, 1349]",1956,14,1942,4,10,1942,0
2.5,HSGSTM4,"[18, 37, 41, 73, 117, 207, 228, 391, 466, 522, 578, 778, 874, 907, 1262, 1268, 1283, 1296, 1357, 1458, 1785, 1793, 2098, 2142, 2232, 2350, 2453, 2469, 2670, 2856, 2907, 2960, 3139, 3202, 3246, 3277, 3366, 3430, 3484, 3511, 3516, 3532, 3623, 3766, 3773, 3933, 3953, 3984, 3991, 4183, 4343, 4381, 4404, 4445, 4648]","[37, 391, 874, 1262, 1458, 2469, 2670]","[18, 41, 73, 117, 207, 228, 466, 522, 578, 778, 907, 1268, 1283, 1296, 1357, 1785, 1793, 2098, 2142, 2232, 2350, 2453, 2856, 2907, 2960, 3139, 3202, 3246, 3277, 3366, 3430, 3484, 3511, 3516, 3532, 3623, 3766, 3773, 3933, 3953, 3984, 3991, 4183, 4343, 4381, 4404, 4445, 4648]","[37, 391, 874, 1262, 1458, 2469, 2670]",4834,55,4779,7,48,4779,0
2.5,HSGTRH,"[143, 442, 515, 536, 1000, 1193, 1251, 1293, 1301, 1615, 1847, 1927, 1965, 2111, 2205, 2322, 2431, 2502, 2809, 2814, 3141, 3732, 3816, 3949, 4747, 5548, 5598, 5640, 5645, 5711, 5758, 5766, 5921, 5926, 6094, 6244, 6256, 6275, 6449, 6552, 6762]","[2205, 3816]","[143, 442, 515, 536, 1000, 1193, 1251, 1293, 1301, 1615, 1847, 1927, 1965, 2111, 2322, 2431, 2502, 2809, 2814, 3141, 3732, 3949, 4747, 5548, 5598, 5640, 5645, 5711, 5758, 5766, 5921, 5926, 6094, 6244, 6256, 6275, 6449, 6552, 6762]","[2205, 3816]",7216,41,7175,2,39,7175,0
2.5,HSHMG17G,"[25, 139, 156, 283, 400, 651, 845, 856, 911, 1043, 1117, 1269, 1538, 1643, 1685, 1793, 1798, 2037, 2061, 2279, 2300, 2335, 2524, 2927, 2946, 3134, 3403, 3415, 3473, 3620, 3705, 4021, 4342, 4469, 4553, 4815, 4833, 4854, 4929, 5014, 5030, 5067, 5882, 5920, 5937, 5946, 6047, 6297, 6302, 6442, 6844, 6906, 7062, 7087, 7188]","[2524, 3415, 3620, 4021, 4553]","[25, 139, 156, 283, 400, 651, 845, 856, 911, 1043, 1117, 1269, 1538, 1643, 1685, 1793, 1798, 2037, 2061, 2279, 2300, 2335, 2927, 2946, 3134, 3403, 3473, 3705, 4342, 4469, 4815, 4833, 4854, 4929, 5014, 5030, 5067, 5882, 5920, 5937, 5946, 6047, 6297, 6302, 6442, 6844, 6906, 7062, 7087, 7188]","[2524, 3415, 3620, 4021, 4553]",7187,55,7132,5,50,7132,0
2.5,HSHNRNPA,"[44, 49, 220, 271, 318, 458, 481, 707, 814, 868, 1086, 1159, 1494, 1751, 1789, 1891, 1936, 1940, 2100, 2185, 2295, 2319, 2337, 2481, 2511, 2530, 2615, 2660, 2723, 2794, 2869, 2927, 2988, 3069, 3229, 3559, 3602, 3773, 3926, 3962, 3967, 4252, 4312, 4316, 4914, 4954, 5159, 5254]","[814, 1494, 1936, 2295, 2481, 2660, 2869, 3962]","[44, 49, 220, 271, 318, 458, 481, 707, 868, 1086, 1159, 1751, 1789, 1891, 1940, 2100, 2185, 2319, 2337, 2511, 2530, 2615, 2723, 2794, 2927, 2988, 3069, 3229, 3559, 3602, 3773, 3926, 3967, 4252, 4312, 4316, 4914, 4954, 5159, 5254]","[814, 1494, 1936, 2295, 2481, 2660, 2869, 3962]",5360,48,5312,8,40,5312,0
2.5,HSHOX51,"[9, 117, 204, 268, 282, 427, 460, 517, 698, 703, 752, 760, 856, 862, 1032, 1043, 1278, 1300, 1425, 1475, 1547, 1640, 1651, 1791, 1959, 2036, 2042, 2052, 2120, 2126, 2130, 2201, 2246, 2260, 2347, 2393, 2401, 2415, 2419, 2425, 2519, 2611, 2690, 3022, 3242, 3341, 3558, 3601, 3803, 3985, 4023, 4643, 4748, 4921, 4940, 5208, 5604, 5898, 6206, 6276]",[2052],"[9, 117, 204, 268, 282, 427, 460, 517, 698, 703, 752, 760, 856, 862, 1032, 1043, 1278, 1300, 1425, 1475, 1547, 1640, 1651, 1791, 1959, 2036, 2042, 2120, 2126, 2130, 2201, 2246, 2260, 2347, 2393, 2401, 2415, 2419, 2425, 2519, 2611, 2690, 3022, 3242, 3341, 3558, 3601, 3803, 3985, 4023, 4643, 4748, 4921, 4940, 5208, 5604, 5898, 6206, 6276]",[2052],6297,60,6237,1,59,6237,0
2.5,HSHSC70,"[27, 31, 41, 54, 59, 63, 119, 229, 305, 456, 470, 499, 681, 777, 852, 913, 1194, 1245, 1313, 1419, 1644, 1773, 1778, 1790, 1988, 2052, 2250, 2337, 2533, 2550, 2781, 2887, 2893, 2902, 2938, 3293, 3307, 3692, 3734, 3793, 3841, 3908, 4114, 4169, 4329, 4343, 4735, 4819, 4910, 4919, 4929, 5017, 5145, 5194, 5253, 5330, 5378]","[1245, 1773, 2250, 2893, 3307, 3734, 4114]","[27, 31, 41, 54, 59, 63, 119, 229, 305, 456, 470, 499, 681, 777, 852, 913, 1194, 1313, 1419, 1644, 1778, 1790, 1988, 2052, 2337, 2533, 2550, 2781, 2887, 2902, 2938, 3293, 3692, 3793, 3841, 3908, 4169, 4329, 4343, 4735, 4819, 4910, 4919, 4929, 5017, 5145, 5194, 5253, 5330, 5378]","[1245, 1773, 2250, 2893, 3307, 3734, 4114]",5400,57,5343,7,50,5343,0
2.5,HSIFNAR,"[197, 329, 365, 394, 429, 549, 568, 583, 616, 631, 654, 669, 712, 731, 830, 869, 1043, 1122, 1139, 1190, 1218, 1356, 1404, 1420, 1437, 1540, 1597, 1942, 2036, 2165, 2167, 2445, 2605, 2612, 2632, 2684, 2696, 2807, 2990, 3071, 3297, 3337, 4103, 4272, 4481, 4549, 4612, 5061, 5097, 5135, 5386, 5468, 5712, 5843, 6393, 7361, 7631, 7694, 7702, 7976, 8112, 8182, 8443, 8569, 8594, 9219, 9566, 9606, 9829, 9963, 10270, 10318, 10402, 10414, 10423, 10427, 10504, 10517, 10612, 10677, 10800, 11127, 11325, 11634, 11655, 11664, 11687, 11832, 12012, 12445, 12704, 12838, 13828, 13884, 14006, 14050, 14096, 14124, 14172, 14247, 14282, 14793, 14795, 14937, 14942, 15058, 15196, 15387, 15464, 15482, 15686, 16062, 16084, 16909, 16944, 17681, 17725, 17884, 17942, 17992, 18117, 18394, 18426, 18564, 18886, 18913, 19180, 19188, 19220, 19442, 19690, 19858, 19910, 19999, 20023, 20036, 20088, 20240, 20346, 20795, 20837, 20839, 21052, 21132, 21239, 21243, 21261, 21610, 21850, 22130, 22183, 22338, 22373, 22532, 22538, 22586, 22719, 23043, 23136, 23180, 23639, 23705, 23766, 23783, 23985, 24341, 24359, 24515, 24550, 24742, 25061, 25314, 25368, 25555, 25630, 25666, 25777, 26285, 26450, 26578, 26649, 26892, 26897, 27001, 27236, 27240, 27263, 27380, 27744, 27840, 27880, 27952, 28142, 28192, 28272, 28315, 28350, 28489, 28657, 28661, 28679, 28868, 29018, 29084, 29168, 29366, 29554, 29629, 29885, 29899, 30041, 30053, 30088, 30214, 30400, 30452, 30489, 30497, 30881, 30949, 30998, 31290, 31604, 31644, 31715, 31727, 31761, 31769, 31918, 32103, 32399]","[830, 11325, 16944, 19188, 19442, 21132, 25061, 25314, 28679, 29554]","[197, 329, 365, 394, 429, 549, 568, 583, 616, 631, 654, 669, 712, 731, 869, 1043, 1122, 1139, 1190, 1218, 1356, 1404, 1420, 1437, 1540, 1597, 1942, 2036, 2165, 2167, 2445, 2605, 2612, 2632, 2684, 2696, 2807, 2990, 3071, 3297, 3337, 4103, 4272, 4481, 4549, 4612, 5061, 5097, 5135, 5386, 5468, 5712, 5843, 6393, 7361, 7631, 7694, 7702, 7976, 8112, 8182, 8443, 8569, 8594, 9219, 9566, 9606, 9829, 9963, 10270, 10318, 10402, 10414, 10423, 10427, 10504, 10517, 10612, 10677, 10800, 11127, 11634, 11655, 11664, 11687, 11832, 12012, 12445, 12704, 12838, 13828, 13884, 14006, 14050, 14096, 14124, 14172, 14247, 14282, 14793, 14795, 14937, 14942, 15058, 15196, 15387, 15464, 15482, 15686, 16062, 16084, 16909, 17681, 17725, 17884, 17942, 17992, 18117, 18394, 18426, 18564, 18886, 18913, 19180, 19220, 19690, 19858, 19910, 19999, 20023, 20036, 20088, 20240, 20346, 20795, 20837, 20839, 21052, 21239, 21243, 21261, 21610, 21850, 22130, 22183, 22338, 22373, 22532, 22538, 22586, 22719, 23043, 23136, 23180, 23639, 23705, 23766, 23783, 23985, 24341, 24359, 24515, 24550, 24742, 25368, 25555, 25630, 25666, 25777, 26285, 26450, 26578, 26649, 26892, 26897, 27001, 27236, 27240, 27263, 27380, 27744, 27840, 27880, 27952, 28142, 28192, 28272, 28315, 28350, 28489, 28657, 28661, 28868, 29018, 29084, 29168, 29366, 29629, 29885, 29899, 30041, 30053, 30088, 30214, 30400, 30452, 30489, 30497, 30881, 30949, 30998, 31290, 31604, 31644, 31715, 31727, 31761, 31769, 31918, 32103, 32399]","[830, 11325, 16944, 19188, 19442, 21132, 25061, 25314, 28679, 29554]",32898,231,32667,10,221,32667,0
2.5,HSIFNG,"[63, 91, 136, 343, 589, 835, 867, 976, 1047, 1897, 2175, 2330, 2347, 2364, 2403, 2413, 2442, 2446, 2771, 3213, 3350, 3516, 3631, 3636, 3690, 3742, 3786, 3833, 3962, 4115, 4278, 4482, 4600, 4648, 5167, 5305, 5346, 5708, 5853]","[589, 1897, 2175]","[63, 91, 136, 343, 835, 867, 976, 1047, 2330, 2347, 2364, 2403, 2413, 2442, 2446, 2771, 3213, 3350, 3516, 3631, 3636, 3690, 3742, 3786, 3833, 3962, 4115, 4278, 4482, 4600, 4648, 5167, 5305, 5346, 5708, 5853]","[589, 1897, 2175]",5953,39,5914,3,36,5914,0
2.5,HSIL1AG,"[826, 916, 1489, 1617, 1730, 1830, 1987, 2208, 2441, 2641, 2797, 2949, 3019, 3067, 3215, 3356, 3519, 3535, 3576, 3631, 3708, 3939, 4118, 4326, 4373, 4447, 4840, 4847, 5019, 5155, 5318, 5343, 5548, 5552, 5580, 6116, 6433, 6888, 7173, 7384, 7604, 7666, 7681, 7897, 7940, 8025, 8132, 8510, 8514, 8526, 8601, 8615, 8873, 8891, 8943, 8989, 9035, 9081, 9174, 9290, 9431, 9436, 9539, 9775, 9789, 9875, 10013, 10321, 10487, 10592, 10633, 11038, 11229, 11686, 11703, 11793]","[2208, 3215, 4326, 6433, 7940]","[826, 916, 1489, 1617, 1730, 1830, 1987, 2441, 2641, 2797, 2949, 3019, 3067, 3356, 3519, 3535, 3576, 3631, 3708, 3939, 4118, 4373, 4447, 4840, 4847, 5019, 5155, 5318, 5343, 5548, 5552, 5580, 6116, 6888, 7173, 7384, 7604, 7666, 7681, 7897, 8025, 8132, 8510, 8514, 8526, 8601, 8615, 8873, 8891, 8943, 8989, 9035, 9081, 9174, 9290, 9431, 9436, 9539, 9775, 9789, 9875, 10013, 10321, 10487, 10592, 10633, 11038, 11229, 11686, 11703, 11793]","[2208, 3215, 4326, 6433, 7940]",11962,76,11886,5,71,11886,0
2.5,HSIL1B,"[74, 735, 767, 821, 865, 935, 1268, 1296, 1352, 1446, 1515, 1565, 1636, 1710, 1855, 2006, 2240, 2466, 2528, 2653, 2861, 3144, 3269, 3365, 3565, 3903, 3916, 4276, 4383, 4393, 4477, 4485, 4492, 4496, 4554, 4833, 5220, 5327, 5427, 5584, 5657, 5783, 5927, 5975, 6039, 6361, 6550, 6555, 7121, 7166, 7311, 7406, 7849, 8237, 8422, 8812, 8995, 9010, 9058, 9336, 9353, 9556, 9692]","[2528, 3144, 5327, 6039, 7406]","[74, 735, 767, 821, 865, 935, 1268, 1296, 1352, 1446, 1515, 1565, 1636, 1710, 1855, 2006, 2240, 2466, 2653, 2861, 3269, 3365, 3565, 3903, 3916, 4276, 4383, 4393, 4477, 4485, 4492, 4496, 4554, 4833, 5220, 5427, 5584, 5657, 5783, 5927, 5975, 6361, 6550, 6555, 7121, 7166, 7311, 7849, 8237, 8422, 8812, 8995, 9010, 9058, 9336, 9353, 9556, 9692]","[2528, 3144, 5327, 6039, 7406]",9703,63,9640,5,58,9640,0
2.5,HSINT2,"[47, 439, 516, 1156, 1285, 1689, 1856, 1982, 2070, 2173, 2267, 2297, 2467, 2564, 2788, 2792, 3155, 3197, 3282, 3328, 3420, 3471, 3509, 3549, 3567, 3571, 3653, 3790, 4136, 4140, 4167, 4173, 4327, 5335, 5386, 6386, 6546, 6819, 6824, 6954, 7235, 7341, 7506, 7600, 7816, 7992, 8132, 8668, 8973, 9056, 9214, 9331, 9443, 9480, 10085, 10162, 10181, 10216, 10228, 10232, 10255, 10263, 10273, 10295, 10458, 10533, 10644, 10708, 10736, 10943, 11019, 11125, 11148, 11551, 11562]","[1156, 3549]","[47, 439, 516, 1285, 1689, 1856, 1982, 2070, 2173, 2267, 2297, 2467, 2564, 2788, 2792, 3155, 3197, 3282, 3328, 3420, 3471, 3509, 3567, 3571, 3653, 3790, 4136, 4140, 4167, 4173, 4327, 5335, 5386, 6386, 6546, 6819, 6824, 6954, 7235, 7341, 7506, 7600, 7816, 7992, 8132, 8668, 8973, 9056, 9214, 9331, 9443, 9480, 10085, 10162, 10181, 10216, 10228, 10232, 10255, 10263, 10273, 10295, 10458, 10533, 10644, 10708, 10736, 10943, 11019, 11125, 11148, 11551, 11562]","[1156, 3549]",11600,75,11525,2,73,11525,0
2.5,HSL7A,"[9, 122, 229, 420, 1133, 1165, 1288, 1408, 1789, 1989, 2073, 2077, 2193, 2398, 2488, 2576, 2646, 2776, 2824, 2867, 2921, 2944, 3103, 3127, 3259, 3525, 3768, 4052, 4164, 4237, 4255, 4259, 4564, 4572, 4781, 4919, 5073]","[2073, 2867, 3525, 4164, 4572, 4919]","[9, 122, 229, 420, 1133, 1165, 1288, 1408, 1789, 1989, 2077, 2193, 2398, 2488, 2576, 2646, 2776, 2824, 2921, 2944, 3103, 3127, 3259, 3768, 4052, 4237, 4255, 4259, 4564, 4781, 5073]","[2073, 2867, 3525, 3881, 4164, 4572, 4919]",5498,37,5461,6,31,5460,1
2.5,HSLCATG,"[24, 48, 57, 73, 333, 361, 372, 819, 863, 867, 991, 1117, 1261, 1352, 1576, 1590, 1620, 1629, 1636, 1663, 1672, 1704, 1777, 1881, 2076, 2149, 2171, 2266, 2296, 2305, 2574, 2609, 3577, 3893, 3895, 3973, 4057, 4200, 4283, 4458, 4654, 4674, 4704, 4790, 4812, 4823, 5051, 5147, 5320, 5331, 5372, 5396, 5638, 5649, 5873, 5914, 5945, 6028, 6060, 6184, 6317, 6357, 6402, 6420, 6574, 6664, 6705, 6743]","[991, 1881, 2076, 2266, 2574]","[24, 48, 57, 73, 333, 361, 372, 819, 863, 867, 1117, 1261, 1352, 1576, 1590, 1620, 1629, 1636, 1663, 1672, 1704, 1777, 2149, 2171, 2296, 2305, 2609, 3577, 3893, 3895, 3973, 4057, 4200, 4283, 4458, 4654, 4674, 4704, 4790, 4812, 4823, 5051, 5147, 5320, 5331, 5372, 5396, 5638, 5649, 5873, 5914, 5945, 6028, 6060, 6184, 6317, 6357, 6402, 6420, 6574, 6664, 6705, 6743]","[991, 1881, 2076, 2266, 2574]",6893,68,6825,5,63,6825,0
2.5,HSMECDAG,"[93, 230, 298, 387, 453, 471, 716, 911, 923, 999, 1153, 1198, 1223, 1393, 1430, 1456, 1641, 1805, 1988, 2149, 2208, 2210, 2352, 2439, 2517, 2584, 2588, 2593, 2597, 2601, 2616, 2776, 2870, 2966, 2994, 3072, 3090, 3122, 3162, 3170, 3202, 3245, 3353, 3544, 3626, 3661, 3673, 3852, 3939, 3986, 4095, 4100, 4361]","[1393, 2517, 2776, 2966, 3544, 3852]","[93, 230, 298, 387, 453, 471, 716, 911, 923, 999, 1153, 1198, 1223, 1430, 1456, 1641, 1805, 1988, 2149, 2208, 2210, 2352, 2439, 2584, 2588, 2593, 2597, 2601, 2616, 2870, 2994, 3072, 3090, 3122, 3162, 3170, 3202, 3245, 3353, 3626, 3661, 3673, 3939, 3986, 4095, 4100, 4361]","[1393, 2517, 2776, 2966, 3544, 3852]",4362,53,4309,6,47,4309,0
2.5,HSMED,"[36, 46, 52, 139, 277, 307, 324, 360, 377, 413, 430, 466, 483, 519, 594, 619, 636, 710, 789, 812, 840, 896, 967, 1354, 1434, 1460, 1506, 1592, 1673, 1693, 1704, 1774, 1943, 1989, 1993, 1998, 2002, 2186, 2315, 3154, 3315, 3529, 3899, 4051, 4294, 4355, 4493, 4521, 4638, 4647, 4686, 4716, 4762, 4833, 5214, 5218]","[1354, 1943, 2315, 4716]","[36, 46, 52, 139, 277, 307, 324, 360, 377, 413, 430, 466, 483, 519, 594, 619, 636, 710, 789, 812, 840, 896, 967, 1434, 1460, 1506, 1592, 1673, 1693, 1704, 1774, 1989, 1993, 1998, 2002, 2186, 3154, 3315, 3529, 3899, 4051, 4294, 4355, 4493, 4521, 4638, 4647, 4686, 4762, 4833, 5214, 5218]","[1354, 1943, 2315, 4716]",5284,56,5228,4,52,5228,0
2.5,HSMT1H,"[20, 72, 196, 367, 396, 442, 474, 544, 567, 632, 649, 816, 1128, 1409, 1475, 1518, 1934, 2125]","[816, 1475]","[20, 72, 196, 367, 396, 442, 474, 544, 567, 632, 649, 1128, 1409, 1518, 1934, 2125]","[816, 1475]",2134,18,2116,2,16,2116,0
2.5,HSNCAMX1,"[188, 280, 638, 846, 1174, 1256, 1266, 1518, 1550, 1609, 1737, 1764, 1794, 2111, 2177, 2183, 2245, 2271, 2302, 2373, 2381, 2419, 2427, 2464, 2470, 2486, 2537, 2557, 2576, 2585, 2791, 2808, 2868, 2898, 2917, 2958, 2974, 3655, 3718, 3743, 3748, 4077, 4142, 4157, 4190, 4608, 4750, 4778, 5218, 5488, 5515, 5916, 6024, 6233, 6315, 6440, 6582, 6983, 7251, 7316, 7569, 7640, 7785, 7795, 7852, 8033, 8107, 8171, 8177, 8529, 8552, 8809, 8967, 9068, 9083, 9248, 9349, 9369, 9373, 9474, 9522, 9571, 9863, 10015, 10087, 10317, 10424, 10722, 10897, 10962, 11249, 11316, 11509, 11640, 11667, 11698, 11710, 11726, 11800, 11870, 11875, 12005, 12072, 12283, 12287, 12313, 12467, 12508, 12519, 12550, 12702, 12786, 12815, 12902, 12924, 13049, 13302, 13357, 13408, 13487, 13505, 13609, 13684, 13743, 13774, 13843, 13887, 13893, 13909, 13980, 14002, 14016, 14055, 14064, 14990, 15056, 15353, 15745, 15914, 15945, 16257]","[1609, 4142, 4778, 5218, 6315, 6582, 6983, 7316, 7569, 7852, 8529, 8809, 9068, 9373, 9571, 10015, 10317, 10722, 11667, 12072, 12283, 12550, 12786, 13049, 13487, 13893, 14002]","[188, 280, 638, 846, 1174, 1256, 1266, 1518, 1550, 1737, 1764, 1794, 2111, 2177, 2183, 2245, 2271, 2302, 2373, 2381, 2419, 2427, 2464, 2470, 2486, 2537, 2557, 2576, 2585, 2791, 2808, 2868, 2898, 2917, 2958, 2974, 3655, 3718, 3743, 3748, 4077, 4157, 4190, 4608, 4750, 5488, 5515, 5916, 6024, 6233, 6440, 7251, 7640, 7785, 7795, 8033, 8107, 8171, 8177, 8552, 8967, 9083, 9248, 9349, 9369, 9474, 9522, 9863, 10087, 10424, 10897, 10962, 11249, 11316, 11509, 11640, 11698, 11710, 11726, 11800, 11870, 11875, 12005, 12287, 12313, 12467, 12508, 12519, 12702, 12815, 12902, 12924, 13302, 13357, 13408, 13505, 13609, 13684, 13743, 13774, 13843, 13887, 13909, 13980, 14016, 14055, 14064, 14990, 15056, 15353, 15745, 15914, 15945, 16257]","[1609, 4142, 4778, 5218, 6315, 6582, 6983, 7316, 7569, 7852, 8529, 8809, 9068, 9373, 9571, 10015, 10317, 10722, 11667, 12072, 12283, 12550, 12786, 13049, 13487, 13893, 14002]",16280,141,16139,27,114,16139,0
2.5,HSNFM,"[21, 56, 163, 242, 417, 432, 606, 790, 820, 1096, 1188, 1231, 1252, 1393, 1411, 1507, 1698, 1741, 1822, 2243, 2311, 2422, 2675, 2691, 2917, 3230, 3325, 3371, 3422, 3751, 3772, 3849, 3863, 3917, 4020, 4101, 4491, 4575, 4896, 4952, 5012, 5057, 5063, 5148, 5172, 5216, 5234, 5343, 5360, 5372, 5388, 5498, 5744]","[1822, 2675]","[21, 56, 163, 242, 417, 432, 606, 790, 820, 1096, 1188, 1231, 1252, 1393, 1411, 1507, 1698, 1741, 2243, 2311, 2422, 2691, 2917, 3230, 3325, 3371, 3422, 3751, 3772, 3849, 3863, 3917, 4020, 4101, 4491, 4575, 4896, 4952, 5012, 5057, 5063, 5148, 5172, 5216, 5234, 5343, 5360, 5372, 5388, 5498, 5744]","[1822, 2675]",6228,53,6175,2,51,6175,0
2.5,HSODCG,"[213, 362, 376, 455, 591, 735, 759, 1002, 1192, 1361, 1392, 1494, 1589, 1648, 1938, 2374, 2393, 2483, 2561, 2612, 2649, 2751, 2829, 2847, 2912, 3007, 3140, 3172, 3288, 3411, 3446, 3454, 3567, 3745, 3826, 3920, 3968, 4103, 4192, 4323, 4343, 4426, 4433, 4445, 4649, 5028, 5282, 5286, 5348, 5421, 5432, 5558, 5633, 5815, 5893, 6164, 6211, 6253, 6298, 6336, 6378, 6579, 6597, 7002, 7111, 7208, 7285, 7306, 7451, 7501, 7505, 7614, 7618, 7638, 7836, 7881, 7971, 8052, 8090, 8214, 8495, 8501, 8758, 8822, 8842, 8854, 8957, 9013]","[4192, 4649, 5028, 5421, 5633, 5893, 7111, 7306, 7614]","[213, 362, 376, 455, 591, 735, 759, 1002, 1192, 1361, 1392, 1494, 1589, 1648, 1938, 2374, 2393, 2483, 2561, 2612, 2649, 2751, 2829, 2847, 2912, 3007, 3140, 3172, 3288, 3411, 3446, 3454, 3567, 3745, 3826, 3920, 3968, 4103, 4323, 4343, 4426, 4433, 4445, 5282, 5286, 5348, 5432, 5558, 5815, 6164, 6211, 6253, 6298, 6336, 6378, 6579, 6597, 7002, 7208, 7285, 7451, 7501, 7505, 7618, 7638, 7836, 7881, 7971, 8052, 8090, 8214, 8495, 8501, 8758, 8822, 8842, 8854, 8957, 9013]","[4192, 4649, 5028, 5421, 5633, 5893, 7111, 7306, 7614]",9035,88,8947,9,79,8947,0
2.5,HSODF2,"[4, 25, 97, 128, 131, 158, 250, 269, 381, 633, 722, 907, 913, 949, 964, 993, 1256, 1277, 1307, 1375]",[],"[4, 25, 97, 128, 131, 158, 250, 269, 381, 633, 722, 907, 913, 949, 964, 993, 1256, 1277, 1307, 1375]",[600],1422,20,1402,0,20,1401,1
2.5,HSPAT133,"[393, 558, 654, 762, 785, 794, 1126, 1173, 1447, 1578, 1666, 1707, 1782, 1801, 1889, 1961, 2207, 2226, 2366, 2531, 2627, 2860, 2995, 3085, 3711]",[1447],"[393, 558, 654, 762, 785, 794, 1126, 1173, 1578, 1666, 1707, 1782, 1801, 1889, 1961, 2207, 2226, 2366, 2531, 2627, 2860, 2995, 3085, 3711]",[1447],3712,25,3687,1,24,3687,0
2.5,HSPLAPL,"[9, 24, 191, 218, 403, 593, 599, 603, 728, 808, 827, 889, 1192, 1197, 1225]","[403, 599, 827]","[9, 24, 191, 218, 593, 603, 728, 808, 889, 1192, 1197, 1225]","[403, 599, 827]",1274,15,1259,3,12,1259,0
2.5,HSPRB3L,"[279, 356, 386, 415, 566, 616, 789, 840, 896, 1103, 1319, 1412, 1537, 1755, 2002, 2069, 2934, 3083, 3376, 3584, 4014, 4236]","[566, 1537]","[279, 356, 386, 415, 616, 789, 840, 896, 1103, 1319, 1412, 1755, 2002, 2069, 2934, 3083, 3376, 3584, 4014, 4236]","[566, 1537]",4508,22,4486,2,20,4486,0
2.5,HSPRB4S,"[97, 411, 487, 518, 542, 646, 687, 693, 719, 741, 750, 913, 1018, 1049, 1058, 1276, 1441, 1534, 1565, 1658, 1875, 2128, 2384, 2495, 2812, 2957, 3462, 3999, 4301, 5204, 5381, 5694]","[693, 1658]","[97, 411, 487, 518, 542, 646, 687, 719, 741, 750, 913, 1018, 1049, 1058, 1276, 1441, 1534, 1565, 1875, 2128, 2384, 2495, 2812, 2957, 3462, 3999, 4301, 5204, 5381, 5694]","[693, 1658]",5805,32,5773,2,30,5773,0
2.5,HSPSAG,"[46, 174, 403, 447, 872, 1759, 1815, 1848, 1878, 2084, 2383, 2397, 2428, 2551, 2586, 2594, 2687, 2695, 2834, 3535, 3544, 3611, 3764, 3782, 3866, 3960, 3987, 4044, 4080, 4368, 4427, 4456, 4493, 4499, 4648, 4741, 4775, 4971, 5079, 5088, 5340, 5414, 5444, 5456, 5518, 5668, 5710]","[447, 1848, 3764, 4044]","[46, 174, 403, 872, 1759, 1815, 1878, 2084, 2383, 2397, 2428, 2551, 2586, 2594, 2687, 2695, 2834, 3535, 3544, 3611, 3782, 3866, 3960, 3987, 4080, 4368, 4427, 4456, 4493, 4499, 4648, 4741, 4775, 4971, 5079, 5088, 5340, 5414, 5444, 5456, 5518, 5668, 5710]","[447, 1848, 3764, 4044]",5865,47,5818,4,43,5818,0
2.5,HSRPII145,"[23, 449, 467, 588, 908, 1071, 1086, 1097, 1102, 1157, 1181, 1233, 1302, 1306, 1350, 1378, 1535, 1598, 1610, 1615, 1619, 1641, 1688, 1729, 1894]","[449, 588, 908, 1071, 1233]","[23, 467, 1086, 1097, 1102, 1157, 1181, 1302, 1306, 1350, 1378, 1535, 1598, 1610, 1615, 1619, 1641, 1688, 1729, 1894]","[449, 588, 908, 1071, 1233]",2085,25,2060,5,20,2060,0
2.5,HSRPS7,"[21, 55, 115, 166, 264, 284, 404, 415, 516, 731, 1008, 1055, 1077, 1099, 1276, 1599, 1628, 1831, 1930, 2003, 2048, 2166, 2192, 2232, 2269, 2369, 2495, 2530, 2551, 2585, 2717, 2785, 2791, 3108, 3329, 3383, 3598, 3626, 3630, 3680, 3730, 3743, 3755, 4116, 4254, 4280, 4347, 4460, 4644, 4654, 5088, 5100, 5409, 5671, 5736, 5912, 5937, 6001, 6064, 6068, 6325, 6386, 6408, 6429, 6518, 6734, 6773, 7003, 7010, 7045, 7049, 7061, 7082, 7273]","[2166, 2369, 3108, 4254, 6734]","[21, 55, 115, 166, 264, 284, 404, 415, 516, 731, 1008, 1055, 1077, 1099, 1276, 1599, 1628, 1831, 1930, 2003, 2048, 2192, 2232, 2269, 2495, 2530, 2551, 2585, 2717, 2785, 2791, 3329, 3383, 3598, 3626, 3630, 3680, 3730, 3743, 3755, 4116, 4280, 4347, 4460, 4644, 4654, 5088, 5100, 5409, 5671, 5736, 5912, 5937, 6001, 6064, 6068, 6325, 6386, 6408, 6429, 6518, 6773, 7003, 7010, 7045, 7049, 7061, 7082, 7273]","[2166, 2369, 3108, 4254, 6734]",7505,74,7431,5,69,7431,0
2.5,HSSAA1B,"[13, 210, 349, 470, 527, 862, 1009, 1064, 1151, 1203, 1543, 1558, 1831, 2203, 2345, 2367, 2430, 2467, 2484, 2623, 2644, 2703, 2753, 2912, 3121, 3182, 3214, 3327, 3570, 3609, 3845, 3876, 3988, 4007, 4013, 4171, 4267, 4403, 4441, 4571, 4575, 4697, 4712, 4744]","[1543, 3845]","[13, 210, 349, 470, 527, 862, 1009, 1064, 1151, 1203, 1558, 1831, 2203, 2345, 2367, 2430, 2467, 2484, 2623, 2644, 2703, 2753, 2912, 3121, 3182, 3214, 3327, 3570, 3609, 3876, 3988, 4007, 4013, 4171, 4267, 4403, 4441, 4571, 4575, 4697, 4712, 4744]","[1543, 3845]",4815,44,4771,2,42,4771,0
2.5,HSSHBG,"[228, 472, 696, 1016, 1058, 1336, 1389, 1443, 1551, 1590, 1713, 1938, 2205, 2388, 2575, 2615, 2672, 2679, 2759, 2776, 2810, 2823, 2867, 2882, 2943, 3019, 3148, 3285, 3306, 3440]","[472, 696, 1058, 1551, 1938, 2205, 3148]","[228, 1016, 1336, 1389, 1443, 1590, 1713, 2388, 2575, 2615, 2672, 2679, 2759, 2776, 2810, 2823, 2867, 2882, 2943, 3019, 3285, 3306, 3440]","[472, 696, 1058, 1551, 1938, 2205, 3148]",3802,30,3772,7,23,3772,0
2.5,HSSSPN1AG,"[8, 152, 155, 399, 409, 418, 589, 854, 1232, 1343, 1402, 1434, 1635, 1672, 1809, 1853, 2066, 2159, 2280, 2330, 2362, 2652, 2905, 2947, 2975, 3028, 3073, 3159, 3240, 3360, 3491, 3518, 3699, 3781, 3934, 4013, 4053, 4087]","[1343, 1635, 1809, 3360, 3491]","[8, 152, 155, 399, 409, 418, 589, 854, 1232, 1402, 1434, 1672, 1853, 2066, 2159, 2280, 2330, 2362, 2652, 2905, 2947, 2975, 3028, 3073, 3159, 3240, 3518, 3699, 3781, 3934, 4013, 4053, 4087]","[1343, 1635, 1809, 3360, 3491]",4088,38,4050,5,33,4050,0
2.5,HSSURF3,"[200, 284, 288, 403, 566, 656, 743, 813, 942, 990, 1033, 1087, 1110, 1294, 1692, 1935, 2048, 2071, 2160, 2209, 2321, 2393, 2411, 2415, 2721, 2729, 2936, 3074, 3226]","[284, 1033, 1692, 2048, 2321, 2729, 3074]","[200, 288, 403, 566, 656, 743, 813, 942, 990, 1087, 1110, 1294, 1935, 2071, 2160, 2209, 2393, 2411, 2415, 2721, 2936, 3226]","[284, 1033, 1692, 2048, 2321, 2729, 3074]",3407,29,3378,7,22,3378,0
2.5,HSTNFB,"[63, 143, 189, 372, 836, 980, 1202, 1309, 1375, 1567, 2506, 2691, 2732, 2888, 3015]","[1375, 1567]","[63, 143, 189, 372, 836, 980, 1202, 1309, 2506, 2691, 2732, 2888, 3015]","[1375, 1567]",3029,15,3014,2,13,3014,0
2.5,HSTPI1G,"[123, 730, 746, 837, 919, 972, 1096, 1127, 1304, 1558, 1616, 1621, 1685, 1817, 1893, 2035, 2046, 2056, 2105, 2176, 2231, 2438, 2493, 2498, 2604, 2646, 2740, 2792, 2821, 2988, 3181, 3207, 3249, 3654, 3688, 3720, 3760, 3829, 3846, 4118, 4236, 4293, 4330, 4376, 4547, 4586, 4651, 4721, 4827, 4845, 4849, 4868, 4888, 4901]","[746, 2035, 2231, 2438, 2821, 3181]","[123, 730, 837, 919, 972, 1096, 1127, 1304, 1558, 1616, 1621, 1685, 1817, 1893, 2046, 2056, 2105, 2176, 2493, 2498, 2604, 2646, 2740, 2792, 2988, 3207, 3249, 3654, 3688, 3720, 3760, 3829, 3846, 4118, 4236, 4293, 4330, 4376, 4547, 4586, 4651, 4721, 4827, 4845, 4849, 4868, 4888, 4901]","[746, 2035, 2231, 2438, 2821, 3181]",4987,54,4933,6,48,4933,0
2.5,HSTUBAG,"[71, 96, 105, 158, 536, 708, 978, 984, 993, 1223, 1235, 1277, 1349, 1457, 1498, 1912, 2065, 2221, 2287, 2310, 2337, 2584, 2813, 2937, 3419, 3441, 3474, 3569, 3623, 3706, 3733, 3759, 3777, 3815, 3843, 3887, 3956]","[536, 2287, 2584]","[71, 96, 105, 158, 708, 978, 984, 993, 1223, 1235, 1277, 1349, 1457, 1498, 1912, 2065, 2221, 2310, 2337, 2813, 2937, 3419, 3441, 3474, 3569, 3623, 3706, 3733, 3759, 3777, 3815, 3843, 3887, 3956]","[536, 2287, 2584]",4079,37,4042,3,34,4042,0
2.5,HSU01102,"[192, 222, 275, 373, 450, 668, 745, 817, 858, 1671, 1711, 1939, 1943, 2082, 2132, 2192, 2210, 2242, 2494, 2561, 2568, 2632, 2732, 2746, 2771, 2875, 2907, 2930, 3140, 3273, 3275, 3393, 3896, 4008, 4040, 4166, 4262, 4611, 4655, 4690]","[668, 3896]","[192, 222, 275, 373, 450, 745, 817, 858, 1671, 1711, 1939, 1943, 2082, 2132, 2192, 2210, 2242, 2494, 2561, 2568, 2632, 2732, 2746, 2771, 2875, 2907, 2930, 3140, 3273, 3275, 3393, 4008, 4040, 4166, 4262, 4611, 4655, 4690]","[668, 3896]",4987,40,4947,2,38,4947,0
2.5,HSU04357,"[97, 123, 132, 192, 310, 366, 774, 792, 800, 909, 985, 1090, 1107, 1201, 1239, 1316, 1342, 1650, 1838, 1882, 1953, 1963]","[97, 1342]","[123, 132, 192, 310, 366, 774, 792, 800, 909, 985, 1090, 1107, 1201, 1239, 1316, 1650, 1838, 1882, 1953, 1963]","[97, 1342]",2074,22,2052,2,20,2052,0
2.5,HSU04636,"[25, 97, 103, 176, 220, 224, 353, 465, 673, 677, 749, 823, 852, 1018, 1449, 1518, 1856, 1935, 2199, 2262, 2426, 2440, 2561, 2605, 2761, 2996, 3000, 3143, 3264, 3426, 3608, 3849, 3965, 4024, 4362, 4424, 4677, 4711, 4748, 4790, 4881, 4919, 5359, 5719, 5723, 5870, 6008, 6340, 6533, 6653, 6706, 6760, 7014, 7194, 7357, 7692, 7768, 7907, 8108, 8301, 8483, 8640, 9044]","[1018, 1935, 2199, 2996, 3608, 4424, 4790, 5359, 6008]","[25, 97, 103, 176, 220, 224, 353, 465, 673, 677, 749, 823, 852, 1449, 1518, 1856, 2262, 2426, 2440, 2561, 2605, 2761, 3000, 3143, 3264, 3426, 3849, 3965, 4024, 4362, 4677, 4711, 4748, 4881, 4919, 5719, 5723, 5870, 6340, 6533, 6653, 6706, 6760, 7014, 7194, 7357, 7692, 7768, 7907, 8108, 8301, 8483, 8640, 9044]","[1018, 1935, 2199, 2996, 3608, 4424, 4790, 5359, 6008]",9445,63,9382,9,54,9382,0
2.5,HSU05259,"[164, 316, 499, 627, 632, 644, 655, 782, 814, 951, 1177, 1773, 1891, 2051, 2055, 2091, 2173, 2435, 2571, 2678, 2685, 2774, 2859, 3045, 3109, 3366, 3387, 3483, 3672, 3937, 4128, 4139, 4150, 4171, 4214, 4281, 4505, 4642, 4871, 5090, 5264]","[782, 2685, 3045, 4128]","[164, 316, 499, 627, 632, 644, 655, 814, 951, 1177, 1773, 1891, 2051, 2055, 2091, 2173, 2435, 2571, 2678, 2774, 2859, 3109, 3366, 3387, 3483, 3672, 3937, 4139, 4150, 4171, 4214, 4281, 4505, 4642, 4871, 5090, 5264]","[782, 2685, 3045, 4128]",5662,41,5621,4,37,5621,0
2.5,HSU07807,"[201, 253, 454, 459, 484, 609, 614, 757, 891, 1040, 1362, 1848, 1983, 1991, 2047, 2082, 2481, 2568, 2577, 2652, 2736, 2873, 3055, 3386, 3390, 3395, 3446, 3509, 3541, 3589, 3664, 4101, 4350, 4638, 4725, 4778]","[757, 3386]","[201, 253, 454, 459, 484, 609, 614, 891, 1040, 1362, 1848, 1983, 1991, 2047, 2082, 2481, 2568, 2577, 2652, 2736, 2873, 3055, 3390, 3395, 3446, 3509, 3541, 3589, 3664, 4101, 4350, 4638, 4725, 4778]","[757, 3386]",4831,36,4795,2,34,4795,0
2.5,HSU07983,"[101, 170, 283, 287, 354, 390, 406, 621, 982, 1286]",[390],"[101, 170, 283, 287, 354, 406, 621, 982, 1286]",[390],1418,10,1408,1,9,1408,0
2.5,HSU08198,"[139, 163, 311, 318, 583, 613, 645, 676, 707, 875, 895, 1072, 1124, 1147, 1151, 1299, 1316, 1392, 1476, 1601, 1620, 1684, 1689, 1811, 1845, 1892, 1900, 1932, 2056, 2068]","[583, 895, 1124, 1316, 1689, 1811]","[139, 163, 311, 318, 613, 645, 676, 707, 875, 1072, 1147, 1151, 1299, 1392, 1476, 1601, 1620, 1684, 1845, 1892, 1900, 1932, 2056, 2068]","[583, 895, 1124, 1316, 1689, 1811]",2336,30,2306,6,24,2306,0
2.5,HSU12421,"[6, 10, 227, 311, 315, 444, 583, 945, 957, 999, 1044, 1215, 1308, 1384, 1400, 1706, 1733, 1807, 1854, 1882, 1941, 2080, 2134, 2158, 2255, 2291, 2334, 2434, 2517, 2624, 2668, 3216, 3242, 3287, 3349, 3485, 3573, 3577, 3633, 3642, 3705, 3740, 3747, 3822, 3869, 3910, 4142]","[311, 2080]","[6, 10, 227, 315, 444, 583, 945, 957, 999, 1044, 1215, 1308, 1384, 1400, 1706, 1733, 1807, 1854, 1882, 1941, 2134, 2158, 2255, 2291, 2334, 2434, 2517, 2624, 2668, 3216, 3242, 3287, 3349, 3485, 3573, 3577, 3633, 3642, 3705, 3740, 3747, 3822, 3869, 3910, 4142]","[311, 2080]",4250,47,4203,2,45,4203,0
2.5,HSUBR,"[219, 251, 362, 374, 409, 417, 512, 564, 634, 793, 957, 1080, 1332, 1513, 1518, 1549, 1589, 1923, 2316, 2324, 2489, 2907, 2969, 3005, 3124, 3287]","[1589, 2324]","[219, 251, 362, 374, 409, 417, 512, 564, 634, 793, 957, 1080, 1332, 1513, 1518, 1549, 1923, 2316, 2489, 2907, 2969, 3005, 3124, 3287]","[1589, 2324]",3287,26,3261,2,24,3261,0
2.5,HSXBXVIII,"[340, 343, 417, 442, 473, 479, 529, 536, 579, 644, 701, 1056, 1059, 1133, 1158, 1176, 1189, 1193, 1199, 1203, 1213, 1671, 1992, 2137, 2491, 2578, 2596, 2723, 2781, 2785, 2897, 2999, 3019, 3026, 3061, 3074, 3099, 3123, 3175, 3248, 3293, 3333, 3339, 3345, 3371, 3726, 3729, 3803, 3828, 3859, 3884, 3919, 3929, 3952, 4453, 4456, 4530, 4555, 4586, 4764, 4989, 5049, 5221, 5248, 5320, 5362, 5383, 5401, 5486, 5490, 5971, 5982, 6064, 6115, 6193, 6240, 6382, 6599, 6733, 6855, 7073, 7479, 7675, 8109, 8174, 8274, 8302, 8689, 8850, 8934, 8943, 9093, 9154, 9342, 9410, 9475, 9552, 9558, 9573, 9633, 9936, 9983, 10043, 10077, 10107, 10136, 10160, 10186, 10425, 10464, 10629, 10687, 10701, 10723, 10737, 10911, 10947, 10960, 11115, 11162, 11196, 11253, 11310, 11405, 11589, 11615, 11714, 11769, 11843, 11856, 11870, 12024, 12085, 12092, 12183, 12286, 12311, 12408, 12416, 12444, 12534, 12693]","[11405, 11589, 11843, 12085]","[340, 343, 417, 442, 473, 479, 529, 536, 579, 644, 701, 1056, 1059, 1133, 1158, 1176, 1189, 1193, 1199, 1203, 1213, 1671, 1992, 2137, 2491, 2578, 2596, 2723, 2781, 2785, 2897, 2999, 3019, 3026, 3061, 3074, 3099, 3123, 3175, 3248, 3293, 3333, 3339, 3345, 3371, 3726, 3729, 3803, 3828, 3859, 3884, 3919, 3929, 3952, 4453, 4456, 4530, 4555, 4586, 4764, 4989, 5049, 5221, 5248, 5320, 5362, 5383, 5401, 5486, 5490, 5971, 5982, 6064, 6115, 6193, 6240, 6382, 6599, 6733, 6855, 7073, 7479, 7675, 8109, 8174, 8274, 8302, 8689, 8850, 8934, 8943, 9093, 9154, 9342, 9410, 9475, 9552, 9558, 9573, 9633, 9936, 9983, 10043, 10077, 10107, 10136, 10160, 10186, 10425, 10464, 10629, 10687, 10701, 10723, 10737, 10911, 10947, 10960, 11115, 11162, 11196, 11253, 11310, 11615, 11714, 11769, 11856, 11870, 12024, 12092, 12183, 12286, 12311, 12408, 12416, 12444, 12534, 12693]","[11405, 11589, 11843, 12085]",12630,142,12488,4,138,12488,0
2.5,HSZNGP1,"[130, 445, 518, 565, 932, 997, 1142, 1307, 1529, 1673, 1684, 1765, 2135, 2520, 2672, 2958, 3191, 3270, 3608, 4109, 4312, 4609, 4718, 4777, 4886, 5026, 5073, 5295, 5483, 5589, 5594, 5623, 5666, 5737, 5752, 5805, 5990, 6022, 6144, 6179, 6347, 6402, 6408, 6435, 6495, 6586, 6632, 6665, 7275, 7410, 7454, 7674, 8059, 8067, 8313, 8588, 8597, 8603, 8615, 8762, 8986, 8991, 9059, 9067, 9107, 9113, 9300, 9762]","[518, 4718, 8313]","[130, 445, 565, 932, 997, 1142, 1307, 1529, 1673, 1684, 1765, 2135, 2520, 2672, 2958, 3191, 3270, 3608, 4109, 4312, 4609, 4777, 4886, 5026, 5073, 5295, 5483, 5589, 5594, 5623, 5666, 5737, 5752, 5805, 5990, 6022, 6144, 6179, 6347, 6402, 6408, 6435, 6495, 6586, 6632, 6665, 7275, 7410, 7454, 7674, 8059, 8067, 8588, 8597, 8603, 8615, 8762, 8986, 8991, 9059, 9067, 9107, 9113, 9300, 9762]","[518, 4718, 8313]",9815,68,9747,3,65,9747,0
2.5,HUMADAG,"[8, 24, 47, 73, 204, 565, 643, 653, 710, 860, 1012, 1241, 1309, 1355, 1609, 1677, 1864, 1947, 1951, 2001, 2050, 2055, 2120, 2405, 2418, 2423, 2455, 2500, 2566, 2578, 2756, 2769, 2805, 3203, 3343, 3539, 3737, 3746, 3775, 4064, 4326, 4395, 4501, 4521, 4549, 4623, 4817, 4829, 4836, 4900, 4916, 4946, 5136, 5141, 5267, 5278, 5296, 5341, 5423, 5657, 5751, 5773, 5816, 5828, 5863, 5871, 6192, 6211, 6261, 6277, 6615, 6630, 6709, 6978, 7179, 7184, 7206, 7249, 7356, 7461, 7561, 7568, 7938, 7980, 7982, 8160, 8421, 8876, 8948, 8957, 9072, 9092, 9467, 9529, 9551, 9572, 9600, 9628, 9633, 9665, 9863, 9946, 9988, 9992, 10139, 10236, 10243, 10515, 10759, 10977, 11111, 11124, 11162, 11190, 11262, 11303, 11568, 11651, 11689, 11763, 11804, 11825, 12068, 12275, 12435, 12498, 12555, 12584, 13187, 13235, 13253, 13314, 13416, 13458, 13503, 13521, 13553, 13601, 14450, 14833, 14855, 14976, 15069, 15395, 15582, 15661, 15857, 15875, 15907, 15955, 16018, 16030, 16262, 17025, 17067, 17161, 17205, 17401, 17492, 17642, 17850, 18096, 18415, 18465, 18482, 18514, 18625, 18637, 19230, 19292, 19437, 19529, 19581, 19940, 20245, 20776, 20954, 21006, 21015, 21020, 21027, 21097, 21114, 21399, 21499, 22345, 22419, 22592, 22672, 22735, 22747, 22887, 23112, 23540, 23621, 23649, 23724, 23808, 23861, 24039, 24080, 24086, 24165, 24224, 24260, 24286, 24626, 24645, 24752, 25434, 25532, 25540, 25869, 26052, 26150, 26313, 26467, 26603, 26649, 26782, 26810, 26891, 26912, 27028, 27206, 27250, 27303, 27432, 27585, 27648, 28038, 28083, 28099, 28255, 28362, 28479, 28712, 28722, 28810, 28977, 28987, 28992, 29052, 29419, 29577, 29700, 29704, 29939, 30604, 30609, 30614, 30766, 30860, 31099, 31115, 31138, 31144, 31158, 31190, 31203, 31304, 31313, 31342, 31560, 31644, 31682, 31717, 32019, 32178, 32243, 32291, 32470, 32497, 32675, 32916, 33343, 33486, 33495, 33626, 33782, 33880, 33952, 33998, 34262, 34279, 34308, 34484, 34488, 34494, 34532, 34578, 34742, 34908, 35203, 35365, 35433, 35981, 36268, 36357, 36733]","[4064, 19292, 26467, 29052, 29939, 31304, 32497, 32675, 32916, 34484, 35203]","[8, 24, 47, 73, 204, 565, 643, 653, 710, 860, 1012, 1241, 1309, 1355, 1609, 1677, 1864, 1947, 1951, 2001, 2050, 2055, 2120, 2405, 2418, 2423, 2455, 2500, 2566, 2578, 2756, 2769, 2805, 3203, 3343, 3539, 3737, 3746, 3775, 4326, 4395, 4501, 4521, 4549, 4623, 4817, 4829, 4836, 4900, 4916, 4946, 5136, 5141, 5267, 5278, 5296, 5341, 5423, 5657, 5751, 5773, 5816, 5828, 5863, 5871, 6192, 6211, 6261, 6277, 6615, 6630, 6709, 6978, 7179, 7184, 7206, 7249, 7356, 7461, 7561, 7568, 7938, 7980, 7982, 8160, 8421, 8876, 8948, 8957, 9072, 9092, 9467, 9529, 9551, 9572, 9600, 9628, 9633, 9665, 9863, 9946, 9988, 9992, 10139, 10236, 10243, 10515, 10759, 10977, 11111, 11124, 11162, 11190, 11262, 11303, 11568, 11651, 11689, 11763, 11804, 11825, 12068, 12275, 12435, 12498, 12555, 12584, 13187, 13235, 13253, 13314, 13416, 13458, 13503, 13521, 13553, 13601, 14450, 14833, 14855, 14976, 15069, 15395, 15582, 15661, 15857, 15875, 15907, 15955, 16018, 16030, 16262, 17025, 17067, 17161, 17205, 17401, 17492, 17642, 17850, 18096, 18415, 18465, 18482, 18514, 18625, 18637, 19230, 19437, 19529, 19581, 19940, 20245, 20776, 20954, 21006, 21015, 21020, 21027, 21097, 21114, 21399, 21499, 22345, 22419, 22592, 22672, 22735, 22747, 22887, 23112, 23540, 23621, 23649, 23724, 23808, 23861, 24039, 24080, 24086, 24165, 24224, 24260, 24286, 24626, 24645, 24752, 25434, 25532, 25540, 25869, 26052, 26150, 26313, 26603, 26649, 26782, 26810, 26891, 26912, 27028, 27206, 27250, 27303, 27432, 27585, 27648, 28038, 28083, 28099, 28255, 28362, 28479, 28712, 28722, 28810, 28977, 28987, 28992, 29419, 29577, 29700, 29704, 30604, 30609, 30614, 30766, 30860, 31099, 31115, 31138, 31144, 31158, 31190, 31203, 31313, 31342, 31560, 31644, 31682, 31717, 32019, 32178, 32243, 32291, 32470, 33343, 33486, 33495, 33626, 33782, 33880, 33952, 33998, 34262, 34279, 34308, 34488, 34494, 34532, 34578, 34742, 34908, 35365, 35433, 35981, 36268, 36357, 36733]","[4064, 19292, 26467, 29052, 29939, 31304, 32497, 32675, 32916, 34484, 35203]",36733,300,36433,11,289,36433,0
2.5,HUMADPRF02,"[90, 277, 359, 514, 638, 1058, 1250, 1308, 1325, 1329, 1338, 1456, 1650, 1937, 2033, 2102, 2108, 2267, 2306, 2658, 2953, 2972, 3035, 3285, 3305, 3392, 3994, 4041, 4213, 4223, 4253, 4279, 4595, 4732, 4870, 4965, 5150]","[359, 1308, 1650]","[90, 277, 514, 638, 1058, 1250, 1325, 1329, 1338, 1456, 1937, 2033, 2102, 2108, 2267, 2306, 2658, 2953, 2972, 3035, 3285, 3305, 3392, 3994, 4041, 4213, 4223, 4253, 4279, 4595, 4732, 4870, 4965, 5150]","[359, 1308, 1650]",5159,37,5122,3,34,5122,0
2.5,HUMAPEXN,"[137, 294, 349, 946, 967, 1002, 1032, 1151, 1156, 1190, 1268, 1347, 1364, 1368, 1376, 1465, 1530, 1535, 1589, 1693, 1748, 1863, 2233, 2341, 2428, 2432, 2539, 2563, 2622, 2781, 2814, 2845, 2850]","[1465, 1863, 2622]","[137, 294, 349, 946, 967, 1002, 1032, 1151, 1156, 1190, 1268, 1347, 1364, 1368, 1376, 1530, 1535, 1589, 1693, 1748, 2233, 2341, 2428, 2432, 2539, 2563, 2781, 2814, 2845, 2850]","[1465, 1863, 2622]",3722,33,3689,3,30,3689,0
2.5,HUMAPOCII,"[70, 94, 102, 112, 169, 184, 198, 349, 501, 547, 571, 589, 699, 811, 891, 930, 965, 1075, 1107, 1147, 1230, 1263, 1331, 1434, 1557, 1778, 1789, 1837, 1856, 1980, 1985, 2187, 2219, 2255, 2305, 2321, 2353, 2405, 2467, 2512, 2571, 2630, 2642, 2760, 2982, 2995, 3223, 3279, 3321, 4263]","[2995, 3321]","[70, 94, 102, 112, 169, 184, 198, 349, 501, 547, 571, 589, 699, 811, 891, 930, 965, 1075, 1107, 1147, 1230, 1263, 1331, 1434, 1557, 1778, 1789, 1837, 1856, 1980, 1985, 2187, 2219, 2255, 2305, 2321, 2353, 2405, 2467, 2512, 2571, 2630, 2642, 2760, 2982, 3223, 3279, 4263]","[2995, 3321]",4332,50,4282,2,48,4282,0
2.5,HUMAPOE4,"[166, 188, 281, 617, 752, 1064, 1091, 1173, 1225, 1294, 1299, 1324, 1433, 1506, 1511, 1526, 1575, 1586, 1711, 1773, 1914, 2365, 2409, 2611, 2661, 2819, 3021, 3033, 3156, 3200, 3234, 3851, 3929, 3962, 4001, 4032, 4166, 4292, 4304, 4313, 4445, 5225]","[1914, 3200]","[166, 188, 281, 617, 752, 1064, 1091, 1173, 1225, 1294, 1299, 1324, 1433, 1506, 1511, 1526, 1575, 1586, 1711, 1773, 2365, 2409, 2611, 2661, 2819, 3021, 3033, 3156, 3234, 3851, 3929, 3962, 4001, 4032, 4166, 4292, 4304, 4313, 4445, 5225]","[1914, 3200]",5507,42,5465,2,40,5465,0
2.5,HUMATPGG,"[156, 203, 213, 285, 313, 599, 676, 708, 831, 1290, 1409, 1445, 1727, 1762, 1856, 1902, 1923, 2170, 2327, 2553, 2601, 2648, 2677, 2819, 2891, 2905, 2920, 2937, 3025, 3180, 3446, 3664, 3691, 4060, 4064, 4114, 4293, 4553, 4578, 5058, 5191, 5307, 5627, 5833, 5882, 5919, 5953, 5985, 6009, 6118, 6191, 6323, 6391, 6534, 6749, 7311, 7456, 7488, 7833, 7864, 7885, 7908, 8017, 8198, 8227, 8620, 8710, 9179, 9204, 9271, 9299, 9308, 9315, 9436, 9645, 9672, 9691, 9778, 9805, 10001, 10015, 10190, 10208, 10354, 10406, 10478, 10624, 10635, 10770, 10861, 10865, 11018, 11140, 11201, 11405, 11435, 11928, 12001, 12070, 12074, 12403, 12415, 12511, 12549, 12987, 13022, 13136, 13458, 13592, 13663, 13759, 13775, 14011, 14032, 14100, 14110, 14137, 14276, 14470, 14537, 14755, 14881, 15036]","[1445, 1727, 1902, 2677, 4293, 5307, 6118, 6534, 6749, 7456, 8198, 9436, 9672, 10190, 11405, 12074, 13663, 14100, 14276]","[156, 203, 213, 285, 313, 599, 676, 708, 831, 1290, 1409, 1762, 1856, 1923, 2170, 2327, 2553, 2601, 2648, 2819, 2891, 2905, 2920, 2937, 3025, 3180, 3446, 3664, 3691, 4060, 4064, 4114, 4553, 4578, 5058, 5191, 5627, 5833, 5882, 5919, 5953, 5985, 6009, 6191, 6323, 6391, 7311, 7488, 7833, 7864, 7885, 7908, 8017, 8227, 8620, 8710, 9179, 9204, 9271, 9299, 9308, 9315, 9645, 9691, 9778, 9805, 10001, 10015, 10208, 10354, 10406, 10478, 10624, 10635, 10770, 10861, 10865, 11018, 11140, 11201, 11435, 11928, 12001, 12070, 12403, 12415, 12511, 12549, 12987, 13022, 13136, 13458, 13592, 13759, 13775, 14011, 14032, 14110, 14137, 14470, 14537, 14755, 14881, 15036]","[1445, 1727, 1902, 2677, 4293, 4749, 5307, 6118, 6534, 6749, 7456, 8198, 9436, 9672, 9946, 10190, 11405, 12074, 13663, 14100, 14276]",15107,123,14984,19,104,14982,2
2.5,HUMBETGLOA,"[52, 252, 351, 376, 601, 687, 920, 942, 958, 1176, 1204, 1264, 1311, 1395, 1792, 2016, 2179, 2255, 2475, 2559, 2931]","[958, 1311]","[52, 252, 351, 376, 601, 687, 920, 942, 1176, 1204, 1264, 1395, 1792, 2016, 2179, 2255, 2475, 2559, 2931]","[958, 1311]",2994,21,2973,2,19,2973,0
2.5,HUMBETGLOB,"[52, 252, 349, 374, 599, 685, 918, 940, 956, 1174, 1202, 1262, 1309, 1393, 1790, 2014, 2177, 2253, 2473, 2557, 2929]","[956, 1309]","[52, 252, 349, 374, 599, 685, 918, 940, 1174, 1202, 1262, 1393, 1790, 2014, 2177, 2253, 2473, 2557, 2929]","[956, 1309]",2992,21,2971,2,19,2971,0
2.5,HUMBETGLOC,"[52, 252, 351, 376, 601, 687, 920, 942, 958, 1176, 1204, 1264, 1311, 1395, 1792, 2016, 2179, 2255, 2475, 2559, 2931]","[958, 1311]","[52, 252, 351, 376, 601, 687, 920, 942, 1176, 1204, 1264, 1395, 1792, 2016, 2179, 2255, 2475, 2559, 2931]","[958, 1311]",2994,21,2973,2,19,2973,0
2.5,HUMBETGLOD,"[52, 252, 351, 376, 601, 687, 920, 942, 958, 1176, 1204, 1264, 1311, 1395, 1792, 2016, 2179, 2255, 2475, 2559, 2931]","[958, 1311]","[52, 252, 351, 376, 601, 687, 920, 942, 1176, 1204, 1264, 1395, 1792, 2016, 2179, 2255, 2475, 2559, 2931]","[958, 1311]",2994,21,2973,2,19,2973,0
2.5,HUMBETGLOE,"[52, 252, 349, 374, 599, 685, 918, 940, 956, 1174, 1202, 1262, 1309, 1393, 1790, 2014, 2177, 2253, 2473, 2557, 2929]","[956, 1309]","[52, 252, 349, 374, 599, 685, 918, 940, 1174, 1202, 1262, 1393, 1790, 2014, 2177, 2253, 2473, 2557, 2929]","[956, 1309]",2992,21,2971,2,19,2971,0
2.5,HUMBETGLOF,"[52, 252, 351, 376, 601, 687, 920, 942, 958, 1176, 1204, 1264, 1311, 1395, 1792, 2016, 2179, 2255, 2475, 2559, 2931]","[958, 1311]","[52, 252, 351, 376, 601, 687, 920, 942, 1176, 1204, 1264, 1395, 1792, 2016, 2179, 2255, 2475, 2559, 2931]","[958, 1311]",2994,21,2973,2,19,2973,0
2.5,HUMBETGLOG,"[52, 252, 351, 376, 601, 687, 920, 942, 958, 1176, 1204, 1264, 1311, 1395, 1792, 2016, 2179, 2255, 2475, 2559, 2931]","[958, 1311]","[52, 252, 351, 376, 601, 687, 920, 942, 1176, 1204, 1264, 1395, 1792, 2016, 2179, 2255, 2475, 2559, 2931]","[958, 1311]",2994,21,2973,2,19,2973,0
2.5,HUMBETGLOH,"[52, 252, 351, 376, 601, 687, 920, 942, 958, 1176, 1204, 1264, 1311, 1395, 1792, 2016, 2179, 2255, 2475, 2559, 2931]","[958, 1311]","[52, 252, 351, 376, 601, 687, 920, 942, 1176, 1204, 1264, 1395, 1792, 2016, 2179, 2255, 2475, 2559, 2931]","[958, 1311]",2994,21,2973,2,19,2973,0
2.5,HUMBETGLOI,"[52, 252, 349, 374, 599, 685, 918, 940, 956, 1174, 1202, 1262, 1309, 1393, 1790, 2014, 2177, 2253, 2473, 2557, 2929]","[956, 1309]","[52, 252, 349, 374, 599, 685, 918, 940, 1174, 1202, 1262, 1393, 1790, 2014, 2177, 2253, 2473, 2557, 2929]","[956, 1309]",2992,21,2971,2,19,2971,0
2.5,HUMBETGLOJ,"[52, 252, 349, 374, 599, 685, 918, 940, 956, 1174, 1202, 1262, 1309, 1393, 1790, 2014, 2177, 2253, 2473, 2557, 2929]","[956, 1309]","[52, 252, 349, 374, 599, 685, 918, 940, 1174, 1202, 1262, 1393, 1790, 2014, 2177, 2253, 2473, 2557, 2929]","[956, 1309]",2992,21,2971,2,19,2971,0
2.5,HUMBETGLOK,"[52, 252, 349, 374, 599, 685, 918, 940, 956, 1174, 1202, 1262, 1309, 1393, 1790, 2014, 2177, 2253, 2473, 2557, 2929]","[956, 1309]","[52, 252, 349, 374, 599, 685, 918, 940, 1174, 1202, 1262, 1393, 1790, 2014, 2177, 2253, 2473, 2557, 2929]","[956, 1309]",2992,21,2971,2,19,2971,0
2.5,HUMBETGLOL,"[52, 252, 349, 374, 599, 685, 918, 940, 956, 1174, 1202, 1262, 1309, 1393, 1790, 2014, 2177, 2253, 2473, 2557, 2929]","[956, 1309]","[52, 252, 349, 374, 599, 685, 918, 940, 1174, 1202, 1262, 1393, 1790, 2014, 2177, 2253, 2473, 2557, 2929]","[956, 1309]",2992,21,2971,2,19,2971,0
2.5,HUMBETGLOM,"[52, 252, 348, 373, 598, 684, 917, 939, 955, 1173, 1201, 1261, 1308, 1392, 1789, 2013, 2176, 2252, 2472, 2556, 2928]","[955, 1308]","[52, 252, 348, 373, 598, 684, 917, 939, 1173, 1201, 1261, 1392, 1789, 2013, 2176, 2252, 2472, 2556, 2928]","[955, 1308]",2991,21,2970,2,19,2970,0
2.5,HUMBETGLON,"[52, 252, 349, 374, 599, 685, 918, 940, 956, 1174, 1202, 1262, 1309, 1393, 1790, 2014, 2177, 2253, 2473, 2557, 2929]","[956, 1309]","[52, 252, 349, 374, 599, 685, 918, 940, 1174, 1202, 1262, 1393, 1790, 2014, 2177, 2253, 2473, 2557, 2929]","[956, 1309]",2992,21,2971,2,19,2971,0
2.5,HUMBETGLOO,"[52, 252, 349, 374, 599, 685, 918, 940, 956, 1174, 1202, 1262, 1309, 1393, 1790, 2014, 2177, 2253, 2473, 2557, 2929]","[956, 1309]","[52, 252, 349, 374, 599, 685, 918, 940, 1174, 1202, 1262, 1393, 1790, 2014, 2177, 2253, 2473, 2557, 2929]","[956, 1309]",2992,21,2971,2,19,2971,0
2.5,HUMBETGLOP,"[52, 252, 349, 374, 599, 685, 918, 940, 956, 1174, 1202, 1262, 1309, 1393, 1790, 2014, 2177, 2253, 2473, 2557, 2929]","[956, 1309]","[52, 252, 349, 374, 599, 685, 918, 940, 1174, 1202, 1262, 1393, 1790, 2014, 2177, 2253, 2473, 2557, 2929]","[956, 1309]",2992,21,2971,2,19,2971,0
2.5,HUMBETGLOR,"[52, 252, 349, 374, 599, 685, 918, 940, 956, 1174, 1202, 1262, 1309, 1393, 1790, 2014, 2177, 2253, 2473, 2557, 2929]","[956, 1309]","[52, 252, 349, 374, 599, 685, 918, 940, 1174, 1202, 1262, 1393, 1790, 2014, 2177, 2253, 2473, 2557, 2929]","[956, 1309]",2992,21,2971,2,19,2971,0
2.5,HUMCBRG,"[80, 90, 167, 237, 305, 395, 517, 567, 704, 1172, 1220, 1525, 2123, 2272, 2282, 2616, 2689, 2715, 2796, 2848, 2897, 2901, 2950, 3041]","[567, 1220]","[80, 90, 167, 237, 305, 395, 517, 704, 1172, 1525, 2123, 2272, 2282, 2616, 2689, 2715, 2796, 2848, 2897, 2901, 2950, 3041]","[567, 1220]",3318,24,3294,2,22,3294,0
2.5,HUMCHYMASE,"[160, 501, 510, 646, 969, 1185, 1277, 1379, 1826, 2315, 2682, 2951, 3135, 3165, 3252, 3406, 3463, 3765, 3874, 3982, 4038, 4104, 4355, 4923, 4986, 5028, 5216, 5602, 5644, 5723, 5779, 6037, 6922, 7220, 7255, 7363, 7455, 7463, 7615, 7795, 7931, 8006, 8052]","[5216, 6037, 6922, 7363]","[160, 501, 510, 646, 969, 1185, 1277, 1379, 1826, 2315, 2682, 2951, 3135, 3165, 3252, 3406, 3463, 3765, 3874, 3982, 4038, 4104, 4355, 4923, 4986, 5028, 5602, 5644, 5723, 5779, 7220, 7255, 7455, 7463, 7615, 7795, 7931, 8006, 8052]","[5216, 6037, 6922, 7363]",8107,43,8064,4,39,8064,0
2.5,HUMCP21OH,"[92, 126, 185, 408, 435, 463, 505, 622, 626, 634, 644, 947, 994, 1134, 1259, 1321, 1357, 1566, 1571, 1600, 1780, 1970, 2158, 2167, 2528, 2580, 2845, 2907, 2931, 3094, 3242, 3403, 3481, 3509, 3589, 3648, 3659, 3758, 3844]","[947, 1134, 1571, 1780, 1970, 2158, 2528, 2907, 3094]","[92, 126, 185, 408, 435, 463, 505, 622, 626, 634, 644, 994, 1259, 1321, 1357, 1566, 1600, 2167, 2580, 2845, 2931, 3242, 3403, 3481, 3509, 3589, 3648, 3659, 3758, 3844]","[947, 1134, 1571, 1780, 1970, 2158, 2528, 2907, 3094]",4034,39,3995,9,30,3995,0
2.5,HUMCP21OHC,"[92, 126, 185, 408, 435, 506, 623, 627, 635, 645, 948, 995, 1135, 1260, 1322, 1358, 1567, 1572, 1601, 1781, 1971, 2159, 2529, 2581, 2846, 2908, 2933, 3096, 3244, 3405, 3483, 3511, 3591, 3650, 3661, 3760, 3846]","[948, 1135, 1572, 1781, 1971, 2159, 2529, 2908, 3096]","[92, 126, 185, 408, 435, 506, 623, 627, 635, 645, 995, 1260, 1322, 1358, 1567, 1601, 2581, 2846, 2933, 3244, 3405, 3483, 3511, 3591, 3650, 3661, 3760, 3846]","[948, 1135, 1572, 1781, 1971, 2159, 2529, 2908, 3096]",4036,37,3999,9,28,3999,0
2.5,HUMCS1,"[85, 144, 148, 304, 310, 393, 429, 565, 652, 669, 893, 991, 1010, 1016, 1194, 1334, 1480, 1496, 1591, 1679, 1726, 2003, 2095, 2160, 2190, 2196, 2210, 2278]","[565, 991, 1334, 1591]","[85, 144, 148, 304, 310, 393, 429, 652, 669, 893, 1010, 1016, 1194, 1480, 1496, 1679, 1726, 2003, 2095, 2160, 2190, 2196, 2210, 2278]","[565, 991, 1334, 1591]",2293,28,2265,4,24,2265,0
2.5,HUMCS3,"[87, 146, 150, 306, 312, 395, 431, 566, 654, 671, 893, 991, 1010, 1016, 1120, 1194, 1334, 1477, 1493, 1588, 1606, 1724, 2001, 2098, 2194, 2200, 2214, 2520, 2728]","[566, 991, 1334, 1588]","[87, 146, 150, 306, 312, 395, 431, 654, 671, 893, 1010, 1016, 1120, 1194, 1477, 1493, 1606, 1724, 2001, 2098, 2194, 2200, 2214, 2520, 2728]","[566, 991, 1334, 1588]",2732,29,2703,4,25,2703,0
2.5,HUMCSN2A,"[122, 241, 303, 546, 591, 772, 912, 1451, 1819, 1845, 2086, 2107, 2228, 2287, 2468, 2520, 2593, 2753, 2761, 3145, 3194, 3235, 3423, 3430, 3480, 3645, 3776, 4104, 4184, 4368, 4855, 5391, 5620, 5742, 5747, 6144, 6244, 6276, 6302, 6682, 6747, 6810, 6887, 6959, 7155, 7171, 7201, 7210, 7234, 7324, 7474, 7617, 7789, 8522, 8564, 8662, 8683, 8751, 8805, 9482, 10040, 10137, 10265]","[4855, 5747, 6747, 6887, 8522]","[122, 241, 303, 546, 591, 772, 912, 1451, 1819, 1845, 2086, 2107, 2228, 2287, 2468, 2520, 2593, 2753, 2761, 3145, 3194, 3235, 3423, 3430, 3480, 3645, 3776, 4104, 4184, 4368, 5391, 5620, 5742, 6144, 6244, 6276, 6302, 6682, 6810, 6959, 7155, 7171, 7201, 7210, 7234, 7324, 7474, 7617, 7789, 8564, 8662, 8683, 8751, 8805, 9482, 10040, 10137, 10265]","[4855, 5747, 6747, 6887, 8522]",10600,63,10537,5,58,10537,0
2.5,HUMCSPA,"[455, 494, 982, 1050, 1239, 1248, 1553, 1883, 2216, 2232, 2276, 2372, 2477, 2929, 3026, 3200, 3392, 3455, 3608, 3691, 3819, 3837, 4007, 4129, 4526]","[982, 2276, 2929, 3392]","[455, 494, 1050, 1239, 1248, 1553, 1883, 2216, 2232, 2372, 2477, 3026, 3200, 3455, 3608, 3691, 3819, 3837, 4007, 4129, 4526]","[982, 2276, 2929, 3392]",4783,25,4758,4,21,4758,0
2.5,HUMCTLA1,"[58, 205, 440, 701, 705, 775, 988, 1184, 1299, 1332, 1812, 1976, 2119, 2179, 2297, 2336, 2349, 2360, 2770, 2867, 3041, 3122, 3151, 3236, 3532, 3550, 3695, 3777, 3912, 4099, 4394]","[988, 2179, 2770, 3236]","[58, 205, 440, 701, 705, 775, 1184, 1299, 1332, 1812, 1976, 2119, 2297, 2336, 2349, 2360, 2867, 3041, 3122, 3151, 3532, 3550, 3695, 3777, 3912, 4099, 4394]","[988, 2179, 2770, 3236]",4520,31,4489,4,27,4489,0
2.5,HUMDEF5A,"[58, 97, 159, 226, 296, 500, 677, 923, 980, 1387, 1571, 1719, 1922, 1934, 2039, 2196, 2276, 2280, 2299, 2323, 2394, 2601, 2618]",[1571],"[58, 97, 159, 226, 296, 500, 677, 923, 980, 1387, 1719, 1922, 1934, 2039, 2196, 2276, 2280, 2299, 2323, 2394, 2601, 2618]",[1571],2872,23,2849,1,22,2849,0
2.5,HUMDZA2G,"[24, 296, 333, 595, 631, 680, 691, 727, 829, 849, 1160, 1425, 1531, 1645, 1715, 1747, 1912, 1973, 1982, 2003, 2013, 2239, 2296, 2353, 2553, 2928, 3566, 3637, 3711, 3763, 3775, 3942, 3969, 4027, 4262, 4294, 4436, 4857, 5001, 5316, 5389, 5436, 5803, 5868, 6013, 6178, 6400, 6544, 6555, 6636, 7006, 7391, 7542, 7830, 8063, 8142, 8480, 8981, 9184, 9481, 9590, 9649, 9758, 9898, 9945, 10166, 10355, 10461, 10466, 10495, 10538, 10609, 10624, 10677, 10862, 10894, 11016, 11212, 11267, 11273, 11300, 11360, 11451, 11530, 12139, 12274, 12318, 12544, 12929, 12937, 13183, 13458, 13467, 13473, 13485, 13632, 13857, 13862, 13930, 13938, 13978, 13984, 14171, 14633]","[5389, 9590, 13183]","[24, 296, 333, 595, 631, 680, 691, 727, 829, 849, 1160, 1425, 1531, 1645, 1715, 1747, 1912, 1973, 1982, 2003, 2013, 2239, 2296, 2353, 2553, 2928, 3566, 3637, 3711, 3763, 3775, 3942, 3969, 4027, 4262, 4294, 4436, 4857, 5001, 5316, 5436, 5803, 5868, 6013, 6178, 6400, 6544, 6555, 6636, 7006, 7391, 7542, 7830, 8063, 8142, 8480, 8981, 9184, 9481, 9649, 9758, 9898, 9945, 10166, 10355, 10461, 10466, 10495, 10538, 10609, 10624, 10677, 10862, 10894, 11016, 11212, 11267, 11273, 11300, 11360, 11451, 11530, 12139, 12274, 12318, 12544, 12929, 12937, 13458, 13467, 13473, 13485, 13632, 13857, 13862, 13930, 13938, 13978, 13984, 14171, 14633]","[5389, 9590, 13183]",14686,104,14582,3,101,14582,0
2.5,HUMELAFIN,"[11, 208, 326, 338, 417, 557, 786, 802, 839, 1089, 1351, 1456, 1461, 1517, 1534, 1538, 1559]",[326],"[11, 208, 338, 417, 557, 786, 802, 839, 1089, 1351, 1456, 1461, 1517, 1534, 1538, 1559]",[326],1870,17,1853,1,16,1853,0
2.5,HUMEPOHYDD,"[356, 362, 504, 776, 845, 1048, 1107, 1253, 1351, 1446, 1470, 1724, 1863, 1951, 2121, 2164, 2190, 2283, 2289, 2324, 2464, 2523, 2801, 2972, 2990, 3022, 3069, 3143, 3327, 3443, 3451, 3511, 3588, 3635, 3680, 3941, 4151, 4208, 4385, 4407, 4725, 4900, 4996, 5057, 5207, 5211, 5571, 5656, 5700, 5814, 5979, 5997, 6103, 6115, 6277, 6289, 6349, 6389, 6422, 6537, 6542, 6599, 6758, 6950, 7098, 7197, 7261, 7946, 7960, 8217, 8650, 8696, 8728, 8999, 9045, 9091, 9132, 9213, 9328, 9470, 9489, 9499, 9564, 9709, 9866, 10042, 10184, 10212, 10263, 10307, 10319, 10351, 10392, 10404, 10475, 10621, 10778, 10813, 10872, 10965, 11088, 11192, 11282, 11482, 11772, 11832, 12105, 12409, 12570, 12607, 12625, 12819, 12924, 12928, 13058, 13103, 13241, 13279, 13322, 13416, 13618, 13651, 13804, 13810, 13815, 13924, 14095, 14107, 14168, 14420, 14606, 15062, 15197, 15227, 15415, 15620, 15666, 15705, 15831, 15858, 16085, 16105, 16172, 16324, 16570, 16708, 16771, 16775, 16885, 17075, 17080, 17170, 17238, 17489, 17502, 17511, 17789, 17805, 17810, 17870, 17986, 18254, 18296, 18298, 18395, 18573, 18823, 18887, 18944, 19118, 19204, 19373, 19571, 19698, 19814, 19867, 19920, 20118, 20318, 20403, 20545, 20674, 20683, 20720, 20725, 20857, 20883, 20926, 20954, 20979, 20994, 20998, 21354, 21441, 21468, 21539, 21648, 21715, 21772, 21941, 21945, 21956, 22059, 22251, 22318, 22539, 22603, 22856, 22952, 22980, 23010, 23217, 23497, 23652, 23927, 24312, 24408, 24469, 24481, 24592, 24629, 24773]","[5656, 8696, 15620, 16085, 16775, 19204, 21354]","[356, 362, 504, 776, 845, 1048, 1107, 1253, 1351, 1446, 1470, 1724, 1863, 1951, 2121, 2164, 2190, 2283, 2289, 2324, 2464, 2523, 2801, 2972, 2990, 3022, 3069, 3143, 3327, 3443, 3451, 3511, 3588, 3635, 3680, 3941, 4151, 4208, 4385, 4407, 4725, 4900, 4996, 5057, 5207, 5211, 5571, 5700, 5814, 5979, 5997, 6103, 6115, 6277, 6289, 6349, 6389, 6422, 6537, 6542, 6599, 6758, 6950, 7098, 7197, 7261, 7946, 7960, 8217, 8650, 8728, 8999, 9045, 9091, 9132, 9213, 9328, 9470, 9489, 9499, 9564, 9709, 9866, 10042, 10184, 10212, 10263, 10307, 10319, 10351, 10392, 10404, 10475, 10621, 10778, 10813, 10872, 10965, 11088, 11192, 11282, 11482, 11772, 11832, 12105, 12409, 12570, 12607, 12625, 12819, 12924, 12928, 13058, 13103, 13241, 13279, 13322, 13416, 13618, 13651, 13804, 13810, 13815, 13924, 14095, 14107, 14168, 14420, 14606, 15062, 15197, 15227, 15415, 15666, 15705, 15831, 15858, 16105, 16172, 16324, 16570, 16708, 16771, 16885, 17075, 17080, 17170, 17238, 17489, 17502, 17511, 17789, 17805, 17810, 17870, 17986, 18254, 18296, 18298, 18395, 18573, 18823, 18887, 18944, 19118, 19373, 19571, 19698, 19814, 19867, 19920, 20118, 20318, 20403, 20545, 20674, 20683, 20720, 20725, 20857, 20883, 20926, 20954, 20979, 20994, 20998, 21441, 21468, 21539, 21648, 21715, 21772, 21941, 21945, 21956, 22059, 22251, 22318, 22539, 22603, 22856, 22952, 22980, 23010, 23217, 23497, 23652, 23927, 24312, 24408, 24469, 24481, 24592, 24629, 24773]","[5656, 8696, 15620, 16085, 16775, 19204, 21354]",24782,222,24560,7,215,24560,0
2.5,HUMG0S24B,"[91, 103, 538, 631, 658, 812, 855, 1005, 1133, 1182, 1264, 1268, 1331, 1392, 1415, 2413, 2598, 2785, 3102]",[631],"[91, 103, 538, 658, 812, 855, 1005, 1133, 1182, 1264, 1268, 1331, 1392, 1415, 2413, 2598, 2785, 3102]",[631],3127,19,3108,1,18,3108,0
2.5,HUMG0S8PP,"[91, 216, 401, 545, 660, 743, 784, 942, 1018, 1230, 1342, 1379, 1523, 2148, 2152, 2333, 2682, 2686, 2744, 2826, 2842, 2853, 3036, 3166, 3170, 3261, 3358, 3467, 3558, 3577, 3590, 3768, 3836, 3840, 3932, 4113, 4316, 4356, 4399, 4646, 5273, 5361, 5586, 5877, 6062, 6110, 6236, 6257, 6552, 7286]","[2682, 3768, 3932, 4646]","[91, 216, 401, 545, 660, 743, 784, 942, 1018, 1230, 1342, 1379, 1523, 2148, 2152, 2333, 2686, 2744, 2826, 2842, 2853, 3036, 3166, 3170, 3261, 3358, 3467, 3558, 3577, 3590, 3836, 3840, 4113, 4316, 4356, 4399, 5273, 5361, 5586, 5877, 6062, 6110, 6236, 6257, 6552, 7286]","[2682, 3768, 3932, 4646]",7337,50,7287,4,46,7287,0
2.5,HUMGAD45A,"[11, 392, 628, 724, 927, 1042, 1114, 1178, 1215, 1292, 1321, 1425, 1558, 1628, 1761, 1779, 2266, 2457, 2461, 2596, 2655, 2835, 2927, 2968, 3006, 3078, 3092, 3184, 3534, 3639, 3645, 3730, 3734, 3827, 3880, 4167, 4171, 4194, 4396, 4402, 4427, 4472, 4529, 4828, 4956, 5015]","[2596, 3184, 3645]","[11, 392, 628, 724, 927, 1042, 1114, 1178, 1215, 1292, 1321, 1425, 1558, 1628, 1761, 1779, 2266, 2457, 2461, 2655, 2835, 2927, 2968, 3006, 3078, 3092, 3534, 3639, 3730, 3734, 3827, 3880, 4167, 4171, 4194, 4396, 4402, 4427, 4472, 4529, 4828, 4956, 5015]","[2596, 3184, 3645]",5370,46,5324,3,43,5324,0
2.5,HUMGARE,"[20, 25, 71, 299, 309, 322, 590, 598, 609, 633, 810, 964, 1056, 1121, 1264, 1273, 1277, 1467, 1537, 1583, 1641, 1872, 1881, 2239, 2243, 2299, 2330, 2373, 2411, 2455, 2519, 2611, 2653, 2861, 2960, 2998, 3118, 3133, 3186, 3190, 3207, 3213, 3254, 3259, 3369, 3507, 3522, 3993, 4469, 4718]","[810, 2239, 2653, 3118]","[20, 25, 71, 299, 309, 322, 590, 598, 609, 633, 964, 1056, 1121, 1264, 1273, 1277, 1467, 1537, 1583, 1641, 1872, 1881, 2243, 2299, 2330, 2373, 2411, 2455, 2519, 2611, 2861, 2960, 2998, 3133, 3186, 3190, 3207, 3213, 3254, 3259, 3369, 3507, 3522, 3993, 4469, 4718]","[810, 2239, 2653, 3118]",4746,50,4696,4,46,4696,0
2.5,HUMGCK,"[304, 444, 506, 573, 634, 725, 916, 1188, 1249, 1514, 1542, 1582, 1989, 2345, 2454, 2647, 2971, 3096, 3108, 3123, 3197, 3248, 3360, 3370, 3684, 3774, 3783, 3789, 3799, 3819, 3882, 3954, 3974, 4030, 4288, 4312, 4503, 4553, 4558, 4806, 4942, 4999, 5011, 5015, 5088, 5092, 5118, 5341, 5356, 5442, 5452, 5584, 5623, 5637, 5808, 5848, 5956, 5964, 5981, 6422, 6475, 6500, 6630, 6651, 6744, 6765, 6830, 6921, 6933, 6946, 7127, 7155, 7591]","[1188, 3360, 3882, 4312, 4806, 5015, 5452, 5964, 6475]","[304, 444, 506, 573, 634, 725, 916, 1249, 1514, 1542, 1582, 1989, 2345, 2454, 2647, 2971, 3096, 3108, 3123, 3197, 3248, 3370, 3684, 3774, 3783, 3789, 3799, 3819, 3954, 3974, 4030, 4288, 4503, 4553, 4558, 4942, 4999, 5011, 5088, 5092, 5118, 5341, 5356, 5442, 5584, 5623, 5637, 5808, 5848, 5956, 5981, 6422, 6500, 6630, 6651, 6744, 6765, 6830, 6921, 6933, 6946, 7127, 7155, 7591]","[1188, 3360, 3882, 4312, 4806, 5015, 5452, 5964, 6475]",7519,73,7446,9,64,7446,0
2.5,HUMGFP40H,"[4, 11, 243, 278, 910, 1058, 1140, 1173, 1731, 1748, 1846, 1870, 1943, 2361, 2486, 2551, 2593, 2646, 2752, 2781, 3126, 3261, 3263, 3295, 3319, 3426, 3615, 3833, 4025, 4290, 4337]","[910, 1058, 1173, 2593]","[4, 11, 243, 278, 1140, 1731, 1748, 1846, 1870, 1943, 2361, 2486, 2551, 2646, 2752, 2781, 3126, 3261, 3263, 3295, 3319, 3426, 3615, 3833, 4025, 4290, 4337]","[910, 1058, 1173, 2593]",4371,31,4340,4,27,4340,0
2.5,HUMGHG,"[40, 79, 689, 757, 946, 955, 1260, 1590, 1923, 1939, 1983, 2079, 2184, 2636, 2733, 2907, 3099, 3162, 3315, 3398, 3526, 3544, 3713, 3835, 4218]","[689, 1983, 2636, 3099]","[40, 79, 757, 946, 955, 1260, 1590, 1923, 1939, 2079, 2184, 2733, 2907, 3162, 3315, 3398, 3526, 3544, 3713, 3835, 4218]","[689, 1983, 2636, 3099]",4444,25,4419,4,21,4419,0
2.5,HUMGHN,"[85, 144, 148, 199, 235, 307, 313, 397, 434, 569, 673, 989, 1008, 1176, 1316, 1574, 2181, 2217, 2439, 2583]","[569, 989, 1316, 1574]","[85, 144, 148, 199, 235, 307, 313, 397, 434, 673, 1008, 1176, 2181, 2217, 2439, 2583]","[569, 989, 1316, 1574]",2649,20,2629,4,16,2629,0
2.5,HUMGHV,"[86, 145, 149, 198, 234, 306, 312, 396, 432, 464, 566, 653, 998, 1010, 1017, 1136, 1188, 1307, 1328, 1351, 1580, 1584, 2087, 2188, 2207, 2223, 2443, 2485]","[566, 998, 1328, 1584]","[86, 145, 149, 198, 234, 306, 312, 396, 432, 464, 653, 1010, 1017, 1136, 1188, 1307, 1351, 1580, 2087, 2188, 2207, 2223, 2443, 2485]","[566, 998, 1328, 1584]",2652,28,2624,4,24,2624,0
2.5,HUMGSTM4A,"[116, 487, 516, 758, 777, 781, 813, 939, 943, 953, 1139, 1272, 1535, 1631, 1665, 1844, 2024, 2058, 2098, 2124, 2225, 2565, 2573, 2880, 2888, 2925, 3023, 3143, 3246, 3262, 3275, 3463, 3649, 3700, 3753, 3933, 3996, 4041, 4072, 4160, 4225, 4279, 4306, 4311, 4329, 4425, 4566, 4573, 4740, 4760, 4791, 4798, 4913, 4991, 5152, 5193, 5226, 5262, 5601, 5623, 5629]","[777, 1139, 1631, 2024, 2225, 3262, 3463]","[116, 487, 516, 758, 781, 813, 939, 943, 953, 1272, 1535, 1665, 1844, 2058, 2098, 2124, 2565, 2573, 2880, 2888, 2925, 3023, 3143, 3246, 3275, 3649, 3700, 3753, 3933, 3996, 4041, 4072, 4160, 4225, 4279, 4306, 4311, 4329, 4425, 4566, 4573, 4740, 4760, 4791, 4798, 4913, 4991, 5152, 5193, 5226, 5262, 5601, 5623, 5629]","[777, 1139, 1631, 2024, 2225, 3262, 3463]",6074,61,6013,7,54,6013,0
2.5,HUMHMGIY,"[190, 310, 654, 720, 1075, 1337, 1472, 1557, 1961, 1967, 2136, 2388, 2454, 2558, 2578, 2704, 3267, 3280, 3749, 3875, 3900, 3978, 3983, 4055, 4328, 4410, 4416, 4529, 4627, 4648, 4660, 4711, 4773, 4781, 4785, 4831, 5075, 5150, 5161, 5444, 5461, 5496, 5569, 5574, 5619, 5655, 5722, 5961, 6012, 6274, 6344, 6422, 6544, 6627, 6673, 6687, 6776, 6897, 7016, 7032, 7038, 7089, 7102, 7133, 7166, 7270, 7274, 7315, 7420, 7449, 7463, 7629, 7691, 7695, 7781, 7923, 7962, 8043, 8047, 8095, 8361, 8374, 8507, 8968, 9134, 9199, 9286, 9360, 9390, 9424, 9763, 9791, 9823, 9995, 10022, 10031]","[4660, 6544, 7270]","[190, 310, 654, 720, 1075, 1337, 1472, 1557, 1961, 1967, 2136, 2388, 2454, 2558, 2578, 2704, 3267, 3280, 3749, 3875, 3900, 3978, 3983, 4055, 4328, 4410, 4416, 4529, 4627, 4648, 4711, 4773, 4781, 4785, 4831, 5075, 5150, 5161, 5444, 5461, 5496, 5569, 5574, 5619, 5655, 5722, 5961, 6012, 6274, 6344, 6422, 6627, 6673, 6687, 6776, 6897, 7016, 7032, 7038, 7089, 7102, 7133, 7166, 7274, 7315, 7420, 7449, 7463, 7629, 7691, 7695, 7781, 7923, 7962, 8043, 8047, 8095, 8361, 8374, 8507, 8968, 9134, 9199, 9286, 9360, 9390, 9424, 9763, 9791, 9823, 9995, 10022, 10031]","[4660, 6544, 7270]",10098,96,10002,3,93,10002,0
2.5,HUMHOX13G,"[93, 336, 380, 503, 730, 811, 1102, 1131, 1392, 1451, 1653, 2083, 2405, 2502, 2576, 2652, 2796, 2814, 2828, 2996]",[811],"[93, 336, 380, 503, 730, 1102, 1131, 1392, 1451, 1653, 2083, 2405, 2502, 2576, 2652, 2796, 2814, 2828, 2996]",[811],3062,20,3042,1,19,3042,0
2.5,HUMHPARS1,"[20, 338, 573, 779, 967, 1046, 1113, 1300, 1320, 1655, 1886, 1907, 1961, 2005, 2105, 2327, 2348, 2362, 2449, 2475, 2632, 2648, 2984, 3020, 3096, 3258, 3337, 3496, 3846, 3855, 4015, 4332, 4708, 4744, 4820, 4982, 5061, 5220, 5568, 5577, 5730, 6047, 6373, 6499, 6620, 6790, 6880, 6889, 6948, 7039, 7164, 7212, 7217, 7221, 7231, 7510, 7569, 7692, 7696, 7752, 8010, 8126, 8420, 8485, 8495, 8703, 8717, 8728, 8994, 9085, 9189, 9266, 9332, 9344, 9570, 9649, 9716, 9904, 9924, 10149, 10183, 10406, 10408, 10466, 10488, 10563, 10607, 10668, 10772, 11326, 11363, 11385, 11460, 11502]","[1046, 2632, 3020, 3855, 4744, 5577]","[20, 338, 573, 779, 967, 1113, 1300, 1320, 1655, 1886, 1907, 1961, 2005, 2105, 2327, 2348, 2362, 2449, 2475, 2648, 2984, 3096, 3258, 3337, 3496, 3846, 4015, 4332, 4708, 4820, 4982, 5061, 5220, 5568, 5730, 6047, 6373, 6499, 6620, 6790, 6880, 6889, 6948, 7039, 7164, 7212, 7217, 7221, 7231, 7510, 7569, 7692, 7696, 7752, 8010, 8126, 8420, 8485, 8495, 8703, 8717, 8728, 8994, 9085, 9189, 9266, 9332, 9344, 9570, 9649, 9716, 9904, 9924, 10149, 10183, 10406, 10408, 10466, 10488, 10563, 10607, 10668, 10772, 11326, 11363, 11385, 11460, 11502]","[1046, 2632, 3020, 3855, 4744, 5577]",11543,94,11449,6,88,11449,0
2.5,HUMIBP3,"[182, 297, 854, 1111, 1260, 1284, 1409, 1473, 1495, 1556, 1685, 1701, 1718, 2107, 2149, 2221, 2253, 2277, 2441, 2457, 2584, 2687, 2715, 2845, 2849, 2935, 2951, 3048, 3142, 3149, 3153, 3356, 3635, 3734, 3924, 3984, 4247, 4262, 4304, 4342, 4358, 4406, 4476, 4713, 4924, 5122, 5197, 5323, 5394, 5534, 5553, 5586, 5735, 5953, 6064, 6375, 6425, 6617, 6621, 6764, 7087, 7184, 7249, 7377, 7471, 7687, 7708, 7842, 7925, 8250, 8353, 8648, 8677, 8756, 9014, 9095, 9118, 9132, 9390, 9458, 9873, 9945, 10031, 10085, 10425, 10554, 10602]","[2441, 5953, 6617]","[182, 297, 854, 1111, 1260, 1284, 1409, 1473, 1495, 1556, 1685, 1701, 1718, 2107, 2149, 2221, 2253, 2277, 2457, 2584, 2687, 2715, 2845, 2849, 2935, 2951, 3048, 3142, 3149, 3153, 3356, 3635, 3734, 3924, 3984, 4247, 4262, 4304, 4342, 4358, 4406, 4476, 4713, 4924, 5122, 5197, 5323, 5394, 5534, 5553, 5586, 5735, 6064, 6375, 6425, 6621, 6764, 7087, 7184, 7249, 7377, 7471, 7687, 7708, 7842, 7925, 8250, 8353, 8648, 8677, 8756, 9014, 9095, 9118, 9132, 9390, 9458, 9873, 9945, 10031, 10085, 10425, 10554, 10602]","[2441, 5953, 6617]",10876,87,10789,3,84,10789,0
2.5,HUMIDS,"[145, 296, 372, 636, 672, 1160, 1685, 1797, 1972, 2038, 2060, 2064, 2248, 2356, 2376, 2471, 2549, 2769, 2856, 2860, 2882, 3140, 3216, 3222, 3238, 3243, 3321, 3374, 3731, 4119, 4174, 4384, 4684, 4778, 4834, 4865, 5228, 5244, 5385, 5446, 5641, 5850, 5864, 5876, 5927, 6071, 6150, 6173, 6178, 6269, 6964, 7093, 7095, 7368, 7784, 8086, 8166, 8266, 8277, 8364, 8494, 8557, 8678, 8700, 8721, 8796, 9161, 9282, 9286, 9391, 9526, 9541, 9554, 9819, 9847, 9897, 9901, 9965, 10120, 10137, 10170, 10235, 10734, 10877, 10987, 11102, 11136, 11158, 11182, 11290, 11397, 11401, 11849, 11928, 12302, 12325, 12329, 12855, 13103, 13437, 13812, 13919, 13928, 13969, 14036, 14124, 14169, 14418, 14508, 14645, 14655, 14702, 14808, 14925, 14980, 15205, 15210, 15473, 15477, 15575, 15579, 15596, 15654, 15693, 15803, 15879, 15901, 15968, 16084, 16088, 16829, 16844, 16993, 17048, 17085, 17241, 17881, 18126, 18130, 18292, 18335, 18552, 18603, 18666, 18689, 18711, 18947, 18957, 18976, 19023, 19046, 19095, 19106, 19268, 19301, 19483, 19537, 19565, 19599, 19657, 19747, 19916, 20032, 20044, 20114, 21158, 21216, 21250, 21311, 21624, 21640, 21720, 21795, 21930, 21946, 22055, 22264, 22309, 22369, 22455, 22524, 22536, 22809, 22814, 23157, 23415, 23494, 24330, 24724, 24865, 24873, 25403, 25482, 25514, 25554, 25810, 25819, 26004, 26093, 26308, 26535, 26836, 26843, 26852, 26943, 26975, 27023, 27097, 27132, 27785, 27983, 28311, 28366, 28627, 28713, 28773, 28973, 28981, 29043, 29070, 29294, 29300, 29338, 29400, 29441, 29518, 29555, 29710, 29830, 30034, 30255, 30261, 30339, 30410, 30436, 30535, 30554, 30602, 30606, 30612, 30773, 30999, 31004, 31038, 31046, 31147, 31168, 31179, 31515, 31699, 31914, 32027, 32099, 32333, 32758, 33216, 33318, 33369, 33667, 33900, 34107, 34423, 34598, 34645, 34665, 35092, 35521, 35535, 35626, 35752, 35761, 35766, 35777, 35860, 35958, 36138, 36195, 36418, 36682, 36699, 36718, 36726]","[1160, 2038, 2882, 5244, 8086, 9847, 15879, 19268]","[145, 296, 372, 636, 672, 1685, 1797, 1972, 2060, 2064, 2248, 2356, 2376, 2471, 2549, 2769, 2856, 2860, 3140, 3216, 3222, 3238, 3243, 3321, 3374, 3731, 4119, 4174, 4384, 4684, 4778, 4834, 4865, 5228, 5385, 5446, 5641, 5850, 5864, 5876, 5927, 6071, 6150, 6173, 6178, 6269, 6964, 7093, 7095, 7368, 7784, 8166, 8266, 8277, 8364, 8494, 8557, 8678, 8700, 8721, 8796, 9161, 9282, 9286, 9391, 9526, 9541, 9554, 9819, 9897, 9901, 9965, 10120, 10137, 10170, 10235, 10734, 10877, 10987, 11102, 11136, 11158, 11182, 11290, 11397, 11401, 11849, 11928, 12302, 12325, 12329, 12855, 13103, 13437, 13812, 13919, 13928, 13969, 14036, 14124, 14169, 14418, 14508, 14645, 14655, 14702, 14808, 14925, 14980, 15205, 15210, 15473, 15477, 15575, 15579, 15596, 15654, 15693, 15803, 15901, 15968, 16084, 16088, 16829, 16844, 16993, 17048, 17085, 17241, 17881, 18126, 18130, 18292, 18335, 18552, 18603, 18666, 18689, 18711, 18947, 18957, 18976, 19023, 19046, 19095, 19106, 19301, 19483, 19537, 19565, 19599, 19657, 19747, 19916, 20032, 20044, 20114, 21158, 21216, 21250, 21311, 21624, 21640, 21720, 21795, 21930, 21946, 22055, 22264, 22309, 22369, 22455, 22524, 22536, 22809, 22814, 23157, 23415, 23494, 24330, 24724, 24865, 24873, 25403, 25482, 25514, 25554, 25810, 25819, 26004, 26093, 26308, 26535, 26836, 26843, 26852, 26943, 26975, 27023, 27097, 27132, 27785, 27983, 28311, 28366, 28627, 28713, 28773, 28973, 28981, 29043, 29070, 29294, 29300, 29338, 29400, 29441, 29518, 29555, 29710, 29830, 30034, 30255, 30261, 30339, 30410, 30436, 30535, 30554, 30602, 30606, 30612, 30773, 30999, 31004, 31038, 31046, 31147, 31168, 31179, 31515, 31699, 31914, 32027, 32099, 32333, 32758, 33216, 33318, 33369, 33667, 33900, 34107, 34423, 34598, 34645, 34665, 35092, 35521, 35535, 35626, 35752, 35761, 35766, 35777, 35860, 35958, 36138, 36195, 36418, 36682, 36699, 36718, 36726]","[1160, 2038, 2882, 5244, 8086, 9847, 15879, 19268]",36837,282,36555,8,274,36555,0
2.5,HUMIGERA,"[68, 106, 147, 529, 627, 831, 1072, 1089, 1097, 1261, 1342, 1403, 1418, 1507, 1601, 1664, 1797, 2173, 2574, 2925, 2948, 3105, 3141, 3297, 3309, 3340, 3396, 3416, 3444, 3459, 3471, 3683, 3845, 4124, 4407, 4527, 4653, 4792, 4942, 4971, 5005, 5024, 5037, 5043, 5105, 5168, 5176, 5359, 5622, 5626, 5681, 5709, 6083, 6188, 6281, 6676, 7019, 7238, 7275]","[1342, 1797, 3105, 5168]","[68, 106, 147, 529, 627, 831, 1072, 1089, 1097, 1261, 1403, 1418, 1507, 1601, 1664, 2173, 2574, 2925, 2948, 3141, 3297, 3309, 3340, 3396, 3416, 3444, 3459, 3471, 3683, 3845, 4124, 4407, 4527, 4653, 4792, 4942, 4971, 5005, 5024, 5037, 5043, 5105, 5176, 5359, 5622, 5626, 5681, 5709, 6083, 6188, 6281, 6676, 7019, 7238, 7275]","[1342, 1797, 3105, 5168]",7651,59,7592,4,55,7592,0
2.5,HUMIL2RGA,"[7, 11, 28, 203, 231, 299, 735, 772, 817, 840, 1017, 1128, 1210, 1232, 1260, 1476, 1519, 1646, 1914, 1957, 1980, 2087, 2162, 2176, 2402, 2589, 2683, 2783, 2794, 2823, 2841, 2857, 3031, 3068, 3126, 3158, 3229, 3353, 3429, 3565, 3718, 3781, 4026]","[203, 735, 1128, 1476, 2402, 3031, 3353]","[7, 11, 28, 231, 299, 772, 817, 840, 1017, 1210, 1232, 1260, 1519, 1646, 1914, 1957, 1980, 2087, 2162, 2176, 2589, 2683, 2783, 2794, 2823, 2841, 2857, 3068, 3126, 3158, 3229, 3429, 3565, 3718, 3781, 4026]","[203, 735, 1128, 1476, 2402, 3031, 3353]",4030,43,3987,7,36,3987,0
2.5,HUMIL4A,"[31, 59, 67, 189, 239, 290, 328, 399, 407, 491, 596, 961, 989, 1248, 1306, 1344, 1408, 1496, 1626, 1644, 1918, 2072, 2726, 2810, 3021, 3035, 3234, 3254, 3354, 3380, 3433, 3469, 3581, 3861, 3877, 4037, 4326, 4460, 4465, 4541, 4830, 4837, 4997, 5549, 5634, 5720, 6427, 6460, 6483, 6557, 6702, 6914, 7003, 7350, 7433, 7514, 7518, 7574, 7646, 7666, 7915, 7981, 8041, 8135, 8140, 8159, 8208, 8316, 8362, 8391, 8407, 8461, 8466, 8512, 8605, 8686, 8706, 9000, 9088, 9169, 9262, 9292, 9369, 9400, 9501, 9516, 9622]","[1306, 1626, 7003]","[31, 59, 67, 189, 239, 290, 328, 399, 407, 491, 596, 961, 989, 1248, 1344, 1408, 1496, 1644, 1918, 2072, 2726, 2810, 3021, 3035, 3234, 3254, 3354, 3380, 3433, 3469, 3581, 3861, 3877, 4037, 4326, 4460, 4465, 4541, 4830, 4837, 4997, 5549, 5634, 5720, 6427, 6460, 6483, 6557, 6702, 6914, 7350, 7433, 7514, 7518, 7574, 7646, 7666, 7915, 7981, 8041, 8135, 8140, 8159, 8208, 8316, 8362, 8391, 8407, 8461, 8466, 8512, 8605, 8686, 8706, 9000, 9088, 9169, 9262, 9292, 9369, 9400, 9501, 9516, 9622]","[1306, 1626, 7003]",9892,87,9805,3,84,9805,0
2.5,HUMIRBPG,"[509, 553, 786, 791, 889, 964, 1285, 1420, 1426, 1487, 1516, 1730, 1819, 1823, 1861, 2338, 2419, 2428, 2461, 2593, 2776, 2858, 2935, 2944, 3049, 3181, 3221, 3263, 3400, 3550, 3837, 3861, 3995, 4070, 4084, 4321, 4331, 4548, 4554, 4599, 4606, 4612, 4672, 4677, 4686, 4736, 5069, 5157, 5171, 5340, 5556, 5568, 5575, 5579, 5838, 6337, 6592, 6975, 7156, 7160, 7234, 7238, 7261, 7759, 7948, 8440, 8713, 8766, 8885, 9002, 9086, 9118, 9193, 9262, 9308, 9691]","[3181, 5157, 7160]","[509, 553, 786, 791, 889, 964, 1285, 1420, 1426, 1487, 1516, 1730, 1819, 1823, 1861, 2338, 2419, 2428, 2461, 2593, 2776, 2858, 2935, 2944, 3049, 3221, 3263, 3400, 3550, 3837, 3861, 3995, 4070, 4084, 4321, 4331, 4548, 4554, 4599, 4606, 4612, 4672, 4677, 4686, 4736, 5069, 5171, 5340, 5556, 5568, 5575, 5579, 5838, 6337, 6592, 6975, 7156, 7234, 7238, 7261, 7759, 7948, 8440, 8713, 8766, 8885, 9002, 9086, 9118, 9193, 9262, 9308, 9691]","[3181, 5157, 7160]",9703,76,9627,3,73,9627,0
2.5,HUMLHDC,"[166, 258, 262, 304, 697, 766, 791, 843, 1011, 1551, 1727, 1763, 2138, 2549, 2859, 3070, 3633, 3735, 3820, 3959, 4192, 4598, 4641, 4925, 5217, 5295, 5520, 5561, 5691, 5931, 6016, 6047, 6140, 6172, 6230, 6257, 6295, 6432, 6468, 6492, 6726, 6793, 7357, 7415, 7475, 7949, 8024, 8171, 8200, 8238, 8345, 8690, 8728, 8814, 8890, 8894, 8992, 9392, 9550, 9773, 9823, 10127, 10261, 10326, 10331, 10421, 10512, 10795, 11053, 11067, 11183, 11221, 11591, 11685, 11761, 11765, 11770, 11774, 11797, 11886, 12252, 12323, 12347, 12354, 12358, 12416, 12607, 12756, 12837, 12947, 13017, 13049, 13087, 13182, 13467, 13608, 13768, 14169, 14605, 14811, 15091, 15099, 15103, 15584, 15769, 15824, 15896, 15970, 16003, 16240, 16327, 16409, 16490, 16729, 16774, 17022, 17237, 17363, 17536, 17581, 18253, 18382, 18413, 18464, 18468, 18519, 18782, 18827, 18855, 18919, 18932, 19019, 19108, 19140, 19171, 19312, 19588, 19687, 19692, 19835, 19921, 19951, 20075, 20118, 20137, 20143, 20231, 20300, 20482, 20508, 20534, 20559, 20774, 20857, 20957, 21206, 21593, 21661, 21813, 21867, 22046, 22069, 22090, 22140, 22219, 22581, 22659, 22928, 23120, 23246, 23450, 23457, 23463, 23475, 23600, 23696, 23701, 23866, 24017, 24054, 24086, 24318, 24453, 24636, 24666, 24767, 24780, 25000, 25106, 25206, 25233, 25246, 25488, 25563, 25569, 25614, 25846, 25895, 26119, 26636, 27053, 27058, 27104, 27266, 27550, 27699, 27752, 27789, 28034, 28067, 28086, 28133, 28177, 28191, 28399, 28411, 28493, 28499, 28537, 28671, 28843, 29144, 29151, 29174, 29183, 29672, 29704, 29773, 29869, 30408, 30438, 30867, 30871, 31191, 31391, 31558, 31702, 31819, 31856, 32156, 32346]","[7415, 9773, 14605, 15584, 18382, 18782, 19312, 20300, 20482, 24666, 29773]","[166, 258, 262, 304, 697, 766, 791, 843, 1011, 1551, 1727, 1763, 2138, 2549, 2859, 3070, 3633, 3735, 3820, 3959, 4192, 4598, 4641, 4925, 5217, 5295, 5520, 5561, 5691, 5931, 6016, 6047, 6140, 6172, 6230, 6257, 6295, 6432, 6468, 6492, 6726, 6793, 7357, 7475, 7949, 8024, 8171, 8200, 8238, 8345, 8690, 8728, 8814, 8890, 8894, 8992, 9392, 9550, 9823, 10127, 10261, 10326, 10331, 10421, 10512, 10795, 11053, 11067, 11183, 11221, 11591, 11685, 11761, 11765, 11770, 11774, 11797, 11886, 12252, 12323, 12347, 12354, 12358, 12416, 12607, 12756, 12837, 12947, 13017, 13049, 13087, 13182, 13467, 13608, 13768, 14169, 14811, 15091, 15099, 15103, 15769, 15824, 15896, 15970, 16003, 16240, 16327, 16409, 16490, 16729, 16774, 17022, 17237, 17363, 17536, 17581, 18253, 18413, 18464, 18468, 18519, 18827, 18855, 18919, 18932, 19019, 19108, 19140, 19171, 19588, 19687, 19692, 19835, 19921, 19951, 20075, 20118, 20137, 20143, 20231, 20508, 20534, 20559, 20774, 20857, 20957, 21206, 21593, 21661, 21813, 21867, 22046, 22069, 22090, 22140, 22219, 22581, 22659, 22928, 23120, 23246, 23450, 23457, 23463, 23475, 23600, 23696, 23701, 23866, 24017, 24054, 24086, 24318, 24453, 24636, 24767, 24780, 25000, 25106, 25206, 25233, 25246, 25488, 25563, 25569, 25614, 25846, 25895, 26119, 26636, 27053, 27058, 27104, 27266, 27550, 27699, 27752, 27789, 28034, 28067, 28086, 28133, 28177, 28191, 28399, 28411, 28493, 28499, 28537, 28671, 28843, 29144, 29151, 29174, 29183, 29672, 29704, 29869, 30408, 30438, 30867, 30871, 31191, 31391, 31558, 31702, 31819, 31856, 32156, 32346]","[7415, 9773, 14605, 15584, 18382, 18782, 19312, 20300, 20482, 24666, 29773]",32343,241,32102,11,230,32102,0
2.5,HUMLUCT,"[108, 324, 728, 1095, 1267, 1358, 1550, 1631, 1800, 1818, 1877, 2369, 2405, 2505, 2861, 3004]","[1550, 2505, 2861]","[108, 324, 728, 1095, 1267, 1358, 1631, 1800, 1818, 1877, 2369, 2405, 3004]","[1550, 2505, 2861]",3288,16,3272,3,13,3272,0
2.5,HUMLYTOXBB,"[393, 540, 677, 855, 1097, 1235, 1357, 1361, 1395, 1430, 1472, 1917, 2056, 2109, 2157, 2184, 2202, 2275, 2284, 2407, 2641, 2657, 2694, 2717, 2734, 2859, 2877, 2934, 3048, 3150, 3172, 3207, 3223, 3229, 3274, 3330, 3376, 3631, 4298, 4333, 4348, 4358, 4402, 4472, 4477, 4491, 4498, 4504, 4558, 4665, 4677, 4830, 4935, 4948, 5005, 5291, 5345, 5349, 5355, 5435, 5530, 5655, 6032, 6167, 6179]","[2934, 3376, 3631]","[393, 540, 677, 855, 1097, 1235, 1357, 1361, 1395, 1430, 1472, 1917, 2056, 2109, 2157, 2184, 2202, 2275, 2284, 2407, 2641, 2657, 2694, 2717, 2734, 2859, 2877, 3048, 3150, 3172, 3207, 3223, 3229, 3274, 3330, 4298, 4333, 4348, 4358, 4402, 4472, 4477, 4491, 4498, 4504, 4558, 4665, 4677, 4830, 4935, 4948, 5005, 5291, 5345, 5349, 5355, 5435, 5530, 5655, 6032, 6167, 6179]","[2934, 3376, 3631]",6297,65,6232,3,62,6232,0
2.5,HUMMCHEMP,"[159, 280, 674, 749, 790, 812, 968, 984, 988, 1030, 1065, 1077, 1328, 1590, 2023, 2252, 2500, 2514, 2540, 2621]","[674, 1590]","[159, 280, 749, 790, 812, 968, 984, 988, 1030, 1065, 1077, 1328, 2023, 2252, 2500, 2514, 2540, 2621]","[674, 1590]",2756,20,2736,2,18,2736,0
2.5,HUMMET2,"[432, 438, 505, 565, 615, 866, 1128, 1167, 1233]","[866, 1233]","[432, 438, 505, 565, 615, 1128, 1167]","[866, 1233]",1695,9,1686,2,7,1686,0
2.5,HUMMGPA,"[4, 333, 845, 1045, 1050, 1288, 1299, 1566, 1628, 1723, 1777, 2041, 2295, 2484, 2515, 2598, 2707, 2979, 3022, 3076, 3137, 3516, 3748, 4493, 4586, 5093, 5401, 6334, 7349, 7617]","[3516, 5093, 6334]","[4, 333, 845, 1045, 1050, 1288, 1299, 1566, 1628, 1723, 1777, 2041, 2295, 2484, 2515, 2598, 2707, 2979, 3022, 3076, 3137, 3748, 4493, 4586, 5401, 7349, 7617]","[3516, 5093, 6334]",7726,30,7696,3,27,7696,0
2.5,HUMMIF,"[521, 580, 700, 713, 753, 825, 903, 912, 997, 1129, 1281, 1529, 1643, 1893, 1988, 2123]","[1281, 1643]","[521, 580, 700, 713, 753, 825, 903, 912, 997, 1129, 1529, 1893, 1988, 2123]","[1281, 1643]",2159,16,2143,2,14,2143,0
2.5,HUMMIS,"[427, 527, 623, 669, 778, 837, 1350, 1358, 1474, 1489, 1639, 1887, 2044, 2492, 2535, 2832, 2962]","[623, 1358, 1639, 1887]","[427, 527, 669, 778, 837, 1350, 1474, 1489, 2044, 2492, 2535, 2832, 2962]","[623, 1358, 1639, 1887]",3092,17,3075,4,13,3075,0
2.5,HUMMKXX,"[89, 225, 471, 614, 679, 870, 915, 1040, 1108, 1168, 1264, 1290, 1415, 1574, 1600, 1652, 1699, 1737, 1887, 2019, 2039, 2078, 2202, 2463, 2985, 3142, 3162, 3172, 3194, 3262]","[1415, 1737, 2019]","[89, 225, 471, 614, 679, 870, 915, 1040, 1108, 1168, 1264, 1290, 1574, 1600, 1652, 1699, 1887, 2039, 2078, 2202, 2463, 2985, 3142, 3162, 3172, 3194, 3262]","[1415, 1737, 2019]",3300,30,3270,3,27,3270,0
2.5,HUMNKG5PRO,"[214, 298, 302, 345, 362, 389, 666, 843, 964, 1055, 1118, 1150, 1306, 1505, 1543, 1644, 1865, 1896, 2016, 2091, 2262, 2357, 2431, 2567, 2639, 2715, 2721, 2788, 2915, 2940, 2978, 3111, 3215, 3283, 3288, 3306, 3314, 3387, 3580, 3584, 3750, 3848, 3912, 3982, 3992, 4048, 4473, 4968, 5043, 5180, 5323, 5379, 5435, 5468, 5480, 5804, 6072, 6237, 6251, 6256, 6576, 6599, 6672]","[2262, 3215, 3848, 5468]","[214, 298, 302, 345, 362, 389, 666, 843, 964, 1055, 1118, 1150, 1306, 1505, 1543, 1644, 1865, 1896, 2016, 2091, 2357, 2431, 2567, 2639, 2715, 2721, 2788, 2915, 2940, 2978, 3111, 3283, 3288, 3306, 3314, 3387, 3580, 3584, 3750, 3912, 3982, 3992, 4048, 4473, 4968, 5043, 5180, 5323, 5379, 5435, 5480, 5804, 6072, 6237, 6251, 6256, 6576, 6599, 6672]","[2262, 3215, 3848, 5468]",6738,63,6675,4,59,6675,0
2.5,HUMNTRI,"[10, 163, 313, 575, 668, 803, 893, 998, 1247, 1349, 1385, 1483, 1629, 1895, 1897, 1939, 2145, 2342, 2412, 2615, 2802, 3141, 3151, 3675]",[2802],"[10, 163, 313, 575, 668, 803, 893, 998, 1247, 1349, 1385, 1483, 1629, 1895, 1897, 1939, 2145, 2342, 2412, 2615, 3141, 3151, 3675]",[2802],3702,24,3678,1,23,3678,0
2.5,HUMNTRIII,"[10, 163, 575, 668, 803, 893, 998, 1247, 1349, 1385, 1483, 1629, 1895, 1897, 1939, 2145, 2342, 2412, 2615, 2802, 3141, 3151, 3675]",[2802],"[10, 163, 575, 668, 803, 893, 998, 1247, 1349, 1385, 1483, 1629, 1895, 1897, 1939, 2145, 2342, 2412, 2615, 3141, 3151, 3675]",[2802],3702,23,3679,1,22,3679,0
2.5,HUMOSTP,"[214, 371, 965, 970, 1549, 1581, 2102, 2162, 2358, 2674, 2833, 3054, 3154, 3385, 3509, 3657, 3712, 3890, 3909, 4438, 4738, 4896, 5856, 5862, 6004, 6322, 6327, 6420, 6480, 6496, 6679, 6986, 7239, 7813, 7897, 8035, 8287, 8349, 8520, 8785, 8832, 8884, 9372, 10025, 10030, 10074, 10293, 10352, 10617, 10776, 10814]","[3509, 3657, 6679, 6986, 8349]","[214, 371, 965, 970, 1549, 1581, 2102, 2162, 2358, 2674, 2833, 3054, 3154, 3385, 3712, 3890, 3909, 4438, 4738, 4896, 5856, 5862, 6004, 6322, 6327, 6420, 6480, 6496, 7239, 7813, 7897, 8035, 8287, 8520, 8785, 8832, 8884, 9372, 10025, 10030, 10074, 10293, 10352, 10617, 10776, 10814]","[3509, 3657, 6679, 6986, 8349]",10714,51,10663,5,46,10663,0
2.5,HUMPAP,"[167, 440, 641, 673, 1012, 1410, 1490, 1495, 1644, 1676, 1737, 1774, 1970, 2089, 2115, 2354, 2367, 2414, 2450, 3062, 3167, 3336, 3342, 3477, 3574, 3907, 3950, 4164, 4270, 4366, 4478]","[1410, 2089, 2414, 3167]","[167, 440, 641, 673, 1012, 1490, 1495, 1644, 1676, 1737, 1774, 1970, 2115, 2354, 2367, 2450, 3062, 3336, 3342, 3477, 3574, 3907, 3950, 4164, 4270, 4366, 4478]","[1410, 2089, 2414, 3167]",4489,31,4458,4,27,4458,0
2.5,HUMPCI,"[284, 308, 312, 511, 803, 914, 1118, 1538, 1823, 1844, 1856, 1978, 2078, 2124, 2208, 2226, 2230, 2298, 2329, 2420, 2426, 2579, 2586, 2671, 2784, 2812, 2930, 2948, 2957, 3129, 3238, 3307, 3477, 3536, 3545, 3575, 3636, 3685, 3914, 4247, 4332, 4672, 4697, 4718, 4859, 4906, 4943, 5210, 5226, 5284, 5533, 5543, 5864, 5911, 5996, 6192, 6315, 6332, 6350, 6399, 6409, 6509, 6723, 7009, 7088, 7199, 7255, 7570, 7858, 8054, 8156, 8384, 8546, 8568, 8664, 8725, 8858, 9094, 9187, 9209, 9460, 9603, 9704, 9820, 9901, 9964, 9976, 10139, 10273, 10698, 10704, 10770, 10819, 10839, 10855, 10898, 10982, 11275, 11474, 11483, 12226, 12583, 12688, 12792, 12825, 12860, 12966, 13221, 13408, 13606, 13706, 13739, 14113, 14117, 14121, 14247, 14264, 14272, 14446, 14452, 14488, 14890, 14982, 15018, 15056, 15064, 15146, 15150, 15402]","[8568, 10898, 11483]","[284, 308, 312, 511, 803, 914, 1118, 1538, 1823, 1844, 1856, 1978, 2078, 2124, 2208, 2226, 2230, 2298, 2329, 2420, 2426, 2579, 2586, 2671, 2784, 2812, 2930, 2948, 2957, 3129, 3238, 3307, 3477, 3536, 3545, 3575, 3636, 3685, 3914, 4247, 4332, 4672, 4697, 4718, 4859, 4906, 4943, 5210, 5226, 5284, 5533, 5543, 5864, 5911, 5996, 6192, 6315, 6332, 6350, 6399, 6409, 6509, 6723, 7009, 7088, 7199, 7255, 7570, 7858, 8054, 8156, 8384, 8546, 8664, 8725, 8858, 9094, 9187, 9209, 9460, 9603, 9704, 9820, 9901, 9964, 9976, 10139, 10273, 10698, 10704, 10770, 10819, 10839, 10855, 10982, 11275, 11474, 12226, 12583, 12688, 12792, 12825, 12860, 12966, 13221, 13408, 13606, 13706, 13739, 14113, 14117, 14121, 14247, 14264, 14272, 14446, 14452, 14488, 14890, 14982, 15018, 15056, 15064, 15146, 15150, 15402]","[8568, 10898, 11483]",15563,129,15434,3,126,15434,0
2.5,HUMPEM,"[65, 244, 287, 296, 317, 437, 499, 586, 693, 700, 779, 789, 934, 948, 993, 1033, 1123, 1127, 1175, 1472, 1537, 2101, 2266, 2421, 2480, 2504, 2614, 2707, 2850, 2928, 2973, 3009, 3203, 3297, 3314, 3352, 3590, 3676, 3691, 3745, 3904, 3921, 3991, 4027, 4166, 4170, 4210]","[934, 2266, 2421, 2707, 2973, 3203]","[65, 244, 287, 296, 317, 437, 499, 586, 693, 700, 779, 789, 948, 993, 1033, 1123, 1127, 1175, 1472, 1537, 2101, 2480, 2504, 2614, 2850, 2928, 3009, 3297, 3314, 3352, 3590, 3676, 3691, 3745, 3904, 3921, 3991, 4027, 4166, 4170, 4210]","[934, 2266, 2421, 2707, 2973, 3203]",4235,47,4188,6,41,4188,0
2.5,HUMPEPYYA,"[7, 20, 25, 95, 338, 398, 647, 727, 734, 766, 790, 796, 854, 904, 965, 1201, 1307, 1388, 1516, 1537, 1658, 1699, 1763, 1824, 1987, 2098, 2196, 2243, 2254]","[1201, 1388]","[7, 20, 25, 95, 338, 398, 647, 727, 734, 766, 790, 796, 854, 904, 965, 1307, 1516, 1537, 1658, 1699, 1763, 1824, 1987, 2098, 2196, 2243, 2254]","[1201, 1388]",2370,29,2341,2,27,2341,0
2.5,HUMPF4V1A,"[4, 11, 46, 199, 381, 509, 607, 755, 785, 826]","[381, 826]","[4, 11, 46, 199, 509, 607, 755, 785]","[381, 826]",1460,10,1450,2,8,1450,0
2.5,HUMPHOSA,"[87, 221, 233, 312, 364, 425, 536, 604, 850, 875, 919, 1164, 1286, 1300, 1494, 1555, 1709, 1713, 1810, 2185, 2279, 2323, 2348, 2469, 2556, 2988, 3209, 3252, 3500, 3729, 4449, 4516, 4789, 4821, 4833]","[233, 850, 1494, 1810, 2323, 2988, 3209, 3729]","[87, 221, 312, 364, 425, 536, 604, 875, 919, 1164, 1286, 1300, 1555, 1709, 1713, 2185, 2279, 2348, 2469, 2556, 3252, 3500, 4449, 4516, 4789, 4821, 4833]","[233, 850, 1494, 1810, 2323, 2988, 3209, 3729]",4884,35,4849,8,27,4849,0
2.5,HUMPRCA,"[55, 96, 116, 130, 488, 498, 684, 756, 1048, 1215, 1292, 1294, 1345, 1481, 1687, 1916, 2114, 2201, 2304, 2309, 2354, 2761, 2937, 3044, 3181, 3217, 3438, 3499, 3631, 3676, 3703, 3856, 3879, 3995, 4175, 4184, 4572, 4584, 4634, 4778, 5114, 5118, 5122, 5213, 5247, 5348, 5452, 5512, 5585, 5624, 5631, 6604, 6648, 6777, 6827, 6933, 6948, 7002, 7100, 7252, 7256, 7418, 7719, 7822, 7878, 7994, 8011, 8015, 8396, 8524, 8580, 8584, 8815, 8853, 9042, 9054, 9206, 9387, 9430, 9456, 9479, 9580, 9620, 9640, 10003, 10055, 10172, 10349, 10376, 10395, 10440, 10444, 10520, 10968, 10977, 10987, 11252, 11305, 11461, 11500, 11602, 11649]","[2201, 3631, 5118, 5348, 5585, 8396, 9387]","[55, 96, 116, 130, 488, 498, 684, 756, 1048, 1215, 1292, 1294, 1345, 1481, 1687, 1916, 2114, 2304, 2309, 2354, 2761, 2937, 3044, 3181, 3217, 3438, 3499, 3676, 3703, 3856, 3879, 3995, 4175, 4184, 4572, 4584, 4634, 4778, 5114, 5122, 5213, 5247, 5452, 5512, 5624, 5631, 6604, 6648, 6777, 6827, 6933, 6948, 7002, 7100, 7252, 7256, 7418, 7719, 7822, 7878, 7994, 8011, 8015, 8524, 8580, 8584, 8815, 8853, 9042, 9054, 9206, 9430, 9456, 9479, 9580, 9620, 9640, 10003, 10055, 10172, 10349, 10376, 10395, 10440, 10444, 10520, 10968, 10977, 10987, 11252, 11305, 11461, 11500, 11602, 11649]","[2201, 3631, 5118, 5348, 5585, 8396, 9387]",11717,102,11615,7,95,11615,0
2.5,HUMPREELAS,"[68, 91, 180, 253, 274, 282, 478, 596, 608, 686, 826, 1054, 1070, 1107, 1357, 1619, 1724, 1729, 1785, 1802, 1806, 1827, 2240]",[596],"[68, 91, 180, 253, 274, 282, 478, 608, 686, 826, 1054, 1070, 1107, 1357, 1619, 1724, 1729, 1785, 1802, 1806, 1827, 2240]",[596],2291,23,2268,1,22,2268,0
2.5,HUMPRPHX,"[71, 163, 292, 317, 568, 627, 778, 963, 1143, 1293, 1299, 1346, 1475, 1551, 1560, 1724, 1777, 1838, 1911, 2127, 2140, 2357, 2480, 2502, 2523, 2532, 2550, 2594, 2652, 2742, 2841, 2869, 2873, 3173, 3322, 3561, 3633, 3719, 3723, 3883, 3886, 3914, 4054, 4221, 4225, 4319]","[1346, 1838, 2127, 2652, 2869, 3173, 3322, 3633]","[71, 163, 292, 317, 568, 627, 778, 963, 1143, 1293, 1299, 1475, 1551, 1560, 1724, 1777, 1911, 2140, 2357, 2480, 2502, 2523, 2532, 2550, 2594, 2742, 2841, 2873, 3561, 3719, 3723, 3883, 3886, 3914, 4054, 4221, 4225, 4319]","[1346, 1838, 2127, 2652, 2869, 3173, 3322, 3633]",4524,46,4478,8,38,4478,0
2.5,HUMRCC1,"[108, 246, 449, 486, 560, 638, 654, 781, 973, 1017, 1099, 1186, 1608, 1708, 1969, 2437, 2711, 2980, 3051, 3055, 3337, 3451, 3455, 3524, 4068, 4217, 4242, 4304, 4379, 4555, 4654, 4681, 4722, 4733, 4737, 4787, 4793, 4872, 4991, 5129, 5210, 5370, 5479, 5489, 5539, 5545, 5558, 5562, 5741, 6061, 6493, 6765, 7136, 7214, 7271, 7529, 7642, 7644, 7920, 8110, 8114, 8572, 8620, 8701, 8862, 8915, 8974, 8986, 9080, 9143, 9297, 9448, 9869, 9960, 10003, 10130, 10178, 10252, 10366, 10460, 10535, 10597, 10711, 10754, 10886, 11003, 11120, 11134, 11329, 11364, 11415, 11594, 12204, 12481, 12573, 12616, 12705, 12731, 13006, 13054, 13360, 13431, 13471, 13510, 13634, 13805, 13819, 14069, 14112, 14114, 14368, 14531, 14604, 14619, 14697, 14702, 14708, 14936, 14977, 15108, 15126, 15158, 15324, 15385, 15440, 15532, 15548, 15580, 15704, 15791, 15894, 16128, 16280, 16316, 16328, 16362, 16379, 16465, 16526, 16574, 16757, 16796, 16836, 16886, 17004, 17016, 17025, 17060, 17164, 17556, 17659, 17950, 18270, 18304, 18348, 18716, 18787, 18795, 19037, 19131, 19296, 19490, 19784, 19855, 19892, 20442, 20525, 20685, 20849, 20918, 21036, 21092, 21127, 21282, 21286, 21296, 21303, 21316, 21493, 21774, 22033, 22051, 22193, 22205, 22297, 22349, 22395, 22531, 22579, 22688, 22748, 22814, 22826, 22868, 22902, 22955, 23423, 23588, 23681, 23725, 23960, 24194, 24201, 24227, 24233, 24622, 24839, 24880, 25071, 25287, 25727, 25729, 25817, 25857, 26089, 26108, 26143, 26194, 26218, 26327, 26501, 26507, 26579, 26669, 26679, 26701, 26742, 26808, 26812, 26950, 26989, 27020, 27447, 27481, 27798, 27923, 27973, 27994, 28000, 28010, 28135, 28154, 28244, 28257, 28523, 28534, 28693, 28756, 28793, 28858, 28893, 29020, 29198, 29247, 29419, 29533, 29641, 29746, 29766, 29965, 30000, 30085, 30108, 30231, 30235, 30284, 30415, 30438, 30443, 30575, 30648, 31313, 31424, 31610, 31617, 31672, 31987, 32000, 32040, 32435, 32512, 33137, 33187, 33278, 33284, 33404, 33439, 33503, 33636, 34138, 34406, 34481, 34597, 34599]","[24201, 26218, 26579, 28010, 28244, 28893, 29247, 29766]","[108, 246, 449, 486, 560, 638, 654, 781, 973, 1017, 1099, 1186, 1608, 1708, 1969, 2437, 2711, 2980, 3051, 3055, 3337, 3451, 3455, 3524, 4068, 4217, 4242, 4304, 4379, 4555, 4654, 4681, 4722, 4733, 4737, 4787, 4793, 4872, 4991, 5129, 5210, 5370, 5479, 5489, 5539, 5545, 5558, 5562, 5741, 6061, 6493, 6765, 7136, 7214, 7271, 7529, 7642, 7644, 7920, 8110, 8114, 8572, 8620, 8701, 8862, 8915, 8974, 8986, 9080, 9143, 9297, 9448, 9869, 9960, 10003, 10130, 10178, 10252, 10366, 10460, 10535, 10597, 10711, 10754, 10886, 11003, 11120, 11134, 11329, 11364, 11415, 11594, 12204, 12481, 12573, 12616, 12705, 12731, 13006, 13054, 13360, 13431, 13471, 13510, 13634, 13805, 13819, 14069, 14112, 14114, 14368, 14531, 14604, 14619, 14697, 14702, 14708, 14936, 14977, 15108, 15126, 15158, 15324, 15385, 15440, 15532, 15548, 15580, 15704, 15791, 15894, 16128, 16280, 16316, 16328, 16362, 16379, 16465, 16526, 16574, 16757, 16796, 16836, 16886, 17004, 17016, 17025, 17060, 17164, 17556, 17659, 17950, 18270, 18304, 18348, 18716, 18787, 18795, 19037, 19131, 19296, 19490, 19784, 19855, 19892, 20442, 20525, 20685, 20849, 20918, 21036, 21092, 21127, 21282, 21286, 21296, 21303, 21316, 21493, 21774, 22033, 22051, 22193, 22205, 22297, 22349, 22395, 22531, 22579, 22688, 22748, 22814, 22826, 22868, 22902, 22955, 23423, 23588, 23681, 23725, 23960, 24194, 24227, 24233, 24622, 24839, 24880, 25071, 25287, 25727, 25729, 25817, 25857, 26089, 26108, 26143, 26194, 26327, 26501, 26507, 26669, 26679, 26701, 26742, 26808, 26812, 26950, 26989, 27020, 27447, 27481, 27798, 27923, 27973, 27994, 28000, 28135, 28154, 28257, 28523, 28534, 28693, 28756, 28793, 28858, 29020, 29198, 29419, 29533, 29641, 29746, 29965, 30000, 30085, 30108, 30231, 30235, 30284, 30415, 30438, 30443, 30575, 30648, 31313, 31424, 31610, 31617, 31672, 31987, 32000, 32040, 32435, 32512, 33137, 33187, 33278, 33284, 33404, 33439, 33503, 33636, 34138, 34406, 34481, 34597, 34599]","[24201, 26218, 26579, 28010, 28244, 28893, 29247, 29766]",34633,294,34339,8,286,34339,0
2.5,HUMREGHOM,"[52, 127, 274, 309, 335, 346, 410, 527, 684, 891, 1107, 1170, 1419, 1423, 1459, 1602, 1864, 1909, 1927, 2002, 2023, 2506, 2739, 2825, 2974, 3329]","[684, 1419, 1864, 2739]","[52, 127, 274, 309, 335, 346, 410, 527, 891, 1107, 1170, 1423, 1459, 1602, 1909, 1927, 2002, 2023, 2506, 2825, 2974, 3329]","[684, 1419, 1864, 2739]",3403,26,3377,4,22,3377,0
2.5,HUMROD1X,"[71, 92, 186, 218, 321, 454, 526, 821, 980, 1063, 1096, 1146, 1170, 1194, 1223, 1242, 1804, 1876, 2015, 2227, 2288, 2343, 2611, 2638, 2695, 2720]","[1242, 1876]","[71, 92, 186, 218, 321, 454, 526, 821, 980, 1063, 1096, 1146, 1170, 1194, 1223, 1804, 2015, 2227, 2288, 2343, 2611, 2638, 2695, 2720]","[1242, 1876]",2833,26,2807,2,24,2807,0
2.5,HUMRPIB2,"[310, 356, 435, 472, 510, 588, 622, 899, 974, 1121, 1156, 1182, 1193, 1257, 1374, 1531, 1737, 1954, 2017, 2268, 2272, 2308, 2451, 2713, 2758, 2776, 2851, 2872, 3355, 3588, 3674, 3823, 4178]","[1531, 2268, 2713, 3588]","[310, 356, 435, 472, 510, 588, 622, 899, 974, 1121, 1156, 1182, 1193, 1257, 1374, 1737, 1954, 2017, 2272, 2308, 2451, 2758, 2776, 2851, 2872, 3355, 3674, 3823, 4178]","[1531, 2268, 2713, 3588]",4329,33,4296,4,29,4296,0
2.5,HUMRPS6B,"[359, 363, 399, 478, 634, 671, 784, 1012, 1045, 1059, 1083, 1101, 1114, 1168, 1205, 1232, 1414, 1543, 1649, 1721, 1838, 2146, 2153, 2178, 2607, 2651, 2753, 2799, 2866, 2896, 2933, 2943, 3072, 3084, 3535, 3645, 3893, 4051, 4432, 4655, 4838, 4905]","[359, 1059, 1838, 2178, 4051]","[363, 399, 478, 634, 671, 784, 1012, 1045, 1083, 1101, 1114, 1168, 1205, 1232, 1414, 1543, 1649, 1721, 2146, 2153, 2607, 2651, 2753, 2799, 2866, 2896, 2933, 2943, 3072, 3084, 3535, 3645, 3893, 4432, 4655, 4838, 4905]","[359, 1059, 1838, 2178, 4051]",4964,42,4922,5,37,4922,0
2.5,HUMSEMI,"[121, 262, 306, 578, 614, 681, 793, 806, 975, 984, 1037, 1061, 1458, 1511, 1583, 1636, 1655, 1835, 1871, 2015, 2051, 2159, 2362, 2394, 2519, 2547, 2682, 2979, 3047, 3074, 3145, 3167, 3496, 3670, 3760, 3849, 3886, 3950, 4061]",[793],"[121, 262, 306, 578, 614, 681, 806, 975, 984, 1037, 1061, 1458, 1511, 1583, 1636, 1655, 1835, 1871, 2015, 2051, 2159, 2362, 2394, 2519, 2547, 2682, 2979, 3047, 3074, 3145, 3167, 3496, 3670, 3760, 3849, 3886, 3950, 4061]",[793],4156,39,4117,1,38,4117,0
2.5,HUMSEMIIB,"[121, 493, 528, 569, 697, 765, 1127, 1274, 1281, 1298, 1302, 1316, 1329, 1389, 1490, 1524, 1530, 1642, 1790, 1828, 1889, 1988, 2155, 2410, 2444, 2489, 2515, 2616, 2746, 2901, 2918, 2979, 3011, 3135, 3352, 3457, 3491, 3511, 3769, 3799, 3843, 4047, 4271, 4486, 4499, 4622, 4660, 4667, 4729, 5203, 5215, 5275, 5328, 5527, 5640, 5707, 5820, 5846, 5887, 6000, 6067, 6304, 6446, 6477, 6514, 6565, 7012, 7038, 7146, 7527, 7944, 8011, 8014]",[4486],"[121, 493, 528, 569, 697, 765, 1127, 1274, 1281, 1298, 1302, 1316, 1329, 1389, 1490, 1524, 1530, 1642, 1790, 1828, 1889, 1988, 2155, 2410, 2444, 2489, 2515, 2616, 2746, 2901, 2918, 2979, 3011, 3135, 3352, 3457, 3491, 3511, 3769, 3799, 3843, 4047, 4271, 4499, 4622, 4660, 4667, 4729, 5203, 5215, 5275, 5328, 5527, 5640, 5707, 5820, 5846, 5887, 6000, 6067, 6304, 6446, 6477, 6514, 6565, 7012, 7038, 7146, 7527, 7944, 8011, 8014]",[4486],8216,73,8143,1,72,8143,0
2.5,HUMSTATH2,"[49, 353, 651, 911, 1035, 1140, 1197, 1553, 1675, 1820, 2025, 2056, 2131, 2151, 2303, 2312, 2322, 2403, 2530, 2627, 2727, 2733, 2848, 3239, 3361, 3474, 4320, 4472, 4592, 4629]","[353, 1553, 1675]","[49, 651, 911, 1035, 1140, 1197, 1820, 2025, 2056, 2131, 2151, 2303, 2312, 2322, 2403, 2530, 2627, 2727, 2733, 2848, 3239, 3361, 3474, 4320, 4472, 4592, 4629]","[353, 1553, 1675]",4715,30,4685,3,27,4685,0
2.5,HUMTBGA,"[89, 362, 377, 451, 460, 654, 812, 854, 1021, 1050, 1156, 1265, 1430, 1435, 1469, 1593, 1646, 1651, 2099, 2323, 2660, 2681, 2792, 2894, 2911, 2932, 3107, 3244, 3355, 3566, 3634, 3744, 4216, 4529, 4634, 4941, 5032, 5164, 5168, 5177, 5231, 5236, 5271, 5469, 5475, 5530, 5782, 5875, 5879, 5941, 6265, 6296, 6314, 6606, 6627, 6841, 6960, 7144, 7172, 7254, 7395, 7417, 7419, 7441, 7909, 7960, 8219, 8362]","[4941, 6265, 7144]","[89, 362, 377, 451, 460, 654, 812, 854, 1021, 1050, 1156, 1265, 1430, 1435, 1469, 1593, 1646, 1651, 2099, 2323, 2660, 2681, 2792, 2894, 2911, 2932, 3107, 3244, 3355, 3566, 3634, 3744, 4216, 4529, 4634, 5032, 5164, 5168, 5177, 5231, 5236, 5271, 5469, 5475, 5530, 5782, 5875, 5879, 5941, 6296, 6314, 6606, 6627, 6841, 6960, 7172, 7254, 7395, 7417, 7419, 7441, 7909, 7960, 8219, 8362]","[4941, 6265, 7144]",8761,68,8693,3,65,8693,0
2.5,HUMTCRBRA,"[63, 128, 132, 199, 278, 318, 405, 469, 505, 561]",[278],"[63, 128, 132, 199, 318, 405, 469, 505, 561]",[278],728,10,718,1,9,718,0
2.5,HUMTHROMA,"[159, 187, 323, 330, 583, 643, 687, 743, 787, 800, 818, 1277, 1428, 1464, 1571, 1605, 1696, 1731, 1985, 2131, 2344, 2377, 2384, 2717, 3117, 3147, 3355, 3367, 3402, 3960, 4129, 4222, 4266, 4362, 4394, 4430, 4522, 4554, 4772, 4817, 4965, 5134, 5715, 5836, 6086]","[1985, 2344, 2717, 4817]","[159, 187, 323, 330, 583, 643, 687, 743, 787, 800, 818, 1277, 1428, 1464, 1571, 1605, 1696, 1731, 2131, 2377, 2384, 3117, 3147, 3355, 3367, 3402, 3960, 4129, 4222, 4266, 4362, 4394, 4430, 4522, 4554, 4772, 4965, 5134, 5715, 5836, 6086]","[1985, 2344, 2717, 4817]",6155,45,6110,4,41,6110,0
2.5,HUMTNP2SS,"[51, 80, 86, 93, 177, 658, 673, 725, 814, 924, 941, 945, 1105, 1420, 1617, 1748]",[658],"[51, 80, 86, 93, 177, 673, 725, 814, 924, 941, 945, 1105, 1420, 1617, 1748]",[658],1774,16,1758,1,15,1758,0
2.5,HUMTPALBU,"[313, 323, 627, 722, 872, 915, 942, 1094, 1228, 1326, 1359, 1402, 1407, 1490, 1559, 1621, 1708, 1778, 1850, 1887, 2455, 2682, 2692, 2741, 2932, 2941, 3116, 3168, 3352, 3377, 3412, 3421, 3425, 3620, 3781, 3856, 3989, 4153, 4361, 4400, 4587, 4691, 4707, 4720, 5066, 5992, 5999, 6035, 6086, 6127]","[1094, 1621, 2741, 3425, 4361]","[313, 323, 627, 722, 872, 915, 942, 1228, 1326, 1359, 1402, 1407, 1490, 1559, 1708, 1778, 1850, 1887, 2455, 2682, 2692, 2932, 2941, 3116, 3168, 3352, 3377, 3412, 3421, 3620, 3781, 3856, 3989, 4153, 4400, 4587, 4691, 4707, 4720, 5066, 5992, 5999, 6035, 6086, 6127]","[1094, 1621, 2741, 3425, 4361]",6164,50,6114,5,45,6114,0
2.5,HUMTRHYAL,"[25, 69, 192, 197, 201, 301, 562, 827, 1120, 1185, 1557, 1645, 1793, 2232, 2236, 2340, 2533, 2679, 2837, 4249, 4658, 5091, 6019, 6062, 6083, 6556, 7003, 7415, 7688, 7814, 8134, 8437, 8441, 8581, 8774]",[1645],"[25, 69, 192, 197, 201, 301, 562, 827, 1120, 1185, 1557, 1793, 2232, 2236, 2340, 2533, 2679, 2837, 4249, 4658, 5091, 6019, 6062, 6083, 6556, 7003, 7415, 7688, 7814, 8134, 8437, 8441, 8581, 8774]",[1645],9543,35,9508,1,34,9508,0
2.5,HUMTSHB2,"[68, 187, 780, 872]",[187],"[68, 780, 872]",[187],978,4,974,1,3,974,0
2.5,HUMV2R,"[261, 287, 296, 357, 475, 531, 939, 957, 965, 1074, 1150, 1255, 1272, 1366, 1404, 1481, 1507, 1815, 2003, 2047, 2118, 2128]","[261, 1507]","[287, 296, 357, 475, 531, 939, 957, 965, 1074, 1150, 1255, 1272, 1366, 1404, 1481, 1815, 2003, 2047, 2118, 2128]","[261, 1507]",2274,22,2252,2,20,2252,0
2.5,HYPSCGH,"[41, 337, 451, 612, 788, 806, 837, 889, 1039, 1252, 1440, 1624]","[41, 451, 1039, 1624]","[337, 612, 788, 806, 837, 889, 1252, 1440]","[41, 451, 1039, 1624]",2476,12,2464,4,8,2464,0
2.5,LAYEGLOBIN,"[222, 238, 272, 470, 537, 584, 600, 953, 1055, 1061, 1167, 1185, 1191, 1197, 1215, 1265, 1312, 1373, 1410, 1415, 1421, 1466, 1522]","[238, 584]","[222, 272, 470, 537, 600, 953, 1055, 1061, 1167, 1185, 1191, 1197, 1215, 1265, 1312, 1373, 1410, 1415, 1421, 1466, 1522]","[238, 584]",1694,23,1671,2,21,1671,0
2.5,LEBGLOB,"[67, 94, 104, 142, 157, 401, 658, 662, 672, 1229, 1373, 1501, 1539, 1561, 1577, 1663, 1791, 1812, 1828, 1926, 2206, 2307, 2555, 2576, 2586, 2806, 2847, 2928, 3171, 3177, 3202, 3208, 3429, 3530, 3565]","[1577, 1926]","[67, 94, 104, 142, 157, 401, 658, 662, 672, 1229, 1373, 1501, 1539, 1561, 1663, 1791, 1812, 1828, 2206, 2307, 2555, 2576, 2586, 2806, 2847, 2928, 3171, 3177, 3202, 3208, 3429, 3530, 3565]","[1577, 1926]",3638,35,3603,2,33,3603,0
2.5,LNOEGLOBIN,"[220, 236, 270, 345, 473, 540, 587, 603, 724, 1056, 1062, 1167, 1185, 1191, 1197, 1215, 1265, 1293, 1312, 1406, 1411, 1417, 1462, 1518]","[236, 587]","[220, 270, 345, 473, 540, 603, 724, 1056, 1062, 1167, 1185, 1191, 1197, 1215, 1265, 1293, 1312, 1406, 1411, 1417, 1462, 1518]","[236, 587]",1690,24,1666,2,22,1666,0
2.5,MACHBGA1,"[20, 32, 283, 457, 495, 505, 727, 794, 841, 937, 1008, 1118, 1188, 1252, 1358, 1370, 1420, 1460, 1643, 1740, 2029]","[495, 841]","[20, 32, 283, 457, 505, 727, 794, 937, 1008, 1118, 1188, 1252, 1358, 1370, 1420, 1460, 1643, 1740, 2029]","[495, 841]",2097,21,2076,2,19,2076,0
2.5,MACHBGA2,"[20, 32, 281, 455, 493, 503, 725, 792, 839, 935, 1006, 1115, 1185, 1249, 1355, 1367, 1417, 1441, 1449, 1461, 1644, 1741, 2017, 2089]","[493, 839]","[20, 32, 281, 455, 503, 725, 792, 935, 1006, 1115, 1185, 1249, 1355, 1367, 1417, 1441, 1449, 1461, 1644, 1741, 2017, 2089]","[493, 839]",2100,24,2076,2,22,2076,0
2.5,MAMGLUTRA,"[34, 424, 484, 488, 657, 663, 702, 821, 1073, 1082, 1255, 1275, 1474, 1627, 1718, 1819, 1944, 1960, 2152, 2360, 2406, 2558, 2598, 2745, 2759, 2938, 3059, 3175, 3915, 4252, 4272, 4396, 4482, 4642, 4844, 4967, 4974, 5131, 5135, 5187, 5213, 5243, 5320, 5598, 5870, 6065]","[484, 821, 1255, 1627, 1819, 2745, 2938]","[34, 424, 488, 657, 663, 702, 1073, 1082, 1275, 1474, 1718, 1944, 1960, 2152, 2360, 2406, 2558, 2598, 2759, 3059, 3175, 3915, 4252, 4272, 4396, 4482, 4642, 4844, 4967, 4974, 5131, 5135, 5187, 5213, 5243, 5320, 5598, 5870, 6065]","[484, 821, 1255, 1627, 1819, 2745, 2938]",6287,46,6241,7,39,6241,0
2.5,MAU09941,"[11, 229, 239, 401, 548, 613, 629, 705, 749, 778, 876, 1031, 1166, 1202, 1480, 1566, 1803, 1830, 1846, 1941, 2264, 2320, 2406, 2427, 2514, 2609, 2667, 2761, 2932, 2968, 3124, 3134, 3239, 3263, 3378, 3521, 3642, 3646, 3697]",[1830],"[11, 229, 239, 401, 548, 613, 629, 705, 749, 778, 876, 1031, 1166, 1202, 1480, 1566, 1803, 1846, 1941, 2264, 2320, 2406, 2427, 2514, 2609, 2667, 2761, 2932, 2968, 3124, 3134, 3239, 3263, 3378, 3521, 3642, 3646, 3697]",[1830],3798,39,3759,1,38,3759,0
2.5,MFAPOA2A,"[53, 57, 69, 133, 153, 155, 226, 379, 462, 571, 575, 587, 720, 785, 875, 1422, 1445]","[379, 785]","[53, 57, 69, 133, 153, 155, 226, 462, 571, 575, 587, 720, 875, 1422, 1445]","[379, 785]",1489,17,1472,2,15,1472,0
2.5,MFAPOC3A,"[115, 232, 363, 441, 622, 642, 870, 913, 924, 1155, 1172, 1239, 1264, 1402, 1530, 1715, 1798, 1993, 2040, 2190, 2232, 2384, 2439, 2689, 2878, 3068, 3213, 3240, 3244]","[913, 1172]","[115, 232, 363, 441, 622, 642, 870, 924, 1155, 1239, 1264, 1402, 1530, 1715, 1798, 1993, 2040, 2190, 2232, 2384, 2439, 2689, 2878, 3068, 3213, 3240, 3244]","[913, 1172]",3254,29,3225,2,27,3225,0
2.5,MMA2IXCOA,"[386, 416, 584, 599, 619, 682, 798, 859, 878, 908, 1175, 1267, 1297, 1383, 1389, 1439, 1722, 1757, 1800, 1812, 1866, 1881, 1925, 1998, 2183, 2340, 2552, 2870, 2935, 3105, 3132, 3259, 3286, 3408, 3639, 3652, 3760, 3826, 4386, 4455, 4499, 4697, 4857, 5647, 5665, 5682, 5831, 5886, 6014, 6054, 6266, 6355, 6359, 6481, 6614, 6623, 6628, 6635, 6639, 6674, 6930, 6954, 7102, 7161, 7250, 7371, 7390, 7472, 7581, 7658, 7684, 8064, 8135, 8216, 8255, 8401, 8539, 8843, 8882, 9179, 9209, 9322, 9437, 9467, 9573, 9609, 9626, 9702, 9793, 9812, 9819, 10270, 10282, 10304, 10930, 11067, 11077, 11145, 11374, 11426, 11555, 11587, 11611, 11890, 12074, 12150, 12182, 12210, 12406, 12792, 12926, 12952, 12989, 13033, 13111, 13361, 13447, 13453, 13609, 13687, 13726, 13786, 13824, 13840, 13912, 14540, 14575, 14635, 14663, 14968, 15021, 15210, 15231, 15338, 15441, 15544, 15597, 15746, 15799, 15933, 16070, 16114, 16123, 16240, 16424, 16474, 16522, 16705, 16811, 16911, 17100, 17106, 17145, 17244, 17275, 17333, 17647, 18032, 18243, 18283, 18729, 18743, 18862, 19220, 19296, 19302, 19335, 19408, 19461]","[3132, 4386, 5682, 5831, 7102, 7250, 7371, 7684, 8064, 8216, 8401, 8539, 8882, 9322, 9467, 9626, 13033, 13447, 13726, 14575, 15021, 15338, 15597, 15746, 15933, 16114, 16240, 16522, 16811, 17275, 17647]","[386, 416, 584, 599, 619, 682, 798, 859, 878, 908, 1175, 1267, 1297, 1383, 1389, 1439, 1722, 1757, 1800, 1812, 1866, 1881, 1925, 1998, 2183, 2340, 2552, 2870, 2935, 3105, 3259, 3286, 3408, 3639, 3652, 3760, 3826, 4455, 4499, 4697, 4857, 5647, 5665, 5886, 6014, 6054, 6266, 6355, 6359, 6481, 6614, 6623, 6628, 6635, 6639, 6674, 6930, 6954, 7161, 7390, 7472, 7581, 7658, 8135, 8255, 8843, 9179, 9209, 9437, 9573, 9609, 9702, 9793, 9812, 9819, 10270, 10282, 10304, 10930, 11067, 11077, 11145, 11374, 11426, 11555, 11587, 11611, 11890, 12074, 12150, 12182, 12210, 12406, 12792, 12926, 12952, 12989, 13111, 13361, 13453, 13609, 13687, 13786, 13824, 13840, 13912, 14540, 14635, 14663, 14968, 15210, 15231, 15441, 15544, 15799, 16070, 16123, 16424, 16474, 16705, 16911, 17100, 17106, 17145, 17244, 17333, 18032, 18243, 18283, 18729, 18743, 18862, 19220, 19296, 19302, 19335, 19408, 19461]","[3132, 4386, 5682, 5831, 7102, 7250, 7371, 7684, 8064, 8216, 8401, 8539, 8882, 9322, 9467, 9626, 13033, 13447, 13726, 14575, 15021, 15338, 15597, 15746, 15933, 16114, 16240, 16522, 16811, 17275, 17647]",19471,169,19302,31,138,19302,0
2.5,MMACLGNA,"[146, 412, 474, 499, 537, 541, 553, 746, 879, 889, 918, 1180, 1192, 1458, 1499, 1731, 1762, 1937, 2363, 2397, 2524, 2537, 2580, 2666, 2734, 2824, 2923, 2933, 2952, 2957, 3107, 3143, 3178, 3442, 3647]","[474, 3178]","[146, 412, 499, 537, 541, 553, 746, 879, 889, 918, 1180, 1192, 1458, 1499, 1731, 1762, 1937, 2363, 2397, 2524, 2537, 2580, 2666, 2734, 2824, 2923, 2933, 2952, 2957, 3107, 3143, 3442, 3647]","[474, 3178]",3873,35,3838,2,33,3838,0
2.5,MMAPOG,"[143, 265, 536, 669, 708, 728, 806, 823, 839, 860, 876, 987, 1037, 1053, 1172, 1186, 1249, 1456, 1501, 1567, 1935, 1940, 2056, 2067, 2146]","[536, 806]","[143, 265, 669, 708, 728, 823, 839, 860, 876, 987, 1037, 1053, 1172, 1186, 1249, 1456, 1501, 1567, 1935, 1940, 2056, 2067, 2146]","[536, 806]",2168,25,2143,2,23,2143,0
2.5,MMASM1G,"[439, 680, 688, 1088, 1092, 1096, 1141, 1173, 1294, 1364, 1492, 1591, 1742, 1896, 2065, 2244, 2332, 2668, 2830, 2928, 2961, 3168, 3245, 3367, 3599, 3619, 3745, 3749, 4681]","[1088, 2244, 2928, 3245, 3745]","[439, 680, 688, 1092, 1096, 1141, 1173, 1294, 1364, 1492, 1591, 1742, 1896, 2065, 2332, 2668, 2830, 2961, 3168, 3367, 3599, 3619, 3749, 4681]","[1088, 2244, 2928, 3245, 3745]",4767,29,4738,5,24,4738,0
2.5,MMCASEIB,"[15, 439, 508, 599, 998, 1059, 1113, 1412, 1488, 1589, 1889, 2857, 2974, 3042, 3141, 3145, 3158, 3285, 3289, 3368, 3445, 3643, 3742, 3746, 3769, 4901, 4916, 5477, 5519, 5615, 5877, 6001, 6060, 6252, 6305, 6394, 6603, 6611, 6905, 6932, 7023, 7119, 7155, 7160, 7929, 7964, 8126, 8222, 8252, 8291, 8413, 8664, 8851, 9203, 9803, 9851, 10030, 10160, 10443, 10796, 10861, 11050, 11133, 11712, 11758, 11765, 11838, 12014, 12187, 12235, 12376, 12573, 12928, 12951, 13000]","[6252, 7023, 7160, 8126, 8252, 9803]","[15, 439, 508, 599, 998, 1059, 1113, 1412, 1488, 1589, 1889, 2857, 2974, 3042, 3141, 3145, 3158, 3285, 3289, 3368, 3445, 3643, 3742, 3746, 3769, 4901, 4916, 5477, 5519, 5615, 5877, 6001, 6060, 6305, 6394, 6603, 6611, 6905, 6932, 7119, 7155, 7929, 7964, 8222, 8291, 8413, 8664, 8851, 9203, 9851, 10030, 10160, 10443, 10796, 10861, 11050, 11133, 11712, 11758, 11765, 11838, 12014, 12187, 12235, 12376, 12573, 12928, 12951, 13000]","[6252, 7023, 7160, 8126, 8252, 9803]",13046,75,12971,6,69,12971,0
2.5,MMCD24A,"[198, 233, 274, 287, 477, 1126, 1273, 1286, 1450, 1522, 1660, 1670, 1804, 1969, 2172, 2195, 2214, 2220, 2259, 2300, 2486, 2555, 2594, 2860, 3016, 3068, 3158, 3308, 3412, 3693, 3794, 3805, 3828, 3911, 3949, 4043, 4140, 4224, 4586, 4910, 5379, 5478, 5793, 5826, 6085, 6236, 6260, 6430, 6441, 6784, 7063, 7471, 7475, 7515, 7528]",[2486],"[198, 233, 274, 287, 477, 1126, 1273, 1286, 1450, 1522, 1660, 1670, 1804, 1969, 2172, 2195, 2214, 2220, 2259, 2300, 2555, 2594, 2860, 3016, 3068, 3158, 3308, 3412, 3693, 3794, 3805, 3828, 3911, 3949, 4043, 4140, 4224, 4586, 4910, 5379, 5478, 5793, 5826, 6085, 6236, 6260, 6430, 6441, 6784, 7063, 7471, 7475, 7515, 7528]",[2486],7632,55,7577,1,54,7577,0
2.5,MMCFOS,"[99, 376, 385, 491, 844, 965, 1025, 1244, 1248, 1459, 1646, 1790, 1850, 2137, 2162, 2168, 2208, 2363, 2655, 3118, 3414, 3429, 3656]","[844, 1850, 2363]","[99, 376, 385, 491, 965, 1025, 1244, 1248, 1459, 1646, 1790, 2137, 2162, 2168, 2208, 2655, 3118, 3414, 3429, 3656]","[844, 1850, 2363]",3959,23,3936,3,20,3936,0
2.5,MMCOL10A,"[30, 216, 560, 714, 1070, 1193, 1393, 1446, 1518, 1719, 1802, 1964, 2209, 2390, 2540, 2829, 2887, 2931, 2937, 3292, 3514, 3553, 3918, 3985, 4222, 4246, 4672, 4689, 4704, 4716, 4779, 4974, 5017, 5092, 5105, 5182, 5203, 5224, 5555, 5660, 5729, 5765, 5846, 5879, 5888, 5975, 6020, 6146, 6228, 6263, 6290, 6340, 6371, 6389, 6407, 6434, 6461, 6479, 6704, 6754, 6821, 6833, 6895, 6933, 7009, 7059, 7101, 7192, 7203, 7278, 7282, 7286, 7335, 7656, 7676, 7726, 8029, 8246, 8369, 8394, 8837, 9050, 9066, 9284, 9322]",[1802],"[30, 216, 560, 714, 1070, 1193, 1393, 1446, 1518, 1719, 1964, 2209, 2390, 2540, 2829, 2887, 2931, 2937, 3292, 3514, 3553, 3918, 3985, 4222, 4246, 4672, 4689, 4704, 4716, 4779, 4974, 5017, 5092, 5105, 5182, 5203, 5224, 5555, 5660, 5729, 5765, 5846, 5879, 5888, 5975, 6020, 6146, 6228, 6263, 6290, 6340, 6371, 6389, 6407, 6434, 6461, 6479, 6704, 6754, 6821, 6833, 6895, 6933, 7009, 7059, 7101, 7192, 7203, 7278, 7282, 7286, 7335, 7656, 7676, 7726, 8029, 8246, 8369, 8394, 8837, 9050, 9066, 9284, 9322]",[1802],9323,85,9238,1,84,9238,0
2.5,MMCRPG,"[32, 375, 523, 809, 824, 929, 1003, 1011, 1037, 1110, 1167, 1289, 1988]",[375],"[32, 523, 809, 824, 929, 1003, 1011, 1037, 1110, 1167, 1289, 1988]",[375],2132,13,2119,1,12,2119,0
2.5,MMCYTOKNA,"[122, 810, 926, 1042, 1089, 1123, 1339, 1393, 1580, 1871, 1881, 1983, 2252, 2432, 2542, 2549, 2553]",[810],"[122, 926, 1042, 1089, 1123, 1339, 1393, 1580, 1871, 1881, 1983, 2252, 2432, 2542, 2549, 2553]","[810, 1559]",2551,17,2534,1,16,2533,1
2.5,MMDM2RR,"[104, 461, 665, 680, 713, 854, 878, 999, 1010, 1162, 1305, 1439, 1473, 1534, 1651, 1846, 1974, 2004, 2156, 2171, 2236, 2247, 2407, 2513, 2702, 2727, 2805, 3017, 3262, 3378, 3509, 3526, 3701, 3750, 3962, 4028, 4033, 4134, 4288, 4625, 4663, 4793, 4862, 4925, 4937, 5044, 5134, 5321, 5505, 5583, 5928, 6015, 6030, 6048, 6108, 6307, 6320, 6476, 6502, 6591]","[665, 854, 1305, 1651, 2702, 3701, 3962, 4925, 5134]","[104, 461, 680, 713, 878, 999, 1010, 1162, 1439, 1473, 1534, 1846, 1974, 2004, 2156, 2171, 2236, 2247, 2407, 2513, 2727, 2805, 3017, 3262, 3378, 3509, 3526, 3750, 4028, 4033, 4134, 4288, 4625, 4663, 4793, 4862, 4937, 5044, 5321, 5505, 5583, 5928, 6015, 6030, 6048, 6108, 6307, 6320, 6476, 6502, 6591]","[665, 854, 1305, 1651, 2702, 3701, 3962, 4925, 5134]",6632,60,6572,9,51,6572,0
2.5,MMDNAASFA,"[188, 297, 345, 542, 855, 859, 914, 918, 1042, 1241, 1406, 1497, 1576, 1746, 1823, 1876, 1923, 1940, 2084, 2135, 2194, 2357, 2406, 2491, 2514, 2695, 2996, 3221, 3239, 3295, 3306, 3455, 3464, 3517, 3546, 3558, 3641, 3703, 4082, 4175, 4306]","[855, 1241, 1576, 1823, 2135, 2357, 2695]","[188, 297, 345, 542, 859, 914, 918, 1042, 1406, 1497, 1746, 1876, 1923, 1940, 2084, 2194, 2406, 2491, 2514, 2996, 3221, 3239, 3295, 3306, 3455, 3464, 3517, 3546, 3558, 3641, 3703, 4082, 4175, 4306]","[855, 1241, 1576, 1823, 2135, 2357, 2695]",4307,41,4266,7,34,4266,0
2.5,MMEZGL,"[17, 54, 106, 161, 589, 613, 621, 637, 701, 706, 715, 802, 852, 910, 1167, 1276, 1497, 1599, 1625, 1658]","[589, 1599]","[17, 54, 106, 161, 613, 621, 637, 701, 706, 715, 802, 852, 910, 1167, 1276, 1497, 1625, 1658]","[589, 1599]",1945,20,1925,2,18,1925,0
2.5,MMG37,"[87, 213, 265, 304, 332, 336, 348, 381, 414, 489, 534, 788, 999, 1049, 1062, 1091, 1303, 1358, 1441, 1700, 1706, 1901, 2119, 2275, 2363, 2476, 2570, 2771, 2784, 2788, 3059]","[332, 788, 1303, 2119, 2363, 2570]","[87, 213, 265, 304, 336, 348, 381, 414, 489, 534, 999, 1049, 1062, 1091, 1358, 1441, 1700, 1706, 1901, 2275, 2476, 2771, 2784, 2788, 3059]","[332, 788, 1303, 2119, 2363, 2570]",3065,31,3034,6,25,3034,0
2.5,MMGBCRYA,"[161, 165, 169, 188, 332, 671, 1003, 1094, 1165, 1412, 1416, 1702, 1718, 1754, 1966, 2020, 2175, 2261, 2662]","[671, 1003]","[161, 165, 169, 188, 332, 1094, 1165, 1412, 1416, 1702, 1718, 1754, 1966, 2020, 2175, 2261, 2662]","[671, 1003]",2653,19,2634,2,17,2634,0
2.5,MMGCCRYA,"[417, 701, 721, 1056, 1126, 1352, 1430, 1473, 1478, 1687, 1716, 1790, 1803, 1807, 2181, 2488, 2570, 2650, 2655]","[721, 1056]","[417, 701, 1126, 1352, 1430, 1473, 1478, 1687, 1716, 1790, 1803, 1807, 2181, 2488, 2570, 2650, 2655]","[721, 1056]",2884,19,2865,2,17,2865,0
2.5,MMGFAPD,"[88, 108, 346, 666, 713, 741, 976, 990, 1035, 1175, 1246, 1298, 1309, 1340, 1500, 1624, 1646, 1710, 1901, 2179, 2277, 2284, 2449, 2760, 2982, 2995, 3128, 3351, 3389, 3473, 3660, 3711, 3906, 4335, 4730, 4868, 4874, 4931, 4947, 5217, 5245, 5452, 5702, 6297, 6333, 6370, 6406, 6510, 6547, 6584, 6620, 6656, 6692, 6728, 6765, 6837, 6873, 6909, 7117, 7192, 7198, 7253, 7577, 7605, 7620, 7759, 7877, 7902, 7907, 8027, 8031, 8155, 8227, 8292, 8347, 8409, 8587, 8598, 8630, 9093, 9266, 9301, 9323, 9474, 9788]","[713, 1624, 1901, 2995, 3906, 4335, 5452, 7907]","[88, 108, 346, 666, 741, 976, 990, 1035, 1175, 1246, 1298, 1309, 1340, 1500, 1646, 1710, 2179, 2277, 2284, 2449, 2760, 2982, 3128, 3351, 3389, 3473, 3660, 3711, 4730, 4868, 4874, 4931, 4947, 5217, 5245, 5702, 6297, 6333, 6370, 6406, 6510, 6547, 6584, 6620, 6656, 6692, 6728, 6765, 6837, 6873, 6909, 7117, 7192, 7198, 7253, 7577, 7605, 7620, 7759, 7877, 7902, 8027, 8031, 8155, 8227, 8292, 8347, 8409, 8587, 8598, 8630, 9093, 9266, 9301, 9323, 9474, 9788]","[713, 1624, 1901, 2995, 3906, 4335, 5452, 7907]",9963,85,9878,8,77,9878,0
2.5,MMGGLINE,"[157, 204, 279, 441, 1389, 1465, 1487, 1787, 1815, 1827, 2076, 2250, 2288, 2298, 2520, 2587, 2634, 2730, 2801, 2910, 2980, 3044, 3150, 3162, 3212, 3236, 3244, 3256, 3439, 3536, 3811, 3883, 3948, 3977, 4209, 4400, 4417, 4429, 4519, 4790, 4813, 4824, 4883, 4949, 5098, 5418, 5624, 5706, 6352, 6374, 6664, 6694, 6706, 6955, 7129, 7167, 7177, 7399, 7466, 7513, 7609, 7680, 7789, 7859, 7923, 8029, 8041, 8091, 8131, 8314, 8411, 8700, 8829, 8852, 9016, 9096, 9162, 9179, 9193, 9263, 9360, 9567, 9578, 9641, 9714, 9849, 10308, 10386, 10407, 10420, 10781, 10978, 10982, 11009, 11052]","[7167, 7513]","[157, 204, 279, 441, 1389, 1465, 1487, 1787, 1815, 1827, 2076, 2250, 2288, 2298, 2520, 2587, 2634, 2730, 2801, 2910, 2980, 3044, 3150, 3162, 3212, 3236, 3244, 3256, 3439, 3536, 3811, 3883, 3948, 3977, 4209, 4400, 4417, 4429, 4519, 4790, 4813, 4824, 4883, 4949, 5098, 5418, 5624, 5706, 6352, 6374, 6664, 6694, 6706, 6955, 7129, 7177, 7399, 7466, 7609, 7680, 7789, 7859, 7923, 8029, 8041, 8091, 8131, 8314, 8411, 8700, 8829, 8852, 9016, 9096, 9162, 9179, 9193, 9263, 9360, 9567, 9578, 9641, 9714, 9849, 10308, 10386, 10407, 10420, 10781, 10978, 10982, 11009, 11052]","[7167, 7513]",11278,95,11183,2,93,11183,0
2.5,MMGK5,"[30, 244, 420, 446, 695, 1208, 1283, 1439, 1690, 1805, 1809, 1872, 1890, 2311, 2318, 2626, 2768, 2825, 2845, 2850, 2970, 2986, 3083, 3197, 3239, 3269, 3287, 3432, 3465, 3507, 3525]","[695, 1805, 2825]","[30, 244, 420, 446, 1208, 1283, 1439, 1690, 1809, 1872, 1890, 2311, 2318, 2626, 2768, 2845, 2850, 2970, 2986, 3083, 3197, 3239, 3269, 3287, 3432, 3465, 3507, 3525]","[695, 1805, 2595, 2825]",3602,31,3571,3,28,3570,1
2.5,MMH2D4Q5,"[159, 345, 390, 644, 839, 899, 1055]","[159, 644]","[345, 390, 839, 899, 1055]","[159, 644]",1100,7,1093,2,5,1093,0
2.5,MMHOX13,"[82, 325, 369, 492, 800, 1037, 1105, 1135, 1147, 1393, 1440, 1455, 1570, 1574, 1647, 1651, 1716, 1976, 2076, 2407, 2504, 2583, 2658, 2798]",[800],"[82, 325, 369, 492, 1037, 1105, 1135, 1147, 1393, 1440, 1455, 1570, 1574, 1647, 1651, 1716, 1976, 2076, 2407, 2504, 2583, 2658, 2798]",[800],2827,24,2803,1,23,2803,0
2.5,MMHOX24I,"[24, 50, 72, 91, 98, 281, 631, 705, 730, 837, 868, 896, 914, 1160, 1264, 1719, 1903, 1913]",[837],"[24, 50, 72, 91, 98, 281, 631, 705, 730, 868, 896, 914, 1160, 1264, 1719, 1903, 1913]",[837],1915,18,1897,1,17,1897,0
2.5,MMIL1BG,"[121, 572, 845, 1099, 1294, 1356, 1360, 1364, 1567, 1803, 1938, 2183, 2470, 2803, 3028, 3095, 3222, 3239, 3249, 3323, 3333, 3423, 3680, 4271, 4398, 4651, 4691, 4844, 4866, 4988, 5080, 5679, 5954, 6134, 6172, 6443, 6509, 6610, 6670]","[1356, 1938, 3680, 4398, 5679]","[121, 572, 845, 1099, 1294, 1360, 1364, 1567, 1803, 2183, 2470, 2803, 3028, 3095, 3222, 3239, 3249, 3323, 3333, 3423, 4271, 4651, 4691, 4844, 4866, 4988, 5080, 5954, 6134, 6172, 6443, 6509, 6610, 6670]","[1356, 1938, 3680, 4398, 5679]",7092,39,7053,5,34,7053,0
2.5,MMIL3G,"[112, 129, 188, 469, 686, 703, 732, 745, 824, 875, 1034, 1038, 1326, 1445, 1913, 1939, 1946, 1992, 2090, 2583, 2916]","[686, 824, 1913, 2090]","[112, 129, 188, 469, 703, 732, 745, 875, 1034, 1038, 1326, 1445, 1939, 1946, 1992, 2583, 2916]","[686, 824, 1913, 2090]",3482,21,3461,4,17,3461,0
2.5,MMIL5G,"[21, 40, 87, 151, 184, 218, 359, 674, 731, 818, 965, 970, 980, 1473, 1593, 1625, 1842, 1971, 2123, 2262, 2282, 2448, 2637, 2641, 2645, 2649, 2653, 2657, 2661, 2708, 2787, 2874, 2991, 3073, 3101, 3123, 3418, 3535, 3597, 3792, 4000, 4227, 4434, 4702, 4754, 4774, 4806, 4899, 4929, 4997, 5051, 5071, 5217, 5303, 5318, 5361, 5441, 5742, 6026, 6174, 6337, 6478, 6585, 6608]","[731, 1593, 3597]","[21, 40, 87, 151, 184, 218, 359, 674, 818, 965, 970, 980, 1473, 1625, 1842, 1971, 2123, 2262, 2282, 2448, 2637, 2641, 2645, 2649, 2653, 2657, 2661, 2708, 2787, 2874, 2991, 3073, 3101, 3123, 3418, 3535, 3792, 4000, 4227, 4434, 4702, 4754, 4774, 4806, 4899, 4929, 4997, 5051, 5071, 5217, 5303, 5318, 5361, 5441, 5742, 6026, 6174, 6337, 6478, 6585, 6608]","[731, 1593, 3597]",6719,64,6655,3,61,6655,0
2.5,MMKFGF,"[47, 469, 493, 542, 566, 693, 779, 961, 976, 1040, 1045, 1086, 1254, 1259, 1279, 1337, 1548, 1556, 1574, 1624, 2012, 2079, 2322, 2484, 2548, 2561, 2607, 2715, 2731, 2857, 2886, 3185, 3596, 3797, 3801, 3818, 3835]","[542, 1045]","[47, 469, 493, 566, 693, 779, 961, 976, 1040, 1086, 1254, 1259, 1279, 1337, 1548, 1556, 1574, 1624, 2012, 2079, 2322, 2484, 2548, 2561, 2607, 2715, 2731, 2857, 2886, 3185, 3596, 3797, 3801, 3818, 3835]","[542, 1045]",3981,37,3944,2,35,3944,0
2.5,MMLDHAG,"[48, 105, 232, 275, 571, 736, 829, 901, 1012, 1052, 1081, 1180, 1378, 1782, 1906, 2096, 2132, 2186, 2305, 2429, 2616, 2774, 2779, 2825, 2852, 2915, 2946, 2978, 3061, 3195, 3291, 3295, 3345, 3434, 3548, 3649, 3670, 3728, 3772, 3939, 4077, 4089, 4167, 4226, 4240, 4330, 4377, 4577, 4649, 4667, 4786, 4824, 4966, 5138, 5333, 5458, 5676, 5919, 6038, 6042, 6123, 6154, 6597, 7130, 7171, 7208, 7224, 7338, 7398, 7401, 7668, 7776, 7780, 7959, 7963, 8181, 8206, 8280, 8315, 8327, 8336, 8380, 8402, 8414, 8454, 8586, 8597, 8833, 8981, 9289, 9494, 9510, 9652, 9818, 9897, 9999, 10037, 10068, 10407, 10447, 10503, 10590, 10704, 10855, 11076, 11081, 11308, 11426, 11452, 11532, 11655, 11822, 11845, 11893, 11907, 11915, 11977, 12060, 12148, 12155, 12262, 12598, 12721]","[4577, 5919, 7171, 7668, 8597, 10704]","[48, 105, 232, 275, 571, 736, 829, 901, 1012, 1052, 1081, 1180, 1378, 1782, 1906, 2096, 2132, 2186, 2305, 2429, 2616, 2774, 2779, 2825, 2852, 2915, 2946, 2978, 3061, 3195, 3291, 3295, 3345, 3434, 3548, 3649, 3670, 3728, 3772, 3939, 4077, 4089, 4167, 4226, 4240, 4330, 4377, 4649, 4667, 4786, 4824, 4966, 5138, 5333, 5458, 5676, 6038, 6042, 6123, 6154, 6597, 7130, 7208, 7224, 7338, 7398, 7401, 7776, 7780, 7959, 7963, 8181, 8206, 8280, 8315, 8327, 8336, 8380, 8402, 8414, 8454, 8586, 8833, 8981, 9289, 9494, 9510, 9652, 9818, 9897, 9999, 10037, 10068, 10407, 10447, 10503, 10590, 10855, 11076, 11081, 11308, 11426, 11452, 11532, 11655, 11822, 11845, 11893, 11907, 11915, 11977, 12060, 12148, 12155, 12262, 12598, 12721]","[4577, 5919, 7171, 7668, 8597, 10704]",12843,123,12720,6,117,12720,0
2.5,MMMMP9A,"[11, 70, 96, 561, 880, 967, 1341, 1378, 1440, 1469, 1476, 1508, 1562, 1600, 1631, 1734, 1890, 1949, 1981, 2008, 2031, 2039, 2068, 2293, 2331, 2375, 2550, 2665, 2781, 2849, 3058, 3064, 3068, 3081, 3222, 3230, 3359, 3395, 3418, 3441, 3479, 3808, 3886, 3945, 3971, 4051, 4132, 4201, 4206, 4321, 4457, 4478, 4492, 4851, 4864, 4944, 5301, 5483, 5695, 5708, 5716, 5799, 5936, 6087, 6215, 6282, 6291, 6356, 6378, 6417, 6482, 6525, 6564, 7049, 7141, 7374, 7402, 7445, 7632, 7752, 7770, 7791, 7800, 7809, 7939, 7954, 7964]","[1341, 2008, 2375, 2781, 3064, 3418, 3945, 4206, 5695, 5936, 6356, 6564]","[11, 70, 96, 561, 880, 967, 1378, 1440, 1469, 1476, 1508, 1562, 1600, 1631, 1734, 1890, 1949, 1981, 2031, 2039, 2068, 2293, 2331, 2550, 2665, 2849, 3058, 3068, 3081, 3222, 3230, 3359, 3395, 3441, 3479, 3808, 3886, 3971, 4051, 4132, 4201, 4321, 4457, 4478, 4492, 4851, 4864, 4944, 5301, 5483, 5708, 5716, 5799, 6087, 6215, 6282, 6291, 6378, 6417, 6482, 6525, 7049, 7141, 7374, 7402, 7445, 7632, 7752, 7770, 7791, 7800, 7809, 7939, 7954, 7964]","[1341, 2008, 2375, 2781, 3064, 3418, 3945, 4206, 5695, 5936, 6356, 6564]",8182,87,8095,12,75,8095,0
2.5,MMMRPS24,"[40, 217, 266, 353, 404, 645, 670, 712, 836, 959, 1106, 1132, 1180, 1196, 1460, 1518, 1761, 1994, 2108, 2149, 2168, 2206, 2253, 2406, 2652, 2669, 2675, 2683, 2928, 2976, 2987, 3095, 3137, 3192, 3263, 3713, 3731, 3934, 4110, 4371, 4461, 4832, 4892, 4905, 4917, 4969, 5070, 5091, 5154, 5228, 5255, 5435]","[404, 1460, 1761, 3137]","[40, 217, 266, 353, 645, 670, 712, 836, 959, 1106, 1132, 1180, 1196, 1518, 1994, 2108, 2149, 2168, 2206, 2253, 2406, 2652, 2669, 2675, 2683, 2928, 2976, 2987, 3095, 3192, 3263, 3713, 3731, 3934, 4110, 4371, 4461, 4832, 4892, 4905, 4917, 4969, 5070, 5091, 5154, 5228, 5255, 5435]","[404, 1460, 1761, 3137]",5491,52,5439,4,48,5439,0
2.5,MMMTIX,"[172, 203, 402, 706, 758, 951, 1355, 1502, 1515]","[402, 951]","[172, 203, 706, 758, 1355, 1502, 1515]","[402, 951]",1552,9,1543,2,7,1543,0
2.5,MMMUPBS6,"[79, 149, 449, 731, 792, 861, 926, 1203, 1207, 1246, 1298, 1451, 1614, 1714, 1727, 1901, 2027, 2045, 2277, 2425, 2623, 2793, 3171, 3185, 3236, 3366, 3445, 3685, 3883, 4527]","[731, 1203, 2045, 2793, 3236]","[79, 149, 449, 792, 861, 926, 1207, 1246, 1298, 1451, 1614, 1714, 1727, 1901, 2027, 2277, 2425, 2623, 3171, 3185, 3366, 3445, 3685, 3883, 4527]","[731, 1203, 2045, 2793, 3236]",4614,30,4584,5,25,4584,0
2.5,MMMYCL,"[26, 256, 264, 270, 317, 337, 369, 580, 806, 840, 898, 919, 1044, 1170, 1396, 1615, 1787, 1951, 1955, 1963, 2009, 2042, 2084, 2341, 2350, 2419, 2554, 2634, 2785, 3292, 3318, 3447, 3452, 3461, 3569, 3810, 3990, 3996, 4161, 4334, 4613, 4617, 4673, 4690, 4744, 4948, 4970, 5002, 5185, 5262, 5420, 5452, 5610, 5883, 6229, 6468, 6484, 6619, 6725, 6731, 6752, 6937, 7147, 7436, 7477, 7560, 7565, 7571, 7635, 7750, 7927, 8161]",[1787],"[26, 256, 264, 270, 317, 337, 369, 580, 806, 840, 898, 919, 1044, 1170, 1396, 1615, 1951, 1955, 1963, 2009, 2042, 2084, 2341, 2350, 2419, 2554, 2634, 2785, 3292, 3318, 3447, 3452, 3461, 3569, 3810, 3990, 3996, 4161, 4334, 4613, 4617, 4673, 4690, 4744, 4948, 4970, 5002, 5185, 5262, 5420, 5452, 5610, 5883, 6229, 6468, 6484, 6619, 6725, 6731, 6752, 6937, 7147, 7436, 7477, 7560, 7565, 7571, 7635, 7750, 7927, 8161]",[1787],8308,72,8236,1,71,8236,0
2.5,MMNFMG,"[50, 59, 97, 120, 243, 274, 284, 352, 421, 638, 993, 1043, 1205, 1223, 1319, 1510, 1549, 1553, 1634, 1774, 1791, 2336, 2340, 2456, 2534, 2540, 2631, 2878, 3175, 3339, 3452, 3597, 3691, 3793, 3876, 4040, 4252, 4409, 4448, 4585, 4619, 4693, 4753, 4777, 4794, 4798, 4804, 4855, 4886, 5044, 5110, 5236, 5282]","[1634, 2540]","[50, 59, 97, 120, 243, 274, 284, 352, 421, 638, 993, 1043, 1205, 1223, 1319, 1510, 1549, 1553, 1774, 1791, 2336, 2340, 2456, 2534, 2631, 2878, 3175, 3339, 3452, 3597, 3691, 3793, 3876, 4040, 4252, 4409, 4448, 4585, 4619, 4693, 4753, 4777, 4794, 4798, 4804, 4855, 4886, 5044, 5110, 5236, 5282]","[1634, 2540]",5463,53,5410,2,51,5410,0
2.5,MMNMYC,"[294, 749, 835, 869, 970, 994, 1163, 1210, 1253, 1355, 1470, 1584, 1591, 1609, 1672, 1732, 1921, 2053, 2756, 2791, 3064, 3124, 3257, 3278, 3549, 3611, 3661, 3902, 3996, 4204, 4261, 4564, 4774]",[1163],"[294, 749, 835, 869, 970, 994, 1210, 1253, 1355, 1470, 1584, 1591, 1609, 1672, 1732, 1921, 2053, 2756, 2791, 3064, 3124, 3257, 3278, 3549, 3611, 3661, 3902, 3996, 4204, 4261, 4564, 4774]",[1163],4799,33,4766,1,32,4766,0
2.5,MMNUCLEO,"[184, 540, 622, 665, 669, 784, 863, 1033, 1160, 1774, 1803, 1911, 1932, 2027, 2042, 2214, 2309, 2311, 2423, 2521, 2563, 2596, 2620, 2680, 2859, 2967, 3012, 3040, 3141, 3456, 3562, 3984, 4016, 4029, 4071, 4293, 4319, 4464, 4694, 4715, 4729, 4879, 4926, 5188, 5198, 5305, 5351, 5605, 5879, 5995, 6221, 6230, 6234, 6248, 6349, 6399, 6530, 6726, 6879, 7043, 7135, 7203, 7215, 7250, 7510, 7705, 8122, 8304, 8349, 8458, 8534, 8614, 8738, 8794, 8928, 9050, 9082, 9279, 9352, 9387, 9572, 9700, 9781, 9881, 10068, 10132, 10179, 10235, 10325, 10331, 10349, 10379, 10436, 10506, 10888, 10946, 11016, 11089, 11413]","[2042, 3141, 4293, 4694, 4879, 5198, 6230, 8122, 8738, 9050, 9881, 10436]","[184, 540, 622, 665, 669, 784, 863, 1033, 1160, 1774, 1803, 1911, 1932, 2027, 2214, 2309, 2311, 2423, 2521, 2563, 2596, 2620, 2680, 2859, 2967, 3012, 3040, 3456, 3562, 3984, 4016, 4029, 4071, 4319, 4464, 4715, 4729, 4926, 5188, 5305, 5351, 5605, 5879, 5995, 6221, 6234, 6248, 6349, 6399, 6530, 6726, 6879, 7043, 7135, 7203, 7215, 7250, 7510, 7705, 8304, 8349, 8458, 8534, 8614, 8794, 8928, 9082, 9279, 9352, 9387, 9572, 9700, 9781, 10068, 10132, 10179, 10235, 10325, 10331, 10349, 10379, 10506, 10888, 10946, 11016, 11089, 11413]","[2042, 3141, 4293, 4694, 4879, 5198, 6230, 7517, 8122, 8738, 9050, 9881, 10436]",11470,99,11371,12,87,11370,1
2.5,MMODC2,"[80, 91, 124, 331, 440, 454, 689, 737, 803, 944, 966, 1053, 1182, 1239, 1369, 1374, 1482, 1557, 1801, 1855, 1892, 1943, 2073, 2227, 2271, 2399, 2508, 2523, 2532, 2537, 2563, 2572, 2681, 2702, 2728, 2836, 2886, 2890, 2999, 3003, 3130, 3416, 3433, 3559, 3752, 3758, 3778, 4219, 4246]","[331, 737, 1053, 1374, 1557, 1801, 2508, 2702, 2999]","[80, 91, 124, 440, 454, 689, 803, 944, 966, 1182, 1239, 1369, 1482, 1855, 1892, 1943, 2073, 2227, 2271, 2399, 2523, 2532, 2537, 2563, 2572, 2681, 2728, 2836, 2886, 2890, 3003, 3130, 3416, 3433, 3559, 3752, 3758, 3778, 4219, 4246]","[331, 737, 1053, 1374, 1557, 1801, 2508, 2702, 2999]",4252,49,4203,9,40,4203,0
2.5,MMOESTEOP,"[510, 706, 763, 771, 993, 997, 1091, 1127, 1395, 1662, 1666, 1800, 1811, 2027, 2052, 2283, 2459, 2605, 2609, 2714, 2742, 2821, 2917, 3332, 3523, 4039, 4101, 4216, 4271, 4452, 4637, 4834, 5104, 5290, 5308, 5456, 5607, 5729]","[993, 1127, 2283, 2821, 4101]","[510, 706, 763, 771, 997, 1091, 1395, 1662, 1666, 1800, 1811, 2027, 2052, 2459, 2605, 2609, 2714, 2742, 2917, 3332, 3523, 4039, 4216, 4271, 4452, 4637, 4834, 5104, 5290, 5308, 5456, 5607, 5729]","[993, 1127, 2283, 2821, 4101]",5774,38,5736,5,33,5736,0
2.5,MMPO,"[324, 475, 561, 825, 857, 1313, 1686, 1709, 1716, 1800, 1950, 2006, 2193, 2232, 2239, 2304, 2391, 2446, 2553, 2839, 2860, 2948, 3035, 3054, 3336, 3441, 3503, 3655, 3719, 3728, 3749, 4238, 4257, 4385, 4769, 4816, 4831, 4835, 4902, 5261, 5312, 5347, 5575, 5641, 5673, 5809, 5814, 6010, 6145, 6250, 6308, 6384, 6478, 6509, 6525, 6555, 6582, 6620, 6624, 6637, 6664, 6672, 6716, 6790, 6805, 6833, 6901, 6911, 6956, 6982, 7167, 7628, 7756, 7842, 8043, 8109, 8440, 8691, 8736, 8907, 9079, 9156, 9226, 9240, 9244, 9257, 9454, 9464, 9476, 9483, 9712, 9716, 9730, 9809, 9841, 9896, 9903, 9938, 10001, 10055, 10550, 10751, 10756, 10826, 10849, 10853, 10866, 10894, 10970, 10979, 10983, 11067, 11076, 11344, 11611, 11636, 11901]","[2193, 2446, 2948, 3503, 3728, 4769, 7167, 8440, 8907, 9903]","[324, 475, 561, 825, 857, 1313, 1686, 1709, 1716, 1800, 1950, 2006, 2232, 2239, 2304, 2391, 2553, 2839, 2860, 3035, 3054, 3336, 3441, 3655, 3719, 3749, 4238, 4257, 4385, 4816, 4831, 4835, 4902, 5261, 5312, 5347, 5575, 5641, 5673, 5809, 5814, 6010, 6145, 6250, 6308, 6384, 6478, 6509, 6525, 6555, 6582, 6620, 6624, 6637, 6664, 6672, 6716, 6790, 6805, 6833, 6901, 6911, 6956, 6982, 7628, 7756, 7842, 8043, 8109, 8691, 8736, 9079, 9156, 9226, 9240, 9244, 9257, 9454, 9464, 9476, 9483, 9712, 9716, 9730, 9809, 9841, 9896, 9938, 10001, 10055, 10550, 10751, 10756, 10826, 10849, 10853, 10866, 10894, 10970, 10979, 10983, 11067, 11076, 11344, 11611, 11636, 11901]","[2193, 2446, 2948, 3503, 3728, 4018, 4769, 7167, 8440, 8907, 9903]",11905,117,11788,10,107,11787,1
2.5,MMPPSOMA,"[124, 133, 251, 411, 435, 447, 562, 608, 706, 722, 990, 1034, 1208, 1248, 1301, 1367, 1439, 1824, 2049, 2196, 2491]",[1034],"[124, 133, 251, 411, 435, 447, 562, 608, 706, 722, 990, 1208, 1248, 1301, 1367, 1439, 1824, 2049, 2196, 2491]",[1034],2556,21,2535,1,20,2535,0
2.5,MMPROP2,"[63, 78, 289, 349, 631]",[289],"[63, 78, 349, 631]",[289],712,5,707,1,4,707,0
2.5,MMPROT1,"[312, 452, 474, 478, 590, 609, 759, 797, 937, 1094]",[759],"[312, 452, 474, 478, 590, 609, 797, 937, 1094]",[759],1178,10,1168,1,9,1168,0
2.5,MMPROT2,"[311, 361, 480, 484, 508, 615, 658, 771, 791, 880, 915, 987, 1128, 1218, 1357, 1368, 1469]",[1218],"[311, 361, 480, 484, 508, 615, 658, 771, 791, 880, 915, 987, 1128, 1357, 1368, 1469]",[1218],1568,17,1551,1,16,1551,0
2.5,MMSAP,"[441, 601, 794, 886, 1200, 1546, 1550, 1554, 1558, 1572, 1805, 1837]",[441],"[601, 794, 886, 1200, 1546, 1550, 1554, 1558, 1572, 1805, 1837]",[441],1868,12,1856,1,11,1856,0
2.5,MMSCIMIP,"[415, 552, 578, 600, 1010, 1017, 1054, 1066, 1153, 1867, 1946]","[415, 1017]","[552, 578, 600, 1010, 1054, 1066, 1153, 1867, 1946]","[415, 1017]",1980,11,1969,2,9,1969,0
2.5,MMSYNDE1A,"[48, 136, 190, 456, 526, 762, 816, 850, 903, 988, 1054, 1345, 1483, 1992, 2151, 2198, 2228, 2272, 2289, 2313, 2318, 2365, 2487, 2623, 2830, 3132, 3292, 3556, 3570, 3706, 3831, 3981, 4124, 4639, 4755, 4826, 4867, 4932, 4952, 5018, 5043, 5219, 5366, 5420, 5616, 5700, 5772, 5834, 5842, 5871, 5923, 5970, 6028, 6090, 6171, 6256, 6275, 6622, 6741, 6769, 6991, 6996, 7075, 7094, 7317, 7622, 7683, 7733, 7805, 7828, 7914, 7931, 8043, 8056, 8412, 8442, 8522, 8705, 8765, 8770, 9076, 9182, 9320, 9519, 9666, 9739, 9867, 9919, 10045, 10122, 10319, 10340, 10903, 11002, 11099, 11249, 11397, 11441, 11495, 11583, 11679, 11823, 11858, 11900, 11920, 11930, 12082, 12128, 12132, 12407, 12515, 12527, 12647, 12651, 12803, 12879, 13042, 13095, 13180, 13198, 13238, 13426, 13599, 13633, 13642, 13646, 13723, 13761, 13767, 13851, 13861, 13868, 14080, 14113, 14178, 14182, 14254, 14410, 14429, 14553, 14623, 14634, 14704, 14812, 14843, 14849, 14948, 15011, 15018, 15081, 15172, 15203, 15299, 15499, 15641, 15674, 15696, 15704, 15806, 15845, 15929, 15955, 16427, 16486, 16566, 16639, 16744, 16770, 16849, 16868, 17246, 17281, 17290, 17451, 17647, 17663, 17701, 17717, 17934, 17951, 17984, 18558, 18607, 18655, 18754, 18837, 19009, 19057, 19151, 19286, 19416, 19424, 19440, 19542, 19546, 19726, 19767, 19822, 19903, 20385, 20460, 20515, 20556, 20604, 20626, 20657, 20689, 20735, 20900, 20942, 20958, 20976, 20990, 21008, 21030, 21279, 21758, 21888, 22028, 22081, 22094, 22120, 22241, 22342, 22393, 22488, 22707, 22802, 23105, 23111, 23203, 23325, 23341]","[1345, 19009, 20385, 20942]","[48, 136, 190, 456, 526, 762, 816, 850, 903, 988, 1054, 1483, 1992, 2151, 2198, 2228, 2272, 2289, 2313, 2318, 2365, 2487, 2623, 2830, 3132, 3292, 3556, 3570, 3706, 3831, 3981, 4124, 4639, 4755, 4826, 4867, 4932, 4952, 5018, 5043, 5219, 5366, 5420, 5616, 5700, 5772, 5834, 5842, 5871, 5923, 5970, 6028, 6090, 6171, 6256, 6275, 6622, 6741, 6769, 6991, 6996, 7075, 7094, 7317, 7622, 7683, 7733, 7805, 7828, 7914, 7931, 8043, 8056, 8412, 8442, 8522, 8705, 8765, 8770, 9076, 9182, 9320, 9519, 9666, 9739, 9867, 9919, 10045, 10122, 10319, 10340, 10903, 11002, 11099, 11249, 11397, 11441, 11495, 11583, 11679, 11823, 11858, 11900, 11920, 11930, 12082, 12128, 12132, 12407, 12515, 12527, 12647, 12651, 12803, 12879, 13042, 13095, 13180, 13198, 13238, 13426, 13599, 13633, 13642, 13646, 13723, 13761, 13767, 13851, 13861, 13868, 14080, 14113, 14178, 14182, 14254, 14410, 14429, 14553, 14623, 14634, 14704, 14812, 14843, 14849, 14948, 15011, 15018, 15081, 15172, 15203, 15299, 15499, 15641, 15674, 15696, 15704, 15806, 15845, 15929, 15955, 16427, 16486, 16566, 16639, 16744, 16770, 16849, 16868, 17246, 17281, 17290, 17451, 17647, 17663, 17701, 17717, 17934, 17951, 17984, 18558, 18607, 18655, 18754, 18837, 19057, 19151, 19286, 19416, 19424, 19440, 19542, 19546, 19726, 19767, 19822, 19903, 20460, 20515, 20556, 20604, 20626, 20657, 20689, 20735, 20900, 20958, 20976, 20990, 21008, 21030, 21279, 21758, 21888, 22028, 22081, 22094, 22120, 22241, 22342, 22393, 22488, 22707, 22802, 23105, 23111, 23203, 23325, 23341]","[1345, 19009, 20385, 20942]",23592,233,23359,4,229,23359,0
2.5,MMTHY1G,"[80, 93, 183, 191, 335, 616, 629, 678, 696, 720, 854, 946, 1009, 1156, 1281, 1586, 1828, 1833, 1837, 1943, 2174, 2181, 2477]","[80, 1009]","[93, 183, 191, 335, 616, 629, 678, 696, 720, 854, 946, 1156, 1281, 1586, 1828, 1833, 1837, 1943, 2174, 2181, 2477]","[80, 1009]",2682,23,2659,2,21,2659,0
2.5,MMTLAC,"[140, 299, 449, 494, 539, 748, 864, 912, 917, 925, 930, 1061, 1090, 1171, 1335, 1750, 2172, 2743, 2858, 2874, 3092, 3158, 3239, 3338, 3467, 3509, 3633, 3836, 4077, 4285, 4297, 4373, 4591, 4651, 4692, 4739, 4774, 4783, 4830, 4893, 4939, 5133, 5164, 5179, 5339]","[299, 748, 1171, 3092, 3338]","[140, 449, 494, 539, 864, 912, 917, 925, 930, 1061, 1090, 1335, 1750, 2172, 2743, 2858, 2874, 3158, 3239, 3467, 3509, 3633, 3836, 4077, 4285, 4297, 4373, 4591, 4651, 4692, 4739, 4774, 4783, 4830, 4893, 4939, 5133, 5164, 5179, 5339]","[299, 748, 1171, 3092, 3338]",5239,45,5194,5,40,5194,0
2.5,MMTNFBG,"[174, 315, 524, 734, 813, 1196, 1234, 1553, 1558, 1728, 1911, 2136, 2415, 2419, 2456, 2999, 3003]","[1728, 1911]","[174, 315, 524, 734, 813, 1196, 1234, 1553, 1558, 2136, 2415, 2419, 2456, 2999, 3003]","[1728, 1911]",3211,17,3194,2,15,3194,0
2.5,MMTROPIB,"[183, 261, 656, 856, 862, 868, 1092, 1120, 1132, 1214, 1261, 1276, 1307, 1568, 1697, 1744, 1749, 1772, 1832, 1932, 1939, 1956, 1977, 2033, 2038, 2185, 2274, 2279, 2300, 2327, 2421, 2522, 2534, 2656, 2673, 2677, 2687, 2761, 3037, 3564, 3690, 3963, 4269, 4493, 4580, 4604, 4620, 4713, 4748, 4865, 4920, 4950, 5379, 5561]","[1697, 1932, 2185, 2656, 3037, 3564, 4604]","[183, 261, 656, 856, 862, 868, 1092, 1120, 1132, 1214, 1261, 1276, 1307, 1568, 1744, 1749, 1772, 1832, 1939, 1956, 1977, 2033, 2038, 2274, 2279, 2300, 2327, 2421, 2522, 2534, 2673, 2677, 2687, 2761, 3690, 3963, 4269, 4493, 4580, 4620, 4713, 4748, 4865, 4920, 4950, 5379, 5561]","[1697, 1932, 2185, 2656, 3037, 3564, 4604]",5683,54,5629,7,47,5629,0
2.5,MMTUM198,"[70, 120, 347, 611, 709, 798, 891, 985, 1012, 1084, 1216, 1420, 1448, 1692, 1717, 1729, 1750, 1849, 1954, 1986, 1990, 1994, 2193, 2262, 2751, 2808, 2818, 2899, 3040, 3049, 3098, 3313, 3328, 3338, 3587, 3818, 3836, 3845, 4087, 4180, 4220]","[1692, 2818, 3098, 3313, 3587, 3818, 4180]","[70, 120, 347, 611, 709, 798, 891, 985, 1012, 1084, 1216, 1420, 1448, 1717, 1729, 1750, 1849, 1954, 1986, 1990, 1994, 2193, 2262, 2751, 2808, 2899, 3040, 3049, 3328, 3338, 3836, 3845, 4087, 4220]","[1692, 2818, 3098, 3313, 3587, 3818, 4180]",4376,41,4335,7,34,4335,0
2.5,MMU01530,"[76, 99, 190, 325, 358, 636, 891, 924, 956, 1046, 1080, 1148, 1164, 1180, 1224, 1357, 1458, 1576, 1589, 1903, 1955, 2027, 2244, 2269, 2293, 2298, 2316, 2400, 2406, 2581, 2853, 2909, 3002, 3094, 3188, 3231, 3526, 3536, 3542, 3729, 3803, 3939, 4035, 4167, 4263, 4412, 4904, 5083, 5086, 5148, 5255, 5260, 5405, 5602, 5774, 5885, 6029, 6039, 6100, 6229, 6342, 6394, 6423, 6532, 6546, 6611, 6697]","[3094, 3231]","[76, 99, 190, 325, 358, 636, 891, 924, 956, 1046, 1080, 1148, 1164, 1180, 1224, 1357, 1458, 1576, 1589, 1903, 1955, 2027, 2244, 2269, 2293, 2298, 2316, 2400, 2406, 2581, 2853, 2909, 3002, 3188, 3526, 3536, 3542, 3729, 3803, 3939, 4035, 4167, 4263, 4412, 4904, 5083, 5086, 5148, 5255, 5260, 5405, 5602, 5774, 5885, 6029, 6039, 6100, 6229, 6342, 6394, 6423, 6532, 6546, 6611, 6697]","[3094, 3231]",6694,67,6627,2,65,6627,0
2.5,MMU02278,"[75, 206, 342, 348, 669, 888, 962, 1041, 1106, 1135, 1141, 1323, 1509, 1537, 1542, 1638, 1858, 1949, 2159, 2312, 2344, 3100, 3368, 3433, 3593, 3647, 3669, 3684, 3779, 3783, 3873, 3967]",[1638],"[75, 206, 342, 348, 669, 888, 962, 1041, 1106, 1135, 1141, 1323, 1509, 1537, 1542, 1858, 1949, 2159, 2312, 2344, 3100, 3368, 3433, 3593, 3647, 3669, 3684, 3779, 3783, 3873, 3967]",[1638],3973,32,3941,1,31,3941,0
2.5,MMU02298,"[475, 603, 685, 887, 1023, 1099, 1180, 1427, 1508, 1531, 1639, 1880, 2102, 2242, 2413, 2618, 2874, 2897, 3047, 3067, 3116, 3120, 3328, 3347, 3442, 3823, 3893, 3911, 3920, 4213, 4270, 4343, 4351, 4589, 4749, 4765, 4769, 4794, 4897, 4942, 5398, 5502, 5527, 5550]","[1180, 2413]","[475, 603, 685, 887, 1023, 1099, 1427, 1508, 1531, 1639, 1880, 2102, 2242, 2618, 2874, 2897, 3047, 3067, 3116, 3120, 3328, 3347, 3442, 3823, 3893, 3911, 3920, 4213, 4270, 4343, 4351, 4589, 4749, 4765, 4769, 4794, 4897, 4942, 5398, 5502, 5527, 5550]","[1180, 2413]",5851,44,5807,2,42,5807,0
2.5,MMU02884,"[214, 220, 462, 512, 589, 668, 711, 814, 875, 1025, 1273, 1372, 1475, 1576, 1630, 1659, 1761, 1930, 2107, 2340, 2382, 2441, 2484, 2785, 3386, 3526, 3665, 3669, 3726, 3865, 3889, 4056, 4307, 4706, 4798, 4831, 4957, 5094, 5217, 5244, 5291, 5499, 5517, 5588, 5806, 6022, 6026, 6642, 6687, 6740, 6836, 6870, 6913, 7068, 7208, 7219, 7309, 7527, 7562, 7567, 7708, 7847, 7866, 7884, 7896, 7973, 8171, 8531, 8536, 8590, 8605, 8612]","[1630, 5244, 6836]","[214, 220, 462, 512, 589, 668, 711, 814, 875, 1025, 1273, 1372, 1475, 1576, 1659, 1761, 1930, 2107, 2340, 2382, 2441, 2484, 2785, 3386, 3526, 3665, 3669, 3726, 3865, 3889, 4056, 4307, 4706, 4798, 4831, 4957, 5094, 5217, 5291, 5499, 5517, 5588, 5806, 6022, 6026, 6642, 6687, 6740, 6870, 6913, 7068, 7208, 7219, 7309, 7527, 7562, 7567, 7708, 7847, 7866, 7884, 7896, 7973, 8171, 8531, 8536, 8590, 8605, 8612]","[1630, 5244, 6836]",8757,72,8685,3,69,8685,0
2.5,MMU04056,"[186, 217, 231, 265, 321, 387, 398, 816, 901, 1227, 1326, 1331, 1382, 1410, 1450, 1456, 1461, 1465, 1472, 1502, 1513, 1644, 1800, 1857, 1865, 2046, 2088, 2108, 2135, 2183, 2256, 2377, 2388, 2490, 2509, 2667, 2711, 2747, 2902, 2960, 3291, 3530, 3721, 3725, 4381, 4688, 4769, 4773, 5105, 5218, 5413, 5459, 5594, 6264, 6477, 6772, 7071, 7075, 7101, 7111, 7199, 7544, 7595, 7683, 7703, 7710, 7979, 8069, 8501, 8625, 8633, 8664, 8680, 8732, 8830, 8895, 9012, 9216, 9485, 9517, 9807, 10200, 10273, 10288, 10317, 10744, 10794, 10876, 10998, 11005, 11259, 11429, 11441, 11449, 11533, 11578, 11758, 11797, 12088, 12156, 12159, 12211, 12437, 12804, 13112, 13211, 13278, 13344, 13391, 13400, 13491, 13933, 14104, 14226, 14264, 14478, 14483, 14531, 14615, 14896, 15011, 15214, 15270, 15365, 15417, 15502, 15506, 15545, 15620, 15870, 15942, 15971, 15993, 16157, 16207, 16230, 16334, 16348, 16561, 16710, 16734, 16843, 16994, 17007, 17017, 17245, 17393, 17452, 17765, 17822, 17826, 17992, 18100, 18768, 19388, 19638, 19830, 19860, 19864, 20025, 20066, 20131, 20243, 20314, 20448, 20501, 20597, 20602, 20633, 20804, 20937, 21133, 21171, 21185, 21351, 21514, 21556, 21562, 21625, 21633]","[1382, 3530, 4688, 7979, 8895, 10317, 10876, 11259, 12211, 13491, 16230, 16561]","[186, 217, 231, 265, 321, 387, 398, 816, 901, 1227, 1326, 1331, 1410, 1450, 1456, 1461, 1465, 1472, 1502, 1513, 1644, 1800, 1857, 1865, 2046, 2088, 2108, 2135, 2183, 2256, 2377, 2388, 2490, 2509, 2667, 2711, 2747, 2902, 2960, 3291, 3721, 3725, 4381, 4769, 4773, 5105, 5218, 5413, 5459, 5594, 6264, 6477, 6772, 7071, 7075, 7101, 7111, 7199, 7544, 7595, 7683, 7703, 7710, 8069, 8501, 8625, 8633, 8664, 8680, 8732, 8830, 9012, 9216, 9485, 9517, 9807, 10200, 10273, 10288, 10744, 10794, 10998, 11005, 11429, 11441, 11449, 11533, 11578, 11758, 11797, 12088, 12156, 12159, 12437, 12804, 13112, 13211, 13278, 13344, 13391, 13400, 13933, 14104, 14226, 14264, 14478, 14483, 14531, 14615, 14896, 15011, 15214, 15270, 15365, 15417, 15502, 15506, 15545, 15620, 15870, 15942, 15971, 15993, 16157, 16207, 16334, 16348, 16710, 16734, 16843, 16994, 17007, 17017, 17245, 17393, 17452, 17765, 17822, 17826, 17992, 18100, 18768, 19388, 19638, 19830, 19860, 19864, 20025, 20066, 20131, 20243, 20314, 20448, 20501, 20597, 20602, 20633, 20804, 20937, 21133, 21171, 21185, 21351, 21514, 21556, 21562, 21625, 21633]","[1382, 3530, 4688, 7979, 8895, 10317, 10876, 11259, 12211, 13491, 16230, 16561]",21710,180,21530,12,168,21530,0
2.5,MMU04827,"[70, 105, 689, 729, 1299, 1649, 1862, 1896, 2148, 2179, 2200, 2246, 2280, 2319, 2369, 2512, 2767, 2828, 3095, 3453, 3523, 3551, 3555, 3684, 3688, 3701, 3903, 3933, 3993, 4131, 4174, 4276, 4281, 4301, 4969, 5174, 5221, 5286, 5338, 5444, 5675, 5771, 6145, 6692, 6871, 6879, 7133, 7252, 7265, 7291, 7369, 7519, 7579, 7592]","[3684, 4281, 4969]","[70, 105, 689, 729, 1299, 1649, 1862, 1896, 2148, 2179, 2200, 2246, 2280, 2319, 2369, 2512, 2767, 2828, 3095, 3453, 3523, 3551, 3555, 3688, 3701, 3903, 3933, 3993, 4131, 4174, 4276, 4301, 5174, 5221, 5286, 5338, 5444, 5675, 5771, 6145, 6692, 6871, 6879, 7133, 7252, 7265, 7291, 7369, 7519, 7579, 7592]","[3684, 4281, 4969]",7600,54,7546,3,51,7546,0
2.5,MMU07568,"[84, 253, 267, 361, 367, 482, 527, 531, 638]","[84, 267, 482]","[253, 361, 367, 527, 531, 638]","[84, 267, 482]",743,9,734,3,6,734,0
2.5,MMU07808,"[61, 183, 404, 542, 547, 664, 673, 677, 824, 829, 866, 876, 987, 1019, 1087, 1179, 1208, 1513, 1697, 1701, 1762, 1798, 1897, 1918, 2384, 2395]","[673, 1697]","[61, 183, 404, 542, 547, 664, 677, 824, 829, 866, 876, 987, 1019, 1087, 1179, 1208, 1513, 1701, 1762, 1798, 1897, 1918, 2384, 2395]","[673, 1697]",2840,26,2814,2,24,2814,0
2.5,MMU09741,"[245, 507, 637, 654, 1076, 1094, 1230, 1293, 1426, 1537, 1655, 1679, 2034, 2116, 2257, 2675]","[245, 1230]","[507, 637, 654, 1076, 1094, 1293, 1426, 1537, 1655, 1679, 2034, 2116, 2257, 2675]","[245, 1230]",2844,16,2828,2,14,2828,0
2.5,MMU09964,"[26, 30, 45, 49, 55, 157, 252, 258, 321, 375, 433, 510, 803, 811, 857, 917, 1295, 1299, 1305, 1584, 1881, 1968, 2044, 2115, 2317, 2375, 2397, 2410, 2490, 2671, 2680, 2693, 2697, 2965, 2970, 2996, 3136, 3414, 3428, 3432, 3448, 3700, 3712, 3779, 3796, 3933, 4126, 4303, 4598, 4607, 4657, 4788, 4962, 5091, 5375, 5667, 5726, 5730, 5747, 5754, 5793, 5816, 5820, 5824, 5828, 5832, 5836, 5840, 5844, 5977, 6240, 6447, 6524, 6612, 6741, 6890, 7030, 7044, 7151, 7292, 7423, 7434, 7525, 7533, 7667, 7695, 7760, 7962, 8162, 8192, 8455, 8460, 8601, 8988, 9017, 9173, 9190, 9311, 9576, 9733, 9898, 9952, 9980, 10001, 10273, 10328, 10332, 10357, 10363, 10372, 10378, 10429, 10434, 10875, 10991, 11050, 11127, 11186, 11246]","[1968, 3428, 4303, 4607, 7962, 8162, 8601, 9017, 9311, 10875]","[26, 30, 45, 49, 55, 157, 252, 258, 321, 375, 433, 510, 803, 811, 857, 917, 1295, 1299, 1305, 1584, 1881, 2044, 2115, 2317, 2375, 2397, 2410, 2490, 2671, 2680, 2693, 2697, 2965, 2970, 2996, 3136, 3414, 3432, 3448, 3700, 3712, 3779, 3796, 3933, 4126, 4598, 4657, 4788, 4962, 5091, 5375, 5667, 5726, 5730, 5747, 5754, 5793, 5816, 5820, 5824, 5828, 5832, 5836, 5840, 5844, 5977, 6240, 6447, 6524, 6612, 6741, 6890, 7030, 7044, 7151, 7292, 7423, 7434, 7525, 7533, 7667, 7695, 7760, 8192, 8455, 8460, 8988, 9173, 9190, 9576, 9733, 9898, 9952, 9980, 10001, 10273, 10328, 10332, 10357, 10363, 10372, 10378, 10429, 10434, 10991, 11050, 11127, 11186, 11246]","[1968, 3428, 4303, 4607, 7962, 8162, 8601, 9017, 9311, 10875]",11454,119,11335,10,109,11335,0
2.5,MMU10098,"[26, 517, 593, 695, 865, 1098, 1152, 1155, 1165, 1173, 1383, 1425, 1436, 1624, 1632, 1956, 1967, 2158, 2584, 2755, 2907, 2957, 3145, 3266, 3270, 3312, 3325, 3447, 3509, 3513, 3562, 3596, 4222, 4659, 4699, 4929, 5053, 5292, 5352, 5535, 5565, 5593, 5609, 5695, 5728, 5812]","[1173, 3509]","[26, 517, 593, 695, 865, 1098, 1152, 1155, 1165, 1383, 1425, 1436, 1624, 1632, 1956, 1967, 2158, 2584, 2755, 2907, 2957, 3145, 3266, 3270, 3312, 3325, 3447, 3513, 3562, 3596, 4222, 4659, 4699, 4929, 5053, 5292, 5352, 5535, 5565, 5593, 5609, 5695, 5728, 5812]","[1173, 3509]",6117,46,6071,2,44,6071,0
2.5,MMU11054,"[23, 185, 204, 383, 457, 729, 951, 1303, 1559, 1668, 1833, 1839, 1884, 1996, 2037, 2250, 2330, 2515]","[457, 1996]","[23, 185, 204, 383, 729, 951, 1303, 1559, 1668, 1833, 1839, 1884, 2037, 2250, 2330, 2515]","[457, 1418, 1996]",2564,18,2546,2,16,2545,1
2.5,MMU11713,"[250, 288, 520, 587, 634, 694, 996, 1203, 1270, 1288, 1365, 1479, 1485, 1530, 1586]","[288, 634]","[250, 520, 587, 694, 996, 1203, 1270, 1288, 1365, 1479, 1485, 1530, 1586]","[288, 634]",1759,15,1744,2,13,1744,0
2.5,MMU12029,"[17, 21, 51, 281, 297, 342, 360, 381, 448, 507, 582, 695, 879, 1264, 1309, 1347, 1385, 1410, 1450, 1741, 1897, 1912, 1922, 2030, 2036, 2082, 2165]","[582, 1264]","[17, 21, 51, 281, 297, 342, 360, 381, 448, 507, 695, 879, 1309, 1347, 1385, 1410, 1450, 1741, 1897, 1912, 1922, 2030, 2036, 2082, 2165]","[582, 1264]",2255,27,2228,2,25,2228,0
2.5,MMU12273,"[38, 165, 247, 283, 306, 327, 358, 384, 389, 496, 680, 685, 688, 769, 857, 915, 970, 1077, 1085, 1434, 1546, 1550, 1657, 1740, 1871, 1904, 1940, 2442]","[680, 1085, 1740]","[38, 165, 247, 283, 306, 327, 358, 384, 389, 496, 685, 688, 769, 857, 915, 970, 1077, 1434, 1546, 1550, 1657, 1871, 1904, 1940, 2442]","[680, 1085, 1740]",2575,28,2547,3,25,2547,0
2.5,MMU12559,"[62, 247, 264, 322, 822]",[247],"[62, 264, 322, 822]",[247],918,5,913,1,4,913,0
2.5,MMU12560,"[62, 247, 257, 322]",[247],"[62, 257, 322]",[247],920,4,916,1,3,916,0
2.5,MMU12561,"[62, 247, 322, 384, 420, 658, 820]",[247],"[62, 322, 384, 420, 658, 820]",[247],916,7,909,1,6,909,0
2.5,MMU12562,"[9, 62, 247, 322, 590]",[247],"[9, 62, 322, 590]",[247],918,5,913,1,4,913,0
2.5,MMU12565,"[62, 247, 257, 396, 630, 795, 866]",[247],"[62, 257, 396, 630, 795, 866]",[247],1043,7,1036,1,6,1036,0
2.5,MMU13921,"[10, 162, 289, 329, 337, 585, 600, 692, 820, 856, 952, 1034, 1402, 1607, 1741, 1745, 1862, 1867, 2003, 2080, 2197, 2354, 2555, 2635, 2693, 2722, 2930, 3036, 3132, 3241, 3401, 3525, 3630, 3794, 3882, 3990, 4034, 4050, 4089, 4226, 4436, 4514]","[952, 2003, 2354, 2693, 2930, 3241, 3990]","[10, 162, 289, 329, 337, 585, 600, 692, 820, 856, 1034, 1402, 1607, 1741, 1745, 1862, 1867, 2080, 2197, 2555, 2635, 2722, 3036, 3132, 3401, 3525, 3630, 3794, 3882, 4034, 4050, 4089, 4226, 4436, 4514]","[952, 2003, 2354, 2693, 2930, 3241, 3990]",4670,42,4628,7,35,4628,0
2.5,MMU14421,"[250, 255, 282, 399, 473, 511, 690, 819, 1078, 1089, 1183, 1322, 1867, 1887, 1900, 1952, 2041, 2454, 3590, 3681, 3685, 3788, 3799, 3848, 3861, 3867, 3916, 3920, 4195, 4237, 4413, 4429, 4470, 4502, 4506, 4528, 4560, 4566, 4613, 4669, 4756, 4941, 5034, 5282, 5599, 5695, 5864, 5941, 6026]","[4237, 4502]","[250, 255, 282, 399, 473, 511, 690, 819, 1078, 1089, 1183, 1322, 1867, 1887, 1900, 1952, 2041, 2454, 3590, 3681, 3685, 3788, 3799, 3848, 3861, 3867, 3916, 3920, 4195, 4413, 4429, 4470, 4506, 4528, 4560, 4566, 4613, 4669, 4756, 4941, 5034, 5282, 5599, 5695, 5864, 5941, 6026]","[3668, 4237, 4502, 4814]",6254,49,6205,2,47,6203,2
2.5,MMVITRO,"[8, 14, 131, 689, 725, 738, 788, 1025, 1263, 1425, 1462, 1845, 1861, 1865, 1883, 1892, 2054, 2071, 2075, 2219, 2249, 2474, 2490, 2501, 2585, 2596, 2693, 2718, 2783, 2826, 3017, 3045, 3142, 3279, 3703, 3733, 3755, 3812, 3816, 3820, 3855, 3859, 3863, 4046, 4355, 4445, 4674, 4780, 4814, 4867, 4941, 4985, 4996]","[1845, 2054, 2474, 2693, 3017, 3279, 4355]","[8, 14, 131, 689, 725, 738, 788, 1025, 1263, 1425, 1462, 1861, 1865, 1883, 1892, 2071, 2075, 2219, 2249, 2490, 2501, 2585, 2596, 2718, 2783, 2826, 3045, 3142, 3703, 3733, 3755, 3812, 3816, 3820, 3855, 3859, 3863, 4046, 4445, 4674, 4780, 4814, 4867, 4941, 4985, 4996]","[1845, 2054, 2474, 2693, 3017, 3279, 4355]",4996,53,4943,7,46,4943,0
2.5,MMVPREB2,"[104, 172, 214, 279, 302, 323, 379, 587, 908, 930]",[379],"[104, 172, 214, 279, 302, 323, 587, 908, 930]",[379],1045,10,1035,1,9,1035,0
2.5,MMVPREB3,"[104, 172, 214, 279, 302, 323, 379, 587, 908]",[379],"[104, 172, 214, 279, 302, 323, 587, 908]",[379],1045,9,1036,1,8,1036,0
2.5,MNKEGLOBIM,"[221, 237, 271, 469, 536, 583, 599, 1054, 1060, 1166, 1184, 1190, 1196, 1214, 1264, 1409, 1414, 1420, 1465, 1521]","[237, 583]","[221, 271, 469, 536, 599, 1054, 1060, 1166, 1184, 1190, 1196, 1214, 1264, 1409, 1414, 1420, 1465, 1521]","[237, 583]",1693,20,1673,2,18,1673,0
2.5,MNKEGLOBIN,"[221, 237, 271, 469, 536, 583, 599, 1052, 1058, 1164, 1182, 1188, 1194, 1212, 1262, 1407, 1412, 1418, 1463, 1519]","[237, 583]","[221, 271, 469, 536, 599, 1052, 1058, 1164, 1182, 1188, 1194, 1212, 1262, 1407, 1412, 1418, 1463, 1519]","[237, 583]",1691,20,1671,2,18,1671,0
2.5,MNKHGBGGAG,"[75, 92, 249, 287, 297, 519, 586, 633, 702, 879, 1064, 1117, 1123, 1127, 1282, 1338, 1342, 1440, 1485, 1640]","[287, 633]","[75, 92, 249, 297, 519, 586, 702, 879, 1064, 1117, 1123, 1127, 1282, 1338, 1342, 1440, 1485, 1640]","[287, 633]",1697,20,1677,2,18,1677,0
2.5,MNPROP2,"[49, 64, 278, 338, 620]",[278],"[49, 64, 338, 620]",[278],696,5,691,1,4,691,0
2.5,MUS8HS20,"[135, 231, 257, 271, 280, 305, 329, 503, 512, 545, 617, 638, 940, 962, 1015, 1067, 1310, 1360, 1625, 1791, 2133, 2189, 2311, 2530, 2562]",[940],"[135, 231, 257, 271, 280, 305, 329, 503, 512, 545, 617, 638, 962, 1015, 1067, 1310, 1360, 1625, 1791, 2133, 2189, 2311, 2530, 2562]",[940],2622,25,2597,1,24,2597,0
2.5,MUSAP,"[34, 58, 110, 443, 499, 657, 810, 814, 931, 1012, 1076, 1202, 1423, 1815, 2291, 2551, 2617, 2656, 2686, 2766, 2774, 2845, 2850, 2868, 3019, 3186, 3190, 3236, 3245, 3264, 3359, 3381, 3398, 3438, 3574, 3815, 3844, 3950, 3962, 4034, 4064, 4160, 4256, 4345, 4509, 4515, 4528, 4539, 4740, 4780, 4927, 4946, 4971, 5092, 5211, 5230, 5290, 5369, 5529, 5547, 5619, 5670, 5709, 5716, 5796, 5952, 6013, 6067, 6071, 6234, 6346, 6406, 6494, 6525, 6538, 6554, 6610, 6709, 6929, 6986, 7072, 7174, 7201, 7229, 7233, 7471, 7890, 7894, 8019]","[3574, 3815, 4034, 4509, 4740, 4971, 5290, 5619, 5952, 6406, 6709]","[34, 58, 110, 443, 499, 657, 810, 814, 931, 1012, 1076, 1202, 1423, 1815, 2291, 2551, 2617, 2656, 2686, 2766, 2774, 2845, 2850, 2868, 3019, 3186, 3190, 3236, 3245, 3264, 3359, 3381, 3398, 3438, 3844, 3950, 3962, 4064, 4160, 4256, 4345, 4515, 4528, 4539, 4780, 4927, 4946, 5092, 5211, 5230, 5369, 5529, 5547, 5670, 5709, 5716, 5796, 6013, 6067, 6071, 6234, 6346, 6494, 6525, 6538, 6554, 6610, 6929, 6986, 7072, 7174, 7201, 7229, 7233, 7471, 7890, 7894, 8019]","[3574, 3815, 4034, 4509, 4740, 4971, 5290, 5619, 5952, 6406, 6709]",8086,89,7997,11,78,7997,0
2.5,MUSAP5A,"[41, 179, 259, 354, 551, 651, 657, 687, 697, 786, 853, 920, 958, 996, 1315, 1696, 1768, 1853, 1889, 2064, 2222, 2428, 2454, 2463, 2526, 2681, 2759, 2842, 3031, 3332, 3355, 3527, 3740, 3744, 3752, 3852, 3913, 3970, 4614, 4657, 4709, 4840, 4971, 5224, 5226, 5253, 5257, 5266, 5301, 5353, 5487, 5575, 5825, 6195, 6212, 6254, 6321, 6668, 6685, 6816]","[2428, 2759, 4614]","[41, 179, 259, 354, 551, 651, 657, 687, 697, 786, 853, 920, 958, 996, 1315, 1696, 1768, 1853, 1889, 2064, 2222, 2454, 2463, 2526, 2681, 2842, 3031, 3332, 3355, 3527, 3740, 3744, 3752, 3852, 3913, 3970, 4657, 4709, 4840, 4971, 5224, 5226, 5253, 5257, 5266, 5301, 5353, 5487, 5575, 5825, 6195, 6212, 6254, 6321, 6668, 6685, 6816]","[2428, 2759, 4614]",6821,60,6761,3,57,6761,0
2.5,MUSAPEX,"[99, 241, 300, 372, 412, 512, 604, 768, 848, 863, 1042, 1169, 1251, 1287, 1311, 1332, 1363, 1389, 1394, 1500, 1684, 1689, 1692, 1773, 1861, 1919, 1974, 2081, 2089, 2436, 2548, 2552, 2659, 2742, 2873, 2906, 2942, 3444, 3602, 3702, 3882, 4006]","[1684, 2089, 2742]","[99, 241, 300, 372, 412, 512, 604, 768, 848, 863, 1042, 1169, 1251, 1287, 1311, 1332, 1363, 1389, 1394, 1500, 1689, 1692, 1773, 1861, 1919, 1974, 2081, 2436, 2548, 2552, 2659, 2873, 2906, 2942, 3444, 3602, 3702, 3882, 4006]","[1684, 2089, 2742]",4034,42,3992,3,39,3992,0
2.5,MUSAPOAII,"[75, 112, 389, 395, 404, 474, 495, 499, 559, 575, 723, 760, 940, 956, 1155, 1404, 1543, 1562, 1618, 1772, 1887, 2016, 2168, 2309, 2327, 2361, 2433, 2459, 2611, 2621, 2907]","[723, 1155]","[75, 112, 389, 395, 404, 474, 495, 499, 559, 575, 760, 940, 956, 1404, 1543, 1562, 1618, 1772, 1887, 2016, 2168, 2309, 2327, 2361, 2433, 2459, 2611, 2621, 2907]","[723, 1155]",2952,31,2921,2,29,2921,0
2.5,MUSAPOIVA,"[27, 63, 358, 470, 529, 560, 588, 975, 1029, 1226, 1235, 1256, 1385, 1415, 1578, 1676, 1759, 2149, 2299, 2365, 2629, 2774, 2859, 2898, 2905, 2914, 2929]","[588, 975]","[27, 63, 358, 470, 529, 560, 1029, 1226, 1235, 1256, 1385, 1415, 1578, 1676, 1759, 2149, 2299, 2365, 2629, 2774, 2859, 2898, 2905, 2914, 2929]","[588, 975]",3012,27,2985,2,25,2985,0
2.5,MUSBMP4,"[221, 336, 441, 510, 660, 664, 768, 884, 944, 1064, 1068, 1080, 1116, 1847, 2001, 2008, 2095, 2149, 2196, 2413, 2434, 2473, 2683, 2728, 2820, 2888, 2960, 3208, 3212, 3281, 3307, 3546, 3634, 3641, 3697, 3791, 3806, 3967, 4135, 4160, 4198, 4310, 4377, 4437, 4471, 4495, 4546, 4594, 4793, 4806, 5026, 5132, 5143, 5261, 5289, 5427, 5497, 5525, 5725, 5890, 5988, 6363, 6380, 6626, 6645, 6816, 7157, 7179, 7212, 7237, 7244, 7382, 7409, 7748, 7914, 7951, 8211, 8267, 8306, 8446, 8462, 8525, 8768, 8984, 9429, 9626]",[7179],"[221, 336, 441, 510, 660, 664, 768, 884, 944, 1064, 1068, 1080, 1116, 1847, 2001, 2008, 2095, 2149, 2196, 2413, 2434, 2473, 2683, 2728, 2820, 2888, 2960, 3208, 3212, 3281, 3307, 3546, 3634, 3641, 3697, 3791, 3806, 3967, 4135, 4160, 4198, 4310, 4377, 4437, 4471, 4495, 4546, 4594, 4793, 4806, 5026, 5132, 5143, 5261, 5289, 5427, 5497, 5525, 5725, 5890, 5988, 6363, 6380, 6626, 6645, 6816, 7157, 7212, 7237, 7244, 7382, 7409, 7748, 7914, 7951, 8211, 8267, 8306, 8446, 8462, 8525, 8768, 8984, 9429, 9626]",[7179],9660,86,9574,1,85,9574,0
2.5,MUSBNP,"[79, 225, 336, 412, 488, 680, 731, 753, 903, 1057, 1127, 1449]","[336, 753]","[79, 225, 412, 488, 680, 731, 903, 1057, 1127, 1449]","[336, 753]",1460,12,1448,2,10,1448,0
2.5,MUSCD14A,"[14, 176, 434, 543, 639, 777, 1002, 1122, 1212, 1454, 1485, 1489]",[176],"[14, 434, 543, 639, 777, 1002, 1122, 1212, 1454, 1485, 1489]",[176],1865,12,1853,1,11,1853,0
2.5,MUSCRKNB,"[96, 460, 668, 815, 917, 1219, 1440, 1493, 1807, 1824, 1904, 1989, 2058, 2110, 2245, 2364, 2455, 2466, 2658, 2796, 2829, 2879, 2951, 3056, 3192, 3406, 3505, 3599, 3805, 3842, 3862, 3876, 3925, 3949, 4066, 4356]","[1904, 2245, 2455, 2796, 3505, 3842]","[96, 460, 668, 815, 917, 1219, 1440, 1493, 1807, 1824, 1989, 2058, 2110, 2364, 2466, 2658, 2829, 2879, 2951, 3056, 3192, 3406, 3599, 3805, 3862, 3876, 3925, 3949, 4066, 4356]","[1904, 2245, 2455, 2796, 3505, 3842]",4513,36,4477,6,30,4477,0
2.5,MUSCYTCOVB,"[48, 182, 412, 479, 724, 774, 778, 928, 935, 1064, 1081, 1319, 1585, 1679, 1717, 1743, 1808, 1925, 1946, 2066, 2105, 2168, 2234, 2371]","[724, 1319, 1585]","[48, 182, 412, 479, 774, 778, 928, 935, 1064, 1081, 1679, 1717, 1743, 1808, 1925, 1946, 2066, 2105, 2168, 2234, 2371]","[724, 1319, 1585]",2532,24,2508,3,21,2508,0
2.5,MUSENDOBA,"[59, 135, 299, 333, 382, 391, 486, 737, 807, 923, 1066, 1276, 1500, 1507, 1701, 2117, 2130, 2462, 2614, 2743, 2929, 3027, 3115, 3148, 3170, 3222, 3282, 3350, 3618, 3675, 3707, 3816, 3892, 4049, 4342, 4346, 4371, 4405, 4430, 4698, 4795, 4837, 4853, 4898, 4920, 5090, 5527, 5589, 5596, 5616, 5660, 5672, 5696, 5700, 5721, 5817, 5969, 6230, 6258, 6301, 6319, 6358, 6443, 6506, 6929, 6980, 6992, 7007, 7151, 7454, 7548, 7585, 7624, 7841]","[2743, 3618, 4049, 4853, 5090, 5589]","[59, 135, 299, 333, 382, 391, 486, 737, 807, 923, 1066, 1276, 1500, 1507, 1701, 2117, 2130, 2462, 2614, 2929, 3027, 3115, 3148, 3170, 3222, 3282, 3350, 3675, 3707, 3816, 3892, 4342, 4346, 4371, 4405, 4430, 4698, 4795, 4837, 4898, 4920, 5527, 5596, 5616, 5660, 5672, 5696, 5700, 5721, 5817, 5969, 6230, 6258, 6301, 6319, 6358, 6443, 6506, 6929, 6980, 6992, 7007, 7151, 7454, 7548, 7585, 7624, 7841]","[2743, 3618, 4049, 4853, 5090, 5589]",7871,74,7797,6,68,7797,0
2.5,MUSFAUA,"[140, 506, 544, 760, 783, 790, 846, 854, 898, 925, 961, 988, 1105, 1216, 1249, 1253, 1496, 1530, 1535, 1645, 1799, 1818, 2068, 2103, 2110, 2124, 2169, 2220, 2275, 2467, 2650, 2773, 2824]","[1249, 1496, 2124]","[140, 506, 544, 760, 783, 790, 846, 854, 898, 925, 961, 988, 1105, 1216, 1253, 1530, 1535, 1645, 1799, 1818, 2068, 2103, 2110, 2169, 2220, 2275, 2467, 2650, 2773, 2824]","[1249, 1496, 2124]",2842,33,2809,3,30,2809,0
2.5,MUSFERHC,"[263, 393, 483, 526, 713, 910, 1103, 1107, 1184, 1417, 1558, 1597, 1634, 1661, 1827, 1860, 1944, 2000, 2185, 2200, 2319, 2341, 2349, 2428, 2462, 2586]","[483, 1827, 2185]","[263, 393, 526, 713, 910, 1103, 1107, 1184, 1417, 1558, 1597, 1634, 1661, 1860, 1944, 2000, 2200, 2319, 2341, 2349, 2428, 2462, 2586]","[483, 1827, 2185]",2782,26,2756,3,23,2756,0
2.5,MUSFKBP13X,"[14, 130, 321, 550, 736, 764, 904, 928, 1070, 1078, 1247, 1282, 1358, 1381, 1556]","[321, 736, 904, 1282]","[14, 130, 550, 764, 928, 1070, 1078, 1247, 1358, 1381, 1556]","[321, 736, 904, 1282]",1573,15,1558,4,11,1558,0
2.5,MUSGAD45,"[85, 559, 807, 935, 1034, 1091, 1099, 1126, 1187, 1236, 1309, 1347, 1360, 1452, 1458, 1542, 1563, 1595, 1755, 1898, 2139, 2170, 2442, 2472, 2647, 2865, 3023]","[935, 1126, 1458]","[85, 559, 807, 1034, 1091, 1099, 1187, 1236, 1309, 1347, 1360, 1452, 1542, 1563, 1595, 1755, 1898, 2139, 2170, 2442, 2472, 2647, 2865, 3023]","[935, 1126, 1458]",3092,27,3065,3,24,3065,0
2.5,MUSGFJE,"[378, 624, 704, 709, 910, 1098, 1194, 1323, 1468, 1489, 1839, 1968, 2167, 2217, 2249, 2275]","[624, 1489]","[378, 704, 709, 910, 1098, 1194, 1323, 1468, 1839, 1968, 2167, 2217, 2249, 2275]","[624, 1489]",2403,16,2387,2,14,2387,0
2.5,MUSGPOAD,"[349, 357, 416, 430, 437, 461, 890, 1044, 1048, 1169, 1324, 1328, 1715, 1737, 2306, 2538, 2898, 3004, 3046, 3337, 3408, 3442, 4023, 4168, 4403, 4505, 4816, 4881, 4916, 4996, 5083, 5245, 5250, 5328, 5342, 5400, 5647, 5719, 5826, 5859, 5944, 6149, 6515, 6573, 6779, 6803, 7258, 7403, 7632, 7850, 7902, 7929, 7980, 7998]","[1044, 2306, 4403, 4916]","[349, 357, 416, 430, 437, 461, 890, 1048, 1169, 1324, 1328, 1715, 1737, 2538, 2898, 3004, 3046, 3337, 3408, 3442, 4023, 4168, 4505, 4816, 4881, 4996, 5083, 5245, 5250, 5328, 5342, 5400, 5647, 5719, 5826, 5859, 5944, 6149, 6515, 6573, 6779, 6803, 7258, 7403, 7632, 7850, 7902, 7929, 7980, 7998]","[1044, 2306, 4403, 4916]",8068,54,8014,4,50,8014,0
2.5,MUSHBBH0,"[163, 184, 365, 370, 651, 914, 1012, 1112, 1265, 1487, 1566, 1772, 1783, 1884, 2081]","[365, 914]","[163, 184, 370, 651, 1012, 1112, 1265, 1487, 1566, 1772, 1783, 1884, 2081]","[365, 914]",2127,15,2112,2,13,2112,0
2.5,MUSHBBH1,"[97, 249, 270, 451, 733, 780, 975, 1062, 1417, 1493, 1651, 1675, 1707, 1902]","[451, 780]","[97, 249, 270, 733, 975, 1062, 1417, 1493, 1651, 1675, 1707, 1902]","[451, 780]",1918,14,1904,2,12,1904,0
2.5,MUSHES1,"[76, 355, 385, 556, 784, 788, 1108, 1121, 1159, 1189, 1323, 1351, 1367, 1400, 1406, 1488, 1671, 1698, 1797, 1819, 1839, 2208, 2308, 2699]","[556, 784, 1108]","[76, 355, 385, 788, 1121, 1159, 1189, 1323, 1351, 1367, 1400, 1406, 1488, 1671, 1698, 1797, 1819, 1839, 2208, 2308, 2699]","[556, 784, 1108]",2817,24,2793,3,21,2793,0
2.5,MUSHOX35A,"[48, 232, 281, 597, 612, 747, 773, 1062, 1308, 1462, 1535, 1715, 1721, 2007, 2012, 2372, 2512, 2531, 2577, 2661, 2850, 3045, 3119, 3150, 3209, 3231, 3248, 3398, 3440, 3464, 3519, 3524, 3545]",[1308],"[48, 232, 281, 597, 612, 747, 773, 1062, 1462, 1535, 1715, 1721, 2007, 2012, 2372, 2512, 2531, 2577, 2661, 2850, 3045, 3119, 3150, 3209, 3231, 3248, 3398, 3440, 3464, 3519, 3524, 3545]",[1308],3847,33,3814,1,32,3814,0
2.5,MUSIL1RN,"[168, 309, 512, 626, 632, 652, 656, 660, 691, 709, 713, 886, 1093, 1154, 1445, 1676, 1736, 1922, 2186, 2224, 2289, 2328, 2451, 2483, 2552, 2789, 2836, 2940, 3076, 3116, 3147, 3196, 3215, 3549, 3808, 3883, 3938, 4482, 4744, 4785, 5269, 5875, 5968, 6210]","[512, 2483, 3549]","[168, 309, 626, 632, 652, 656, 660, 691, 709, 713, 886, 1093, 1154, 1445, 1676, 1736, 1922, 2186, 2224, 2289, 2328, 2451, 2552, 2789, 2836, 2940, 3076, 3116, 3147, 3196, 3215, 3808, 3883, 3938, 4482, 4744, 4785, 5269, 5875, 5968, 6210]","[512, 2483, 3549]",6342,44,6298,3,41,6298,0
2.5,MUSKE3A,"[21, 340, 349, 365, 406, 411, 544, 657, 788, 840, 976, 981, 1002, 1009, 1032, 1088, 1098, 1215, 1222, 1227, 1328, 1377, 1402, 1410, 1545, 1562, 1569, 1604, 1620, 1645, 1881, 1948, 2052, 2194, 2659, 2665, 2794, 2960, 3116, 3218, 3339, 3400, 3405, 3409, 3515, 3553]","[21, 544, 3218, 3400]","[340, 349, 365, 406, 411, 657, 788, 840, 976, 981, 1002, 1009, 1032, 1088, 1098, 1215, 1222, 1227, 1328, 1377, 1402, 1410, 1545, 1562, 1569, 1604, 1620, 1645, 1881, 1948, 2052, 2194, 2659, 2665, 2794, 2960, 3116, 3339, 3405, 3409, 3515, 3553]","[21, 544, 3218, 3400]",3612,46,3566,4,42,3566,0
2.5,MUSLMP7A,"[287, 429, 487, 535, 903, 1082, 1107, 1193, 1218, 1318, 1327, 1354, 1364, 1407, 1570, 1876, 1978, 2033, 2153, 2157, 2269, 2293, 2297, 2454, 2838, 3029, 3046, 3178, 3559, 3674, 3795, 3959, 3964, 3985, 4005]","[1318, 2153, 2454, 3029, 3674]","[287, 429, 487, 535, 903, 1082, 1107, 1193, 1218, 1327, 1354, 1364, 1407, 1570, 1876, 1978, 2033, 2157, 2269, 2293, 2297, 2838, 3046, 3178, 3559, 3795, 3959, 3964, 3985, 4005]","[1318, 2153, 2454, 3029, 3674]",4259,35,4224,5,30,4224,0
2.5,MUSLTA,"[177, 382, 530, 830, 1207, 1245, 1632, 1637, 1807, 1990, 2114, 2217, 2496, 2500, 2537, 3073, 3077, 3164]","[1807, 1990]","[177, 382, 530, 830, 1207, 1245, 1632, 1637, 2114, 2217, 2496, 2500, 2537, 3073, 3077, 3164]","[1807, 1990]",3286,18,3268,2,16,3268,0
2.5,MUSMC26,"[155, 316, 539, 634, 646, 687, 816, 843, 1581, 1589, 1884, 1906, 2028, 2071, 2419, 2475, 3046, 3075, 3190, 3331, 3415, 3442, 3666, 3682, 3716, 3870, 3964, 3982, 4144, 4182, 4322, 4429, 4663, 4669, 5306]","[2419, 3190, 4144]","[155, 316, 539, 634, 646, 687, 816, 843, 1581, 1589, 1884, 1906, 2028, 2071, 2475, 3046, 3075, 3331, 3415, 3442, 3666, 3682, 3716, 3870, 3964, 3982, 4182, 4322, 4429, 4663, 4669, 5306]","[2419, 3190, 4144]",5386,35,5351,3,32,5351,0
2.5,MUSOGC,"[113, 142, 290, 460, 489, 522, 631, 742, 779, 814, 920]","[113, 290, 489]","[142, 460, 522, 631, 742, 779, 814, 920]","[113, 290, 489]",941,11,930,3,8,930,0
2.5,MUSOGCA,"[152, 214, 285, 356, 367, 464, 479, 513, 725, 866, 895, 1043, 1213, 1242, 1275, 1495, 1532, 1567, 1673]","[866, 1043, 1242]","[152, 214, 285, 356, 367, 464, 479, 513, 725, 895, 1213, 1275, 1495, 1532, 1567, 1673]","[866, 1043, 1242]",1694,19,1675,3,16,1675,0
2.5,MUSOGCB,"[113, 142, 290, 461, 490, 523, 632, 743, 780, 815, 921]","[113, 290, 490]","[142, 461, 523, 632, 743, 780, 815, 921]","[113, 290, 490]",942,11,931,3,8,931,0
2.5,MUSPNMT,"[85, 104, 148, 171, 276, 547, 694, 947, 955, 986, 1076, 1106, 1123, 1221, 1523, 1665, 1713, 1881, 1920, 2135, 2343, 2372, 2450, 2491, 2599, 2703, 2755, 2884, 2890, 2892, 2914, 3115, 3124]","[1665, 2343]","[85, 104, 148, 171, 276, 547, 694, 947, 955, 986, 1076, 1106, 1123, 1221, 1523, 1713, 1881, 1920, 2135, 2372, 2450, 2491, 2599, 2703, 2755, 2884, 2890, 2892, 2914, 3115, 3124]","[1665, 2343]",3136,33,3103,2,31,3103,0
2.5,MUSPROTA,"[124, 337, 421, 433, 581, 585, 660, 697, 945, 1173, 1213, 1250, 1945, 2011, 2033, 2069, 2278, 2328, 2530, 2585, 2604, 2791, 3119, 3224, 3555, 3621, 3663, 4024, 4105, 4600]","[1945, 2585, 3224, 3663]","[124, 337, 421, 433, 581, 585, 660, 697, 945, 1173, 1213, 1250, 2011, 2033, 2069, 2278, 2328, 2530, 2604, 2791, 3119, 3555, 3621, 4024, 4105, 4600]","[1945, 2585, 3224, 3663]",4636,30,4606,4,26,4606,0
2.5,MUSPROTEB,"[337, 398, 496, 561, 594, 634, 647, 749, 765, 803, 962, 993, 1015, 1024, 1221, 1482, 1553, 1645, 1682, 1726, 1856, 1920, 1988, 2090, 2130]","[337, 594, 993, 1988]","[398, 496, 561, 634, 647, 749, 765, 803, 962, 1015, 1024, 1221, 1482, 1553, 1645, 1682, 1726, 1856, 1920, 2090, 2130]","[337, 594, 993, 1988]",2389,25,2364,4,21,2364,0
2.5,MUSPRPC2,"[165, 381, 652, 795, 801, 817, 1279, 1996, 2057, 2455, 2470, 2687, 2740, 2919, 3008, 3019, 3141, 3531, 3650, 3778, 3833, 4083, 4087, 4186, 5314, 5493, 6159, 6607, 6793, 6797, 6869, 6877, 6929, 7077, 7232]",[801],"[165, 381, 652, 795, 817, 1279, 1996, 2057, 2455, 2470, 2687, 2740, 2919, 3008, 3019, 3141, 3531, 3650, 3778, 3833, 4083, 4087, 4186, 5314, 5493, 6159, 6607, 6793, 6797, 6869, 6877, 6929, 7077, 7232]",[801],7298,35,7263,1,34,7263,0
2.5,MUSPRPMPB,"[120, 651, 795, 801, 817, 1230, 1480, 1839, 2952, 2974]",[801],"[120, 651, 795, 817, 1230, 1480, 1839, 2952, 2974]",[801],3566,10,3556,1,9,3556,0
2.5,MUSREGI,"[325, 632, 775, 809, 892, 1012, 1159, 1258, 1316, 1458, 1558, 1799, 1807, 1965, 2230, 2234, 2304, 2388, 2450, 2497, 2611, 2646, 2903, 2993, 3368, 3550, 3667, 3707]","[1159, 1799, 2230, 2993]","[325, 632, 775, 809, 892, 1012, 1258, 1316, 1458, 1558, 1807, 1965, 2234, 2304, 2388, 2450, 2497, 2611, 2646, 2903, 3368, 3550, 3667, 3707]","[1159, 1799, 2230, 2993]",3748,28,3720,4,24,3720,0
2.5,MUSREGII,"[530, 927, 1012, 1141, 1239, 1298, 1491, 1626, 1657, 1988, 2023, 2142, 2522, 2526, 2543, 2554, 2927, 3091, 3233, 3308, 3463, 3680]","[927, 1626, 1988, 3091]","[530, 1012, 1141, 1239, 1298, 1491, 1657, 2023, 2142, 2522, 2526, 2543, 2554, 2927, 3233, 3308, 3463, 3680]","[927, 1626, 1988, 3091]",3924,22,3902,4,18,3902,0
2.5,MUSROM1X,"[39, 110, 115, 219, 661, 742, 781, 967, 983, 1030, 1096, 1146, 1194, 1242, 1307, 1848, 1961, 2038, 2169, 2302, 2529, 2555, 2616, 2640, 2649]","[1242, 1848]","[39, 110, 115, 219, 661, 742, 781, 967, 983, 1030, 1096, 1146, 1194, 1307, 1961, 2038, 2169, 2302, 2529, 2555, 2616, 2640, 2649]","[1242, 1848]",2779,25,2754,2,23,2754,0
2.5,MUSRPL30,"[18, 84, 500, 504, 660, 960, 1050, 1209, 1331, 1337, 1430, 1505, 1622, 1679, 1816, 1948, 2291, 2431, 2459, 2654, 2709, 2829, 2891, 2941, 3019, 3085, 3124, 3243, 3441]","[660, 1050, 2459]","[18, 84, 500, 504, 960, 1209, 1331, 1337, 1430, 1505, 1622, 1679, 1816, 1948, 2291, 2431, 2654, 2709, 2829, 2891, 2941, 3019, 3085, 3124, 3243, 3441]","[660, 1050, 2459]",3468,29,3439,3,26,3439,0
2.5,MUSRPS16,"[17, 268, 373, 475, 481, 512, 636, 714, 758, 829, 944, 1210, 1311, 1352, 1491, 1667, 1673, 1728, 1814, 1868, 1896, 2005, 2009, 2038, 2050, 2355]","[1868, 2005]","[17, 268, 373, 475, 481, 512, 636, 714, 758, 829, 944, 1210, 1311, 1352, 1491, 1667, 1673, 1728, 1814, 1896, 2009, 2038, 2050, 2355]","[450, 687, 1868, 2005]",2641,26,2615,2,24,2613,2
2.5,MUSS100B,"[133, 213, 289, 342, 430, 741, 880, 951, 1034, 1097, 1423, 1514, 1534, 1710, 1721, 1778, 2041, 2162, 2287, 2692, 2757, 3025, 3151, 3160, 3508, 3660, 3709, 3997, 4309, 4373, 4377, 4387, 4611, 4641, 4672, 4849, 4920, 5082, 5104, 5219, 5309, 5321, 5323, 5329, 5444, 5786, 6011, 6291, 6295, 6425, 6438, 6653, 6694, 6880, 6965, 7045, 7588, 7766, 7801, 8033, 8061, 8146, 8180, 8200, 8612, 8671, 8736]",[4920],"[133, 213, 289, 342, 430, 741, 880, 951, 1034, 1097, 1423, 1514, 1534, 1710, 1721, 1778, 2041, 2162, 2287, 2692, 2757, 3025, 3151, 3160, 3508, 3660, 3709, 3997, 4309, 4373, 4377, 4387, 4611, 4641, 4672, 4849, 5082, 5104, 5219, 5309, 5321, 5323, 5329, 5444, 5786, 6011, 6291, 6295, 6425, 6438, 6653, 6694, 6880, 6965, 7045, 7588, 7766, 7801, 8033, 8061, 8146, 8180, 8200, 8612, 8671, 8736]",[4920],8865,67,8798,1,66,8798,0
2.5,MUSSERPROA,"[217, 1034, 1449, 1572, 1780, 1831, 1836, 2032, 2037, 2092, 2114, 2253, 2332, 2341, 2739, 3101, 3136, 3178, 3345, 3371, 3387, 3575, 3721, 3997, 4039]","[1449, 2092, 2739, 3178]","[217, 1034, 1572, 1780, 1831, 1836, 2032, 2037, 2114, 2253, 2332, 2341, 3101, 3136, 3345, 3371, 3387, 3575, 3721, 3997, 4039]","[1449, 2092, 2739, 3178]",4449,25,4424,4,21,4424,0
2.5,MUSSSATGN,"[29, 122, 491, 613, 729, 742, 840, 844, 976, 1162, 1346, 1774, 1825, 1857, 2081, 2102, 2165, 2190, 2353, 2487, 2516, 2905, 2929, 3039, 3115, 3185, 3199, 3233, 3241, 3294, 3354, 3436, 3590, 3612, 3706, 3740, 3892, 3898]","[840, 1162, 1346, 2905, 3039]","[29, 122, 491, 613, 729, 742, 844, 976, 1774, 1825, 1857, 2081, 2102, 2165, 2190, 2353, 2487, 2516, 2929, 3115, 3185, 3199, 3233, 3241, 3294, 3354, 3436, 3590, 3612, 3706, 3740, 3892, 3898]","[840, 1162, 1346, 2905, 3039]",4058,38,4020,5,33,4020,0
2.5,MUSTCP,"[6, 224, 364, 453, 470, 518, 624, 654, 908, 933, 1005, 1132, 1218, 1274, 1329, 1486, 1705, 1779, 1802, 1912, 1940, 1993, 2146, 2164, 2271, 2427, 2463, 2496, 2781, 3172, 3270, 3474, 3576, 3599, 3642, 3916, 4000, 4019, 4101, 4278, 4687, 4954, 5303, 5681, 6098, 6296, 6313, 6337, 6552, 6567, 7134, 7171, 7177, 7230, 7255, 7274, 7300, 7512, 7562, 7780, 7901, 8154, 8327, 8459]","[453, 1705, 1993, 3270, 4278, 4687, 6098, 6552, 7230, 7512]","[6, 224, 364, 470, 518, 624, 654, 908, 933, 1005, 1132, 1218, 1274, 1329, 1486, 1779, 1802, 1912, 1940, 2146, 2164, 2271, 2427, 2463, 2496, 2781, 3172, 3474, 3576, 3599, 3642, 3916, 4000, 4019, 4101, 4954, 5303, 5681, 6296, 6313, 6337, 6567, 7134, 7171, 7177, 7255, 7274, 7300, 7562, 7780, 7901, 8154, 8327, 8459]","[453, 1705, 1993, 3270, 3746, 4278, 4687, 6098, 6552, 7230, 7512]",9253,64,9189,10,54,9188,1
2.5,MUSTHY1,"[80, 93, 183, 191, 335, 616, 629, 678, 696, 720, 854, 946, 1009, 1156, 1281, 1586, 1828, 1833, 1837, 1943, 2174, 2181, 2477]","[80, 1009]","[93, 183, 191, 335, 616, 629, 678, 696, 720, 854, 946, 1156, 1281, 1586, 1828, 1833, 1837, 1943, 2174, 2181, 2477]","[80, 1009]",2682,23,2659,2,21,2659,0
2.5,MUSTLAG,"[42, 99, 153, 261, 269, 547, 705, 856, 901, 946, 1155, 1265, 1314, 1319, 1327, 1332, 1463, 1492, 1573, 1733, 1790, 2128, 2250, 2571, 3145, 3260, 3276, 3494, 3560, 3641, 3740, 3869, 4032, 4237, 4788, 5009, 5069, 5110, 5192, 5201, 5248, 5310]","[705, 1155, 1573, 3494, 3740]","[42, 99, 153, 261, 269, 547, 856, 901, 946, 1265, 1314, 1319, 1327, 1332, 1463, 1492, 1733, 1790, 2128, 2250, 2571, 3145, 3260, 3276, 3560, 3641, 3869, 4032, 4237, 4788, 5009, 5069, 5110, 5192, 5201, 5248, 5310]","[705, 1155, 1573, 3494, 3740]",5412,42,5370,5,37,5370,0
2.5,MUSTSHBA2,"[69, 186, 388, 464, 599, 629, 777, 830, 1045, 1255]",[464],"[69, 186, 388, 599, 629, 777, 830, 1045, 1255]",[464],1283,10,1273,1,9,1273,0
2.5,MUSY1GLOB,"[137, 288, 334, 354, 361, 377, 395, 576, 690, 808, 813, 829, 1024, 1066, 1224, 1249, 1341, 1445, 1456, 1557, 1681]","[377, 690]","[137, 288, 334, 354, 361, 395, 576, 808, 813, 829, 1024, 1066, 1224, 1249, 1341, 1445, 1456, 1557, 1681]","[377, 690]",1745,21,1724,2,19,1724,0
2.5,OABBGLOB,"[33, 192, 525, 666, 692, 920, 958, 1174, 1195, 1262, 1309, 1413, 1868, 1987, 2267, 2291, 2701, 3128, 3229]","[958, 1309]","[33, 192, 525, 666, 692, 920, 1174, 1195, 1262, 1413, 1868, 1987, 2267, 2291, 2701, 3128, 3229]","[958, 1309]",3241,19,3222,2,17,3222,0
2.5,OABCGLOB,"[33, 193, 433, 673, 699, 919, 957, 1011, 1177, 1198, 1265, 1312, 1352, 1413, 1603, 1708, 1879, 1998, 2239, 2249, 2648, 2984, 3079, 3180]","[957, 1312]","[33, 193, 433, 673, 699, 919, 1011, 1177, 1198, 1265, 1352, 1413, 1603, 1708, 1879, 1998, 2239, 2249, 2648, 2984, 3079, 3180]","[957, 1312]",3192,24,3168,2,22,3168,0
2.5,OAINIGFII1,"[60, 150, 266, 676, 724, 740, 1022, 1098, 1165, 1551, 1588, 1671, 1679, 1698, 1752, 1975, 2057, 2106, 2199, 2309, 2335, 2382]",[740],"[60, 150, 266, 676, 724, 1022, 1098, 1165, 1551, 1588, 1671, 1679, 1698, 1752, 1975, 2057, 2106, 2199, 2309, 2335, 2382]",[740],2385,22,2363,1,21,2363,0
2.5,OAINTL3,"[115, 134, 674, 721, 813, 850, 948, 1310, 1598, 1602, 1747, 1764, 1909, 2072, 2099, 2565, 2595, 2670, 2704]","[674, 813, 1909, 2072]","[115, 134, 721, 850, 948, 1310, 1598, 1602, 1747, 1764, 2099, 2565, 2595, 2670, 2704]","[674, 813, 1909, 2072]",2793,19,2774,4,15,2774,0
2.5,OAKRT213,"[50, 144, 523, 554, 932, 975, 1088, 1179, 1206, 1215, 1228, 1253, 1260, 1290, 1294, 1328, 1593, 1635, 1714, 1988, 1992, 2176, 2294, 2641, 2665, 2852, 3029, 3071, 3132, 3198, 3241, 3255, 3333, 3357, 3829, 3841, 3915, 3938, 4124, 4147, 4213, 4467, 4642, 4690, 4752, 4813, 5046, 5210, 5249, 5258, 5278, 5288, 5371, 5377, 5487, 5584, 5671, 5684, 5789, 5815, 5950, 6077, 6221, 6474, 6548, 6552, 6914, 7052, 7061, 7076, 7268, 7283, 7287, 7389, 7393, 7427, 7455, 7660, 7752, 7896, 7911, 7913, 7937, 8453, 8457, 8482, 8487, 8502, 8709, 8931, 9063, 9083, 9294, 9316, 9417, 9454]","[3198, 4147, 4813, 5288, 5684, 6077, 6548, 7393]","[50, 144, 523, 554, 932, 975, 1088, 1179, 1206, 1215, 1228, 1253, 1260, 1290, 1294, 1328, 1593, 1635, 1714, 1988, 1992, 2176, 2294, 2641, 2665, 2852, 3029, 3071, 3132, 3241, 3255, 3333, 3357, 3829, 3841, 3915, 3938, 4124, 4213, 4467, 4642, 4690, 4752, 5046, 5210, 5249, 5258, 5278, 5371, 5377, 5487, 5584, 5671, 5789, 5815, 5950, 6221, 6474, 6552, 6914, 7052, 7061, 7076, 7268, 7283, 7287, 7389, 7427, 7455, 7660, 7752, 7896, 7911, 7913, 7937, 8453, 8457, 8482, 8487, 8502, 8709, 8931, 9063, 9083, 9294, 9316, 9417, 9454]","[3198, 4147, 4813, 5288, 5684, 6077, 6548, 7393]",9521,96,9425,8,88,9425,0
2.5,OALGB,"[46, 76, 109, 123, 130, 288, 374, 378, 702, 955, 959, 1216, 1324, 1422, 1459, 1602, 1682, 1742, 1801, 1859, 2043, 2432, 2438, 2660, 2762, 2873, 2939, 2994, 3330, 3336, 3500, 3557, 3623, 3667, 3883, 3943, 3980, 4047, 4092, 4204, 4250, 4387, 4477, 4656, 4724, 4761, 4886, 4900, 4911, 4954, 4967, 5008, 5079, 5143, 5156, 5244, 5514, 5825, 5895, 6149, 6242, 6422, 6494, 6617, 6672, 7176, 7320]","[1742, 2660, 3883, 4656]","[46, 76, 109, 123, 130, 288, 374, 378, 702, 955, 959, 1216, 1324, 1422, 1459, 1602, 1682, 1801, 1859, 2043, 2432, 2438, 2762, 2873, 2939, 2994, 3330, 3336, 3500, 3557, 3623, 3667, 3943, 3980, 4047, 4092, 4204, 4250, 4387, 4477, 4724, 4761, 4886, 4900, 4911, 4954, 4967, 5008, 5079, 5143, 5156, 5244, 5514, 5825, 5895, 6149, 6242, 6422, 6494, 6617, 6672, 7176, 7320]","[938, 1742, 2660, 3883, 4656]",7371,67,7304,4,63,7303,1
2.5,OAMETIAG,"[9, 91, 142, 205, 246, 416, 438, 510, 528, 569, 701, 746, 920, 953, 969, 1067, 1136, 1479, 1674, 1682, 2118, 2480, 2654, 2726]","[701, 1479]","[9, 91, 142, 205, 246, 416, 438, 510, 528, 569, 746, 920, 953, 969, 1067, 1136, 1674, 1682, 2118, 2480, 2654, 2726]","[701, 1479]",2792,24,2768,2,22,2768,0
2.5,OAMTIB,"[258, 338, 368, 444, 484, 516, 731, 789, 993, 1209, 1721, 1922, 2041, 2110, 2170, 2185, 2301, 2554, 2618, 2764, 2983, 3016, 3092, 3175, 3205]",[1721],"[258, 338, 368, 444, 484, 516, 731, 789, 993, 1209, 1922, 2041, 2110, 2170, 2185, 2301, 2554, 2618, 2764, 2983, 3016, 3092, 3175, 3205]","[965, 1721]",3211,25,3186,1,24,3185,1
2.5,OAMTIC,"[65, 162, 214, 381, 545, 621, 707, 1010, 1059, 1084, 1295, 1332, 1336, 1376, 1387, 1607, 1771, 1787, 1859, 2055]","[621, 1295]","[65, 162, 214, 381, 545, 707, 1010, 1059, 1084, 1332, 1336, 1376, 1387, 1607, 1771, 1787, 1859, 2055]","[621, 1295]",2375,20,2355,2,18,2355,0
2.5,OAMTII,"[38, 326, 435, 572, 799, 836, 1023, 1133, 1312, 1325, 1358, 1378, 1588, 1976]","[1023, 1378]","[38, 326, 435, 572, 799, 836, 1133, 1312, 1325, 1358, 1588, 1976]","[1023, 1378]",2047,14,2033,2,12,2033,0
2.5,OAPROTP1,"[7, 212, 253]",[212],"[7, 253]",[212],524,3,521,1,2,521,0
2.5,OATRICH,"[146, 152, 398, 938, 966, 1009, 1053, 1174, 1179, 1183, 1197, 1215, 1425, 1471, 1568, 1798, 2017, 2201, 2328, 2661, 2892, 3157, 3240, 3309, 3909, 4055, 4062, 4096, 4101, 4211, 4464, 4631, 4744, 4772, 4947, 5498, 5721, 5825, 5936, 6075, 6254, 6612, 6681, 6750, 7050, 7119, 7209, 7368, 7437, 7506, 7575, 9111]",[3157],"[146, 152, 398, 938, 966, 1009, 1053, 1174, 1179, 1183, 1197, 1215, 1425, 1471, 1568, 1798, 2017, 2201, 2328, 2661, 2892, 3240, 3309, 3909, 4055, 4062, 4096, 4101, 4211, 4464, 4631, 4744, 4772, 4947, 5498, 5721, 5825, 5936, 6075, 6254, 6612, 6681, 6750, 7050, 7119, 7209, 7368, 7437, 7506, 7575, 9111]",[3157],9336,52,9284,1,51,9284,0
2.5,OCAPOAIG,"[60, 361, 553, 557, 777, 855, 1152, 1159, 1216, 1239, 1248, 1275, 1467, 1524, 1798, 1916, 1921]","[553, 855]","[60, 361, 557, 777, 1152, 1159, 1216, 1239, 1248, 1275, 1467, 1524, 1798, 1916, 1921]","[553, 855]",1986,17,1969,2,15,1969,0
2.5,OCTNFBETA,"[68, 202, 245, 390, 577, 609, 766, 1247, 1637]","[577, 766]","[68, 202, 245, 390, 609, 1247, 1637]","[577, 766]",1963,9,1954,2,7,1954,0
2.5,OCUTGLOB,"[315, 852, 927, 932, 953, 963, 974, 1279, 1336, 1576, 1708, 1736, 1821, 2016, 2050, 2057, 2144, 2158, 2162, 2281, 2469, 2566, 2572, 2588, 2680, 2700, 2984, 3077, 3155, 3172, 3357, 3424, 3496, 3634, 3653, 4176, 4265, 4295, 4315, 4404, 4529, 4651, 4872, 4900, 4912, 5000, 5062, 5072, 5138, 5207, 5230, 5317, 5831, 6183]","[3357, 5831]","[315, 852, 927, 932, 953, 963, 974, 1279, 1336, 1576, 1708, 1736, 1821, 2016, 2050, 2057, 2144, 2158, 2162, 2281, 2469, 2566, 2572, 2588, 2680, 2700, 2984, 3077, 3155, 3172, 3424, 3496, 3634, 3653, 4176, 4265, 4295, 4315, 4404, 4529, 4651, 4872, 4900, 4912, 5000, 5062, 5072, 5138, 5207, 5230, 5317, 6183]","[3357, 5831]",6560,54,6506,2,52,6506,0
2.5,OOGH,"[13, 36, 127, 200, 333, 375, 635, 638, 740, 768, 849, 881, 890, 914, 946, 950, 1084, 1219, 1475, 1552, 2002, 2065, 2089]","[333, 740, 1084, 1475]","[13, 36, 127, 200, 375, 635, 638, 768, 849, 881, 890, 914, 946, 950, 1219, 1552, 2002, 2065, 2089]","[333, 740, 1084, 1475]",2154,23,2131,4,19,2131,0
2.5,OPOP1,"[33, 249, 377, 546]",[249],"[33, 377, 546]",[249],616,4,612,1,3,612,0
2.5,ORAPROTP1A,"[7, 59, 163, 183, 276]",[163],"[7, 59, 183, 276]",[163],409,5,404,1,4,404,0
2.5,PAA1GL,"[112, 155, 160, 180, 185, 204, 399, 513, 598, 677, 752]","[204, 513]","[112, 155, 160, 180, 185, 399, 598, 677, 752]","[204, 513]",872,11,861,2,9,861,0
2.5,PAAFPG,"[214, 328, 484, 638]",[214],"[328, 484, 638]",[214],1087,4,1083,1,3,1083,0
2.5,PAU03674,"[93, 201, 361, 461, 600, 1110, 1194, 1399, 1404, 1566, 1633, 1710, 1853, 2100, 2123, 2414, 2451, 2493, 2761, 3117, 3171, 3309, 3574, 3685, 3726, 3773, 3866, 3972, 3977, 4013, 4019, 4171, 4181, 4238, 4294, 4367, 4464, 4611, 4705, 4741, 4765, 5237, 5266]","[3171, 3574, 3773, 4013, 4294, 4611]","[93, 201, 361, 461, 600, 1110, 1194, 1399, 1404, 1566, 1633, 1710, 1853, 2100, 2123, 2414, 2451, 2493, 2761, 3117, 3309, 3685, 3726, 3866, 3972, 3977, 4019, 4171, 4181, 4238, 4367, 4464, 4705, 4741, 4765, 5237, 5266]","[3171, 3574, 3773, 4013, 4294, 4611]",5437,43,5394,6,37,5394,0
2.5,PIGAPAI,"[35, 62, 85, 101, 107, 191, 449, 538, 562, 794, 1031, 1051, 1129, 1156, 1163, 1169, 1320, 1353, 1549, 1720, 1819, 1823, 1918, 1930, 1983, 2041, 2317, 2367, 2539, 2693, 2871, 2893, 2897, 2917, 3022, 3317]","[794, 1129]","[35, 62, 85, 101, 107, 191, 449, 538, 562, 1031, 1051, 1156, 1163, 1169, 1320, 1353, 1549, 1720, 1819, 1823, 1918, 1930, 1983, 2041, 2317, 2367, 2539, 2693, 2871, 2893, 2897, 2917, 3022, 3317]","[794, 1129]",3325,36,3289,2,34,3289,0
2.5,PIGAPCIII,"[27, 45, 148, 353, 375, 620, 682, 736, 774, 867, 944, 948, 1091, 1141, 1321, 1432, 1443, 1679, 1711, 2020, 2031, 2035, 2083, 2295, 2513, 2597, 2639, 2740, 3036]","[1432, 1711]","[27, 45, 148, 353, 375, 620, 682, 736, 774, 867, 944, 948, 1091, 1141, 1321, 1443, 1679, 2020, 2031, 2035, 2083, 2295, 2513, 2597, 2639, 2740, 3036]","[1432, 1711]",3268,29,3239,2,27,3239,0
2.5,PIGCNP,"[25, 126, 400, 429, 466, 528, 672, 799, 894, 1150, 1416, 1430, 1615, 1622, 1662, 1781, 1846]",[400],"[25, 126, 429, 466, 528, 672, 799, 894, 1150, 1416, 1430, 1615, 1622, 1662, 1781, 1846]",[400],1886,17,1869,1,16,1869,0
2.5,PIGFSB,"[269, 290, 300, 515, 589, 782, 794, 1042, 1175, 1511, 1598, 1755, 1801, 1849, 1885, 1899]","[515, 1042]","[269, 290, 300, 589, 782, 794, 1175, 1511, 1598, 1755, 1801, 1849, 1885, 1899]","[515, 1042]",2043,16,2027,2,14,2027,0
2.5,PIKEGLOBIN,"[221, 237, 271, 474, 541, 588, 604, 1011, 1063, 1069, 1175, 1193, 1199, 1222, 1272, 1319, 1417, 1422, 1428, 1473, 1529]","[237, 588]","[221, 271, 474, 541, 604, 1011, 1063, 1069, 1175, 1193, 1199, 1222, 1272, 1319, 1417, 1422, 1428, 1473, 1529]","[237, 588]",1701,21,1680,2,19,1680,0
2.5,PPGLTG,"[60, 111, 308, 373, 527, 548, 662, 715, 737, 747, 792, 890, 903, 907]","[373, 662]","[60, 111, 308, 527, 548, 715, 737, 747, 792, 890, 903, 907]","[373, 662]",1064,14,1050,2,12,1050,0
2.5,PPPROP2,"[63, 319, 576, 661]",[319],"[63, 576, 661]",[319],739,4,735,1,3,735,0
2.5,PPYPROP2,"[16, 245, 272, 530, 615]",[272],"[16, 245, 530, 615]",[272],688,5,683,1,4,683,0
2.5,PTAZGLO,"[392, 441, 516, 804, 840, 943, 965, 974, 1062, 1086, 1270, 1549, 1603, 1636, 1648, 1652, 1679, 1707, 1721, 1749, 1791, 1833, 1947, 1991, 2120, 2162, 2176, 2244, 2253, 2331, 2574, 2788, 2813, 2963, 2987, 3065, 3077, 3111, 3124, 3169, 3214]","[1603, 3077]","[392, 441, 516, 804, 840, 943, 965, 974, 1062, 1086, 1270, 1549, 1636, 1648, 1652, 1679, 1707, 1721, 1749, 1791, 1833, 1947, 1991, 2120, 2162, 2176, 2244, 2253, 2331, 2574, 2788, 2813, 2963, 2987, 3065, 3111, 3124, 3169, 3214]","[1603, 3077]",3609,41,3568,2,39,3568,0
2.5,PTGGGLOG,"[162, 200, 210, 431, 545, 641, 712, 821, 891, 1064, 1076, 1174, 1358, 1456, 1501, 1525, 1730, 1803]","[200, 545]","[162, 210, 431, 641, 712, 821, 891, 1064, 1076, 1174, 1358, 1456, 1501, 1525, 1730, 1803]","[200, 545]",1814,18,1796,2,16,1796,0
2.5,PTPPINS,"[688, 728, 742, 799, 933, 1028, 1054, 1134, 1140, 1410, 1524, 1652, 1762, 1778, 1985, 1994, 2010, 2027, 2031, 2073, 2095, 2201, 2274, 2425, 2469]",[1410],"[688, 728, 742, 799, 933, 1028, 1054, 1134, 1140, 1524, 1652, 1762, 1778, 1985, 1994, 2010, 2027, 2031, 2073, 2095, 2201, 2274, 2425, 2469]",[1410],2475,25,2450,1,24,2450,0
2.5,PTPROP2,"[74, 330, 588, 673]",[330],"[74, 588, 673]",[330],750,4,746,1,3,746,0
2.5,PVU11715,"[250, 288, 519, 586, 633, 1021, 1202, 1258, 1272, 1340, 1368, 1504, 1605]","[288, 633]","[250, 519, 586, 1021, 1202, 1258, 1272, 1340, 1368, 1504, 1605]","[288, 633]",1781,13,1768,2,11,1768,0
2.5,QULNFLW,"[5, 15, 113, 145, 260, 474, 762, 809, 867, 961, 1222, 1338, 1504, 1548, 1630, 1667, 1797, 1804, 1975, 2169, 2227, 2301, 2364, 2405, 2417, 2425, 2435, 2461, 2703, 2752, 2972, 3290, 3329, 3422, 3541, 3662, 3720, 3794, 4139, 4360, 4443, 4587, 4656, 4817, 4973, 4978, 5192, 5240, 5368, 5500, 5612, 5691, 5849, 5873, 5894, 5921, 5972, 6211, 6264, 6672, 6808, 6890, 7198, 7255, 7285, 7385, 7389, 7413, 7540, 7905]","[3794, 4656, 5921]","[5, 15, 113, 145, 260, 474, 762, 809, 867, 961, 1222, 1338, 1504, 1548, 1630, 1667, 1797, 1804, 1975, 2169, 2227, 2301, 2364, 2405, 2417, 2425, 2435, 2461, 2703, 2752, 2972, 3290, 3329, 3422, 3541, 3662, 3720, 4139, 4360, 4443, 4587, 4817, 4973, 4978, 5192, 5240, 5368, 5500, 5612, 5691, 5849, 5873, 5894, 5972, 6211, 6264, 6672, 6808, 6890, 7198, 7255, 7285, 7385, 7389, 7413, 7540, 7905]","[3794, 4656, 5921]",7925,70,7855,3,67,7855,0
2.5,QULTROPIA,"[19, 63, 67, 240, 310, 410, 469, 542, 591, 678, 689, 694, 717, 748, 1306, 1449, 1505, 1571, 1858, 1985, 1998, 2156, 2186, 2210, 2360, 2443, 2666, 2707, 2858, 2899, 3004, 3033, 3149, 3437, 3638, 4007, 4020, 4047, 4052, 4225, 4229, 4336, 4544, 4565, 4588, 4677, 4681, 4823, 4891, 4981]","[2186, 2360, 3004, 3437, 4047, 4336]","[19, 63, 67, 240, 310, 410, 469, 542, 591, 678, 689, 694, 717, 748, 1306, 1449, 1505, 1571, 1858, 1985, 1998, 2156, 2210, 2443, 2666, 2707, 2858, 2899, 3033, 3149, 3638, 4007, 4020, 4052, 4225, 4229, 4544, 4565, 4588, 4677, 4681, 4823, 4891, 4981]","[2186, 2360, 3004, 3437, 4047, 4336]",4956,50,4906,6,44,4906,0
2.5,RABCRP,"[397, 402, 416, 509, 513, 551, 579, 781, 785, 870, 990, 1098, 1171, 1221, 1228, 1239, 1286]",[397],"[402, 416, 509, 513, 551, 579, 781, 785, 870, 990, 1098, 1171, 1221, 1228, 1239, 1286]",[397],1430,17,1413,1,16,1413,0
2.5,RABDNP3AA,"[288, 370, 654, 742, 816, 906, 924, 995, 1030, 1286, 1304, 1766, 1865, 1974, 2156, 2182, 2270, 2320, 2435, 2483, 2540, 2581, 2793]",[2156],"[288, 370, 654, 742, 816, 906, 924, 995, 1030, 1286, 1304, 1766, 1865, 1974, 2182, 2270, 2320, 2435, 2483, 2540, 2581, 2793]",[2156],3082,23,3059,1,22,3059,0
2.5,RABSURFA,"[378, 398, 471, 503, 530, 636, 679, 780, 795, 810, 928, 1038, 1175, 1255, 1431, 1539, 1601, 1612, 1642, 2209, 2320, 2383, 2385, 2409, 2556, 2926, 2947, 3132, 3239, 3281, 3290, 3423, 3443, 3447, 3455, 3550, 3917, 4033, 4080, 4166, 4177, 4188, 4361, 4370, 4391, 4577, 4584, 4636, 4661, 4834, 4857, 4959, 4987, 5088, 5440, 5622, 5638, 5795, 5899, 6219, 6243, 6359, 6482, 6529, 6659, 6793, 6939, 7268, 7307, 7344, 7419, 7450, 7760]","[4033, 4361, 5088]","[378, 398, 471, 503, 530, 636, 679, 780, 795, 810, 928, 1038, 1175, 1255, 1431, 1539, 1601, 1612, 1642, 2209, 2320, 2383, 2385, 2409, 2556, 2926, 2947, 3132, 3239, 3281, 3290, 3423, 3443, 3447, 3455, 3550, 3917, 4080, 4166, 4177, 4188, 4370, 4391, 4577, 4584, 4636, 4661, 4834, 4857, 4959, 4987, 5440, 5622, 5638, 5795, 5899, 6219, 6243, 6359, 6482, 6529, 6659, 6793, 6939, 7268, 7307, 7344, 7419, 7450, 7760]","[4033, 4361, 5088]",8089,73,8016,3,70,8016,0
2.5,RABTNF,"[166, 218, 252, 261, 418, 503, 600, 678, 827, 851, 855, 1077, 1095, 1355, 1481, 1563, 1652, 1761, 1778, 1792, 1798, 1895, 2139, 2183, 2268, 2565, 2719, 2803, 2812, 3019, 3034]","[851, 1355, 1563]","[166, 218, 252, 261, 418, 503, 600, 678, 827, 855, 1077, 1095, 1481, 1652, 1761, 1778, 1792, 1798, 1895, 2139, 2183, 2268, 2565, 2719, 2803, 2812, 3019, 3034]","[851, 1355, 1563]",3192,31,3161,3,28,3161,0
2.5,RATCYC,"[28, 70, 116, 270, 362, 452, 456, 572, 636, 833, 921, 1063, 1103, 1168, 1267, 1333, 1400, 1434, 2350]",[1333],"[28, 70, 116, 270, 362, 452, 456, 572, 636, 833, 921, 1063, 1103, 1168, 1267, 1400, 1434, 2350]",[1333],2520,19,2501,1,18,2501,0
2.5,RATCYSS,"[81, 119, 356, 445, 628, 641, 1006, 1119, 1174, 1217, 1221, 1268, 1630, 1686, 1927, 1964, 2500, 2667, 3397, 3865, 3979, 4026, 4083, 4152, 4200, 4214, 4277, 4283, 4287, 4690, 4714, 4811, 4869, 5453, 5488, 5509]","[1006, 4026]","[81, 119, 356, 445, 628, 641, 1119, 1174, 1217, 1221, 1268, 1630, 1686, 1927, 1964, 2500, 2667, 3397, 3865, 3979, 4083, 4152, 4200, 4214, 4277, 4283, 4287, 4690, 4714, 4811, 4869, 5453, 5488, 5509]","[1006, 4026]",5555,36,5519,2,34,5519,0
2.5,RATDCCOVB,"[13, 98, 211, 406, 549, 788, 880, 936, 1396, 1545, 1559, 1599, 1734, 1943, 1951, 2267, 2271, 2283, 2292, 2317, 2321, 2471, 2478, 2864, 3126, 3242, 3489, 3498, 3558, 3716, 3739, 3782, 3923, 4349, 4650, 4709, 4730, 4815, 5129]","[2267, 2864, 3126]","[13, 98, 211, 406, 549, 788, 880, 936, 1396, 1545, 1559, 1599, 1734, 1943, 1951, 2271, 2283, 2292, 2317, 2321, 2471, 2478, 3242, 3489, 3498, 3558, 3716, 3739, 3782, 3923, 4349, 4650, 4709, 4730, 4815, 5129]","[2267, 2864, 3126]",5323,39,5284,3,36,5284,0
2.5,RATGRG,"[83, 204, 286, 331, 441, 446, 658, 719, 804, 848, 1268, 1280, 1291, 1302, 1397, 1415, 1494, 1554, 1622, 1696, 1732, 1918, 1942, 2065, 2106, 2187, 2319, 2338, 2392, 2525, 2546, 2616, 2740, 2852, 2994, 3038, 3290, 3294, 3447, 3454, 3552, 3556, 3706, 3715, 3763]","[83, 286, 1291, 1494, 1696, 1942, 2187, 2319, 2616, 2994, 3290]","[204, 331, 441, 446, 658, 719, 804, 848, 1268, 1280, 1302, 1397, 1415, 1554, 1622, 1732, 1918, 2065, 2106, 2338, 2392, 2525, 2546, 2740, 2852, 3038, 3294, 3447, 3454, 3552, 3556, 3706, 3715, 3763]","[83, 286, 1291, 1494, 1696, 1942, 2187, 2319, 2616, 2994, 3290]",3880,45,3835,11,34,3835,0
2.5,RATGROS,"[79, 107, 236, 397, 406, 589, 621, 631, 746, 800, 1178, 1219, 1293, 1349, 1390, 1482, 1587, 1777, 1820, 1912, 2001, 2131, 2143, 2159]","[1178, 1390, 1587]","[79, 107, 236, 397, 406, 589, 621, 631, 746, 800, 1219, 1293, 1349, 1482, 1777, 1820, 1912, 2001, 2131, 2143, 2159]","[1178, 1390, 1587]",2488,24,2464,3,21,2464,0
2.5,RATGSTY,"[493, 659, 663, 718, 728, 853, 884, 996, 1137, 1310, 1495, 1558, 1647, 1862, 1883, 1918, 1933, 1959, 2027, 2060, 2086, 2416, 2622, 2830, 2896, 3003, 3022, 3101, 3180, 3194, 3201, 3225, 3376, 3534, 3576, 3804, 3854, 3958, 4000, 4115, 4123, 4168, 4269, 4600, 4646, 4691, 4756, 4772, 4777, 4804, 4914, 5009, 5205, 5214, 5376, 5505, 5813, 5926, 5995, 6279]","[659, 996, 1495, 1862, 2060, 3180, 3376]","[493, 663, 718, 728, 853, 884, 1137, 1310, 1558, 1647, 1883, 1918, 1933, 1959, 2027, 2086, 2416, 2622, 2830, 2896, 3003, 3022, 3101, 3194, 3201, 3225, 3534, 3576, 3804, 3854, 3958, 4000, 4115, 4123, 4168, 4269, 4600, 4646, 4691, 4756, 4772, 4777, 4804, 4914, 5009, 5205, 5214, 5376, 5505, 5813, 5926, 5995, 6279]","[659, 996, 1495, 1862, 2060, 3180, 3376]",6286,60,6226,7,53,6226,0
2.5,RATIGFBA,"[210, 412, 526, 850, 854, 883, 1002, 1097, 1152, 1242, 1381, 1450, 1455, 1731, 1788, 1948, 2034, 2082, 2203, 2240, 2385, 2396, 2617, 2645, 3002, 3105, 3214, 3262, 3303, 3312, 3331, 3379, 3450, 3496, 3515, 3613, 3828, 3873, 3924, 4000, 4127, 4362, 4459, 4512, 4535, 4546, 4560, 4578, 4620]","[526, 2034, 3002]","[210, 412, 850, 854, 883, 1002, 1097, 1152, 1242, 1381, 1450, 1455, 1731, 1788, 1948, 2082, 2203, 2240, 2385, 2396, 2617, 2645, 3105, 3214, 3262, 3303, 3312, 3331, 3379, 3450, 3496, 3515, 3613, 3828, 3873, 3924, 4000, 4127, 4362, 4459, 4512, 4535, 4546, 4560, 4578, 4620]","[526, 2034, 3002]",4992,49,4943,3,46,4943,0
2.5,RATJE,"[248, 256, 417, 485, 682, 1191, 1299, 1456, 1550, 1619, 1816, 1968, 1989, 2417, 2565, 2734, 2751, 2777, 2986]","[1191, 1989]","[248, 256, 417, 485, 682, 1299, 1456, 1550, 1619, 1816, 1968, 2417, 2565, 2734, 2751, 2777, 2986]","[1191, 1989]",3097,19,3078,2,17,3078,0
2.5,RATKALA,"[20, 225, 435, 618, 825, 945, 992, 1001, 1027, 1062, 1134, 1275, 1296, 1866, 2147, 2404, 3167, 3282, 3343, 3391, 3650, 3667, 3674, 3753, 3770, 3806, 3977, 4019, 4027, 4031, 4043, 4047, 4051, 4061, 4199, 4388, 4424, 4476, 4506, 4652, 4709, 4729, 4734, 4826, 4856, 4915, 5070, 5100, 5334, 5376, 5689, 5693, 5818, 5842, 6007, 6082, 6132, 6206]","[1275, 3282, 4476, 4709]","[20, 225, 435, 618, 825, 945, 992, 1001, 1027, 1062, 1134, 1296, 1866, 2147, 2404, 3167, 3343, 3391, 3650, 3667, 3674, 3753, 3770, 3806, 3977, 4019, 4027, 4031, 4043, 4047, 4051, 4061, 4199, 4388, 4424, 4506, 4652, 4729, 4734, 4826, 4856, 4915, 5070, 5100, 5334, 5376, 5689, 5693, 5818, 5842, 6007, 6082, 6132, 6206]","[1275, 3282, 4476, 4709]",6249,58,6191,4,54,6191,0
2.5,RATLHB,"[217, 503, 591, 621, 763, 784, 793, 817, 825, 837, 934, 959, 1028, 1230, 1247, 1293, 1359, 1390, 1455, 1461, 1510]","[817, 1230]","[217, 503, 591, 621, 763, 784, 793, 825, 837, 934, 959, 1028, 1247, 1293, 1359, 1390, 1455, 1461, 1510]","[817, 1230]",1790,21,1769,2,19,1769,0
2.5,RATLITHOST,"[80, 171, 397, 992, 1205, 1250, 1357, 1482, 2013, 2464, 2496, 2847, 2945, 3117, 3260, 3471, 3475, 3902, 3906, 3942, 4022, 4229, 4341, 4373, 4424, 4562, 4652, 4715, 4832, 5058, 5147, 5216, 5343]","[2847, 3471, 3902, 4652]","[80, 171, 397, 992, 1205, 1250, 1357, 1482, 2013, 2464, 2496, 2945, 3117, 3260, 3475, 3906, 3942, 4022, 4229, 4341, 4373, 4424, 4562, 4715, 4832, 5058, 5147, 5216, 5343]","[2847, 3471, 3902, 4652]",5399,33,5366,4,29,5366,0
2.5,RATLYSOZYM,"[38, 60, 342, 960, 1322, 1495, 1561, 1622, 1736, 1788, 1941, 2210, 2216, 2220, 2582, 2752, 3092, 3255, 3588, 3750, 3999, 4018, 4049, 4059, 4136, 4186, 4367, 4434, 4446, 4497, 4558, 4784, 4907, 5131, 5145, 5174, 5339, 5370, 5443, 5572, 5576, 5691, 5742, 5953, 6174, 6270, 6404, 6474, 6518, 6523, 6539]","[1561, 3255, 5174]","[38, 60, 342, 960, 1322, 1495, 1622, 1736, 1788, 1941, 2210, 2216, 2220, 2582, 2752, 3092, 3588, 3750, 3999, 4018, 4049, 4059, 4136, 4186, 4367, 4434, 4446, 4497, 4558, 4784, 4907, 5131, 5145, 5339, 5370, 5443, 5572, 5576, 5691, 5742, 5953, 6174, 6270, 6404, 6474, 6518, 6523, 6539]","[1561, 3255, 5174]",6732,51,6681,3,48,6681,0
2.5,RATLYSZYM,"[6, 113, 306, 319, 323, 508, 574, 635, 749, 801, 1007, 1044, 1082, 1099, 1108, 1310, 1392, 1488, 1667, 1671, 2090, 2101, 2558, 2606, 2676, 2912, 2937, 3256, 3260, 3451, 3830, 3840, 3924, 4290, 4624, 4787, 5036, 5055, 5074, 5105, 5115, 5192, 5242, 5423, 5490, 5502, 5553, 5614, 5840, 5963, 6187, 6201, 6230, 6395, 6426, 6499, 6628, 6632, 6746, 6797, 7008, 7229, 7325, 7461, 7531, 7575, 7580, 7596, 7905]","[574, 4290, 6230]","[6, 113, 306, 319, 323, 508, 635, 749, 801, 1007, 1044, 1082, 1099, 1108, 1310, 1392, 1488, 1667, 1671, 2090, 2101, 2558, 2606, 2676, 2912, 2937, 3256, 3260, 3451, 3830, 3840, 3924, 4624, 4787, 5036, 5055, 5074, 5105, 5115, 5192, 5242, 5423, 5490, 5502, 5553, 5614, 5840, 5963, 6187, 6201, 6395, 6426, 6499, 6628, 6632, 6746, 6797, 7008, 7229, 7325, 7461, 7531, 7575, 7580, 7596, 7905]","[574, 4290, 6230]",7943,69,7874,3,66,7874,0
2.5,RATOSCAL,"[54, 261, 319, 641, 846, 876, 1072, 1108, 1192, 1340, 1373, 1540, 1545, 1548, 1586, 1633, 1828, 1832, 2008, 2054, 2085]","[1192, 1373, 1586]","[54, 261, 319, 641, 846, 876, 1072, 1108, 1340, 1540, 1545, 1548, 1633, 1828, 1832, 2008, 2054, 2085]","[1192, 1373, 1586]",2119,21,2098,3,18,2098,0
2.5,RATPAP,"[389, 419, 624, 628, 633, 662, 863, 921, 1048, 1076, 1308, 1342, 1456, 1641, 1648, 1737, 1795, 1806, 1960, 2295, 2803, 3090, 3103, 3305, 3432, 3570, 3715, 4006, 4152, 4240]","[1308, 1648, 2295, 3305]","[389, 419, 624, 628, 633, 662, 863, 921, 1048, 1076, 1342, 1456, 1641, 1737, 1795, 1806, 1960, 2803, 3090, 3103, 3432, 3570, 3715, 4006, 4152, 4240]","[1308, 1648, 2295, 2604, 3305]",4863,30,4833,4,26,4832,1
2.5,RATPAPIIB,"[27, 115, 333, 474, 557, 1110, 1129, 1412, 1597, 1785, 1916, 2043, 2291, 2298, 2332, 2383, 2486, 2532, 2550, 2701, 2705, 2745, 2751, 3021, 3154, 3231, 3387, 3413, 3473, 3577, 3587, 3813, 3817, 3834, 3930, 4025, 4077, 4107, 4206, 4297]","[2298, 3473, 4107]","[27, 115, 333, 474, 557, 1110, 1129, 1412, 1597, 1785, 1916, 2043, 2291, 2332, 2383, 2486, 2532, 2550, 2701, 2705, 2745, 2751, 3021, 3154, 3231, 3387, 3413, 3577, 3587, 3813, 3817, 3834, 3930, 4025, 4077, 4206, 4297]","[2298, 3140, 3473, 4107]",4717,40,4677,3,37,4676,1
2.5,RATPPP,"[118, 306, 378, 740, 863, 1249, 1406, 1497, 1538, 1542, 1586, 1893, 1983, 2002, 2261, 2271, 2321, 2451, 2521, 2563, 2718, 2853, 2927, 2950, 2986, 2990, 3065, 3270, 3500, 3566, 3728, 3732, 3737, 3991, 4133, 4145, 4400, 4464, 4498, 4519]",[2261],"[118, 306, 378, 740, 863, 1249, 1406, 1497, 1538, 1542, 1586, 1893, 1983, 2002, 2271, 2321, 2451, 2521, 2563, 2718, 2853, 2927, 2950, 2986, 2990, 3065, 3270, 3500, 3566, 3728, 3732, 3737, 3991, 4133, 4145, 4400, 4464, 4498, 4519]",[2261],4534,40,4494,1,39,4494,0
2.5,RATPTBZR02,"[188, 224, 326, 340, 537, 559, 610, 669, 673, 727, 871, 909, 1028, 1139, 1206, 1222, 1306, 1319, 1434, 1535, 1828, 1877, 1927, 2004, 2066, 2123, 2145, 2159, 2162, 2200, 2251, 2295, 2371, 2375, 2598, 2719, 2988, 3110, 3232, 3245]","[1306, 2066]","[188, 224, 326, 340, 537, 559, 610, 669, 673, 727, 871, 909, 1028, 1139, 1206, 1222, 1319, 1434, 1535, 1828, 1877, 1927, 2004, 2123, 2145, 2159, 2162, 2200, 2251, 2295, 2371, 2375, 2598, 2719, 2988, 3110, 3232, 3245]","[1306, 2066]",3426,40,3386,2,38,3386,0
2.5,RATRGPI,"[34, 261, 857, 1070, 1115, 1222, 1347, 1879, 2329, 2361, 2712, 2811, 2984, 3128, 3339, 3343, 3770, 3774, 3810, 3890, 4097, 4209, 4242, 4293, 4431, 4521, 4584, 4926, 5015, 5084, 5211]","[2712, 3339, 3770, 4521]","[34, 261, 857, 1070, 1115, 1222, 1347, 1879, 2329, 2361, 2811, 2984, 3128, 3343, 3774, 3810, 3890, 4097, 4209, 4242, 4293, 4431, 4584, 4926, 5015, 5084, 5211]","[2712, 3339, 3770, 4521]",5237,31,5206,4,27,5206,0
2.5,RATRPIII,"[419, 438, 721, 906, 1094, 1226, 1320, 1353, 1601, 1608, 1642, 1693, 1796, 1839, 1843, 1861, 2017, 2021, 2061, 2067, 2337, 2456, 2470, 2547, 2704, 2730, 2790, 2894, 2905, 3131, 3135, 3152, 3249, 3344, 3396, 3426, 3526, 3617, 4044, 4132]","[1608, 2456, 2790, 3426]","[419, 438, 721, 906, 1094, 1226, 1320, 1353, 1601, 1642, 1693, 1796, 1839, 1843, 1861, 2017, 2021, 2061, 2067, 2337, 2470, 2547, 2704, 2730, 2894, 2905, 3131, 3135, 3152, 3249, 3344, 3396, 3526, 3617, 4044, 4132]","[1608, 2456, 2790, 3426]",4133,40,4093,4,36,4093,0
2.5,RATSVSIV1,"[67, 72, 244, 300, 380, 418, 659, 721, 814, 892, 902]",[244],"[67, 72, 300, 380, 418, 659, 721, 814, 892, 902]",[244],972,11,961,1,10,961,0
2.5,RATTSHB,"[260, 265, 435, 514, 661, 672, 825, 880, 929, 1198, 1288, 1482, 1585, 1651, 1661, 1728, 1758, 1762, 1904, 2142, 2177, 2183, 2483, 2711, 2766, 2874, 2899, 2921, 3202, 3462, 3676, 3977, 3999, 4050, 4093, 4299, 4375, 4640, 4781]",[4375],"[260, 265, 435, 514, 661, 672, 825, 880, 929, 1198, 1288, 1482, 1585, 1651, 1661, 1728, 1758, 1762, 1904, 2142, 2177, 2183, 2483, 2711, 2766, 2874, 2899, 2921, 3202, 3462, 3676, 3977, 3999, 4050, 4093, 4299, 4640, 4781]",[4375],5159,39,5120,1,38,5120,0
2.5,RN0B2GLOB,"[9, 31, 80, 84, 136, 316, 374, 474, 500, 547, 558, 579, 693, 796, 1134, 1450, 1485, 1702, 1766]",[693],"[9, 31, 80, 84, 136, 316, 374, 474, 500, 547, 558, 579, 796, 1134, 1450, 1485, 1702, 1766]","[354, 693]",1789,19,1770,1,18,1769,1
2.5,RN2BGLOB,"[205, 264, 394, 432, 483, 571, 618, 629, 650, 764, 982, 1217, 1533, 1568, 1710, 1760, 1769]","[432, 764]","[205, 264, 394, 483, 571, 618, 629, 650, 982, 1217, 1533, 1568, 1710, 1760, 1769]","[432, 764]",1876,17,1859,2,15,1859,0
2.5,RN3B2GLOB,"[84, 122, 142, 180, 267, 314, 325, 346, 460, 679, 760, 835, 867, 1183, 1218, 1360, 1421]","[122, 460]","[84, 142, 180, 267, 314, 325, 346, 679, 760, 835, 867, 1183, 1218, 1360, 1421]","[122, 460]",1436,17,1419,2,15,1419,0
2.5,RN3B3GLOB,"[75, 125, 129, 365, 403, 423, 461, 546, 593, 604, 625, 739, 960, 1039, 1146, 1497, 1642, 1680, 1726]","[403, 739]","[75, 125, 129, 365, 423, 461, 546, 593, 604, 625, 960, 1039, 1146, 1497, 1642, 1680, 1726]","[403, 739]",1738,19,1719,2,17,1719,0
2.5,RN3BGLOB,"[250, 288, 308, 346, 433, 480, 491, 512, 626, 840, 996, 1028, 1344, 1379, 1522]","[288, 626]","[250, 308, 346, 433, 480, 491, 512, 840, 996, 1028, 1344, 1379, 1522]","[288, 626]",1526,15,1511,2,13,1511,0
2.5,RNAC01,"[127, 131, 309, 374, 417, 497, 509, 513, 528, 561, 582, 734, 758, 788, 844, 1049, 1085, 1207, 1367, 1463, 1467, 1694, 1707, 1904, 1910, 1953, 1992, 2190, 2220, 2419, 2528, 2597, 2631, 2685, 2797, 2867, 3089, 3335, 3556, 3650, 3697, 3767, 3850, 3868, 3889, 3984, 4000]","[1367, 1694, 2597, 2867]","[127, 131, 309, 374, 417, 497, 509, 513, 528, 561, 582, 734, 758, 788, 844, 1049, 1085, 1207, 1463, 1467, 1707, 1904, 1910, 1953, 1992, 2190, 2220, 2419, 2528, 2631, 2685, 2797, 3089, 3335, 3556, 3650, 3697, 3767, 3850, 3868, 3889, 3984, 4000]","[1367, 1694, 2597, 2867]",4083,47,4036,4,43,4036,0
2.5,RNAC02,"[33, 141, 200, 251, 262, 271, 388, 480, 524, 636, 907, 1152, 1293, 1347, 1368, 1471, 1475, 1526, 1734, 1753, 1787, 1820, 2138, 2165, 2180, 2243, 2487, 2508, 2561, 2637, 2673, 2681, 2743, 2759, 2917, 2978]","[1368, 1787, 2138, 2743]","[33, 141, 200, 251, 262, 271, 388, 480, 524, 636, 907, 1152, 1293, 1347, 1471, 1475, 1526, 1734, 1753, 1820, 2165, 2180, 2243, 2487, 2508, 2561, 2637, 2673, 2681, 2759, 2917, 2978]","[1368, 1787, 2138, 2429, 2743]",3192,36,3156,4,32,3155,1
2.5,RNANTANT,"[62, 88, 236, 476, 681, 936, 1017, 1295, 1339, 1344, 1358, 1456, 1524, 1678, 1706, 1808, 2578, 2839, 2904, 2969, 3008, 3023, 3097, 3119, 3137, 3263, 3301, 3420, 3449, 3574, 3609, 3646, 3658, 3777, 3883, 3993, 4075, 4083, 4213, 4324, 4532, 4565, 4710, 4724]","[1524, 3263, 3883]","[62, 88, 236, 476, 681, 936, 1017, 1295, 1339, 1344, 1358, 1456, 1678, 1706, 1808, 2578, 2839, 2904, 2969, 3008, 3023, 3097, 3119, 3137, 3301, 3420, 3449, 3574, 3609, 3646, 3658, 3777, 3993, 4075, 4083, 4213, 4324, 4532, 4565, 4710, 4724]","[1524, 3263, 3883]",5117,44,5073,3,41,5073,0
2.5,RNAPOEG,"[398, 459, 499, 506, 615, 620, 716, 872, 948, 1077, 1152, 1293, 1327, 1440, 1446, 1538, 1604, 1746, 1812, 1955, 2069, 2356, 2383, 2461, 2536, 2690, 2692, 2705, 2863, 2867, 2884, 3203]","[1293, 1955]","[398, 459, 499, 506, 615, 620, 716, 872, 948, 1077, 1152, 1327, 1440, 1446, 1538, 1604, 1746, 1812, 2069, 2356, 2383, 2461, 2536, 2690, 2692, 2705, 2863, 2867, 2884, 3203]","[1293, 1955]",3229,32,3197,2,30,3197,0
2.5,RNCALBD9,"[24, 115, 161, 373, 469, 596, 984, 1041, 1330, 1399, 1471, 1532, 1550, 1621, 1729, 1739, 1779, 1781, 1793, 1831, 2187, 2285, 2291, 2499, 2563, 2736, 2779, 3177, 3254, 3508, 3841, 4062, 4310, 4412, 4587, 4711, 4869]",[2736],"[24, 115, 161, 373, 469, 596, 984, 1041, 1330, 1399, 1471, 1532, 1550, 1621, 1729, 1739, 1779, 1781, 1793, 1831, 2187, 2285, 2291, 2499, 2563, 2779, 3177, 3254, 3508, 3841, 4062, 4310, 4412, 4587, 4711, 4869]",[2736],4883,37,4846,1,36,4846,0
2.5,RNGAMT,"[486, 497, 618, 799, 866, 1028, 1424, 1478, 1503, 1531, 1552, 1564, 1975, 2173, 2468, 2543, 2653, 2660, 2752, 2756, 2926, 3141, 3205, 3319, 3361, 3462, 3573, 3628, 3760, 3797, 3802, 4003, 4022, 4149, 4357, 4390, 4441, 4635, 4704, 4715, 4824, 4870, 4876]","[2173, 3141, 3319, 3760, 4003]","[486, 497, 618, 799, 866, 1028, 1424, 1478, 1503, 1531, 1552, 1564, 1975, 2468, 2543, 2653, 2660, 2752, 2756, 2926, 3205, 3361, 3462, 3573, 3628, 3797, 3802, 4022, 4149, 4357, 4390, 4441, 4635, 4704, 4715, 4824, 4870, 4876]","[2173, 3141, 3319, 3760, 4003]",4956,43,4913,5,38,4913,0
2.5,RNGMTG,"[12, 92, 203, 250, 440, 620, 727, 741, 806, 971, 1011, 1016, 1226, 1267, 1406, 1438, 1538, 1561, 1646, 1656, 1682, 1818, 1874, 2031, 2067, 2117, 2433, 2443, 2987, 3244, 3249, 3328, 3357, 3415, 3428, 3481, 3555, 3918, 4048, 4063, 4069, 4120, 4158, 4254, 4401, 4425, 4432, 4463, 4493, 4548, 4624, 4644, 5067, 5094, 5101, 5122, 5252, 5306, 5347, 5368]","[1682, 3249, 3918, 4254, 4463]","[12, 92, 203, 250, 440, 620, 727, 741, 806, 971, 1011, 1016, 1226, 1267, 1406, 1438, 1538, 1561, 1646, 1656, 1818, 1874, 2031, 2067, 2117, 2433, 2443, 2987, 3244, 3328, 3357, 3415, 3428, 3481, 3555, 4048, 4063, 4069, 4120, 4158, 4401, 4425, 4432, 4493, 4548, 4624, 4644, 5067, 5094, 5101, 5122, 5252, 5306, 5347, 5368]","[1682, 3249, 3918, 4254, 4463]",5391,60,5331,5,55,5331,0
2.5,RNGROW3,"[89, 216, 299, 365, 471, 543, 817, 1096, 1652, 1751, 1908, 1973, 2066]","[471, 817, 1652, 1973]","[89, 216, 299, 365, 543, 1096, 1751, 1908, 2066]","[471, 817, 1652, 1973]",2549,13,2536,4,9,2536,0
2.5,RNHSC73,"[93, 233, 498, 522, 533, 546, 570, 810, 954, 975, 1139, 1244, 1280, 1528, 1584, 1713, 1727, 1779, 1982, 2062, 2258, 2297, 2506, 2612, 2618, 2664, 3034, 3259, 3448, 3452, 3542, 3766, 3795, 3935, 3942, 4070, 4221]","[1244, 1713, 1982, 2618, 3034, 3448, 3766]","[93, 233, 498, 522, 533, 546, 570, 810, 954, 975, 1139, 1280, 1528, 1584, 1727, 1779, 2062, 2258, 2297, 2506, 2612, 2664, 3259, 3452, 3542, 3795, 3935, 3942, 4070, 4221]","[1244, 1713, 1982, 2618, 3034, 3448, 3766]",4312,37,4275,7,30,4275,0
2.5,RNLALB01,"[39, 347, 351, 821, 877, 891, 971, 1101, 1237, 1242, 1264, 1354, 1414, 1825, 1914, 1991, 2014, 2096, 2375, 2419, 2809, 2897, 2974, 3122, 3263, 3297, 3337, 3482, 3800]","[1414, 1914, 2419]","[39, 347, 351, 821, 877, 891, 971, 1101, 1237, 1242, 1264, 1354, 1825, 1991, 2014, 2096, 2375, 2809, 2897, 2974, 3122, 3263, 3297, 3337, 3482, 3800]","[1414, 1914, 2419]",3812,29,3783,3,26,3783,0
2.5,RNLPKG,"[33, 102, 326, 617, 760, 1022, 1137, 1599, 1729, 1911, 1934, 2034, 2062, 2169, 2183, 2333, 2376, 2691, 2847, 2926, 3195, 3219, 3300, 3374, 3407, 3460, 3634, 3729, 3787, 3949, 4000, 4052, 4069, 4076, 4253, 4309, 4321, 4376, 4493, 4655, 4959, 5073, 5184, 5605, 5806, 5836, 6009, 6284, 6457, 6463, 6494, 6510, 6592, 6605, 6805, 6935, 7192, 7302, 7321, 7453, 7481, 7582, 7598, 7818, 8078, 8213, 8286, 8374, 8465, 8510, 8548, 8608, 8789, 8812, 8846, 8860, 9121, 9142, 9414, 9480, 9723, 9775, 9838, 9857, 9919, 9996, 10186, 10198, 10207, 10214, 10252, 10493, 10546, 10711, 10935, 10973, 11491, 11648, 11734, 11834, 12153, 12163, 12180, 12649, 12724, 12937]","[3219, 3949, 6009, 6284, 6605, 7192, 7453, 7818, 8078, 9480]","[33, 102, 326, 617, 760, 1022, 1137, 1599, 1729, 1911, 1934, 2034, 2062, 2169, 2183, 2333, 2376, 2691, 2847, 2926, 3195, 3300, 3374, 3407, 3460, 3634, 3729, 3787, 4000, 4052, 4069, 4076, 4253, 4309, 4321, 4376, 4493, 4655, 4959, 5073, 5184, 5605, 5806, 5836, 6457, 6463, 6494, 6510, 6592, 6805, 6935, 7302, 7321, 7481, 7582, 7598, 8213, 8286, 8374, 8465, 8510, 8548, 8608, 8789, 8812, 8846, 8860, 9121, 9142, 9414, 9723, 9775, 9838, 9857, 9919, 9996, 10186, 10198, 10207, 10214, 10252, 10493, 10546, 10711, 10935, 10973, 11491, 11648, 11734, 11834, 12153, 12163, 12180, 12649, 12724, 12937]","[3219, 3949, 6009, 6284, 6605, 7192, 7453, 7818, 8078, 9480]",13003,106,12897,10,96,12897,0
2.5,RNODC,"[115, 126, 161, 570, 877, 883, 1097, 1218, 1279, 1339, 1344, 1430, 1554, 1568, 2245, 2435, 2454, 2655, 2666, 2850, 2887, 3174, 3262, 3305, 3525, 3618, 3630, 3696, 3870, 3918, 4073, 4095, 4182, 4259, 4382, 4517, 4623, 4630, 4698, 4953, 4982, 5321, 5347, 5522, 5631, 5650, 5686, 5695, 5804, 5825, 5851, 5974, 5997, 6128, 6178, 6182, 6291, 6350, 6412, 6582, 6636, 6679, 6692, 7019, 7025, 7045, 7326, 7755]","[3525, 3918, 4182, 4517, 4698, 4953, 5631, 5825, 6291]","[115, 126, 161, 570, 877, 883, 1097, 1218, 1279, 1339, 1344, 1430, 1554, 1568, 2245, 2435, 2454, 2655, 2666, 2850, 2887, 3174, 3262, 3305, 3618, 3630, 3696, 3870, 4073, 4095, 4259, 4382, 4623, 4630, 4982, 5321, 5347, 5522, 5650, 5686, 5695, 5804, 5851, 5974, 5997, 6128, 6178, 6182, 6350, 6412, 6582, 6636, 6679, 6692, 7019, 7025, 7045, 7326, 7755]","[3525, 3918, 4182, 4517, 4698, 4953, 5631, 5825, 6291]",7768,68,7700,9,59,7700,0
2.5,RNP9KA,"[22, 30, 157, 172, 207, 248, 262, 324, 338, 372, 400, 483, 632, 723, 727, 736, 823, 875, 879, 905, 910, 937, 1156, 1227, 1468, 1612, 1760, 1870, 2118, 2216, 2220, 2224, 2228, 2300, 2311]",[1227],"[22, 30, 157, 172, 207, 248, 262, 324, 338, 372, 400, 483, 632, 723, 727, 736, 823, 875, 879, 905, 910, 937, 1156, 1468, 1612, 1760, 1870, 2118, 2216, 2220, 2224, 2228, 2300, 2311]",[1227],2332,35,2297,1,34,2297,0
2.5,RNPBPG,"[21, 125, 231, 235, 501, 956, 980, 1117, 1155, 1180, 2100, 2592, 2638, 2773, 2890, 2916, 2950, 3056, 3190, 3297, 3363, 3553, 3756, 3786, 3855, 3978, 4056, 4073, 4580, 4772, 5117, 5404, 5428]","[1117, 2950]","[21, 125, 231, 235, 501, 956, 980, 1155, 1180, 2100, 2592, 2638, 2773, 2890, 2916, 3056, 3190, 3297, 3363, 3553, 3756, 3786, 3855, 3978, 4056, 4073, 4580, 4772, 5117, 5404, 5428]","[1117, 2950]",6021,33,5988,2,31,5988,0
2.5,RNPGMUT,"[6, 17, 32, 63, 167, 174, 277, 370, 460, 483, 886, 945, 1216, 1273, 1352, 1356, 1412, 1425, 1515, 1596, 1605, 1618, 1623, 1637, 1734, 1912, 1934, 2032, 2242, 2248, 2252, 2287, 2291, 2301]",[1596],"[6, 17, 32, 63, 167, 174, 277, 370, 460, 483, 886, 945, 1216, 1273, 1352, 1356, 1412, 1425, 1515, 1605, 1618, 1623, 1637, 1734, 1912, 1934, 2032, 2242, 2248, 2252, 2287, 2291, 2301]","[1596, 1872]",2420,34,2386,1,33,2385,1
2.5,RNPROST22,"[45, 237, 438, 444, 494, 499, 528, 721, 733, 876, 1262, 1412, 1870, 2025, 2200, 2321, 2356, 2556, 2702, 3060, 3110, 3159, 3246, 3502, 3647, 3658, 3835, 3841, 3916, 4048, 4236, 4241, 4279, 4351, 4526, 4727, 4820, 5161, 5185, 5333, 5680, 5765, 5952, 6009, 6129, 6366, 6680, 6790, 6890, 6974, 7004, 7034, 7412]","[876, 3647, 4526]","[45, 237, 438, 444, 494, 499, 528, 721, 733, 1262, 1412, 1870, 2025, 2200, 2321, 2356, 2556, 2702, 3060, 3110, 3159, 3246, 3502, 3658, 3835, 3841, 3916, 4048, 4236, 4241, 4279, 4351, 4727, 4820, 5161, 5185, 5333, 5680, 5765, 5952, 6009, 6129, 6366, 6680, 6790, 6890, 6974, 7004, 7034, 7412]","[876, 3647, 4526]",7667,53,7614,3,50,7614,0
2.5,RNREVSV2A,"[12, 67, 71, 121, 290, 741, 754, 762, 848, 935, 1201, 1216, 1304, 1332, 1341]","[67, 1304]","[12, 71, 121, 290, 741, 754, 762, 848, 935, 1201, 1216, 1332, 1341]","[67, 1304]",1730,15,1715,2,13,1715,0
2.5,RNSDHG,"[160, 177, 199, 285, 290, 299, 379, 405, 435, 568, 656, 743, 836, 881, 1007, 1028, 1171, 1211, 1224, 1286, 1376, 1536, 1775, 1777, 1993, 2205, 2256, 2305, 2533, 2697, 3035, 3170, 3480, 3554, 3975, 4077, 4179, 4189, 4413, 4511, 4640, 4705, 4761, 5079, 5291, 5565, 5590, 5691, 5866, 6043, 6052, 6095, 6213, 6253, 6479, 6512, 6567, 6576, 6584, 6592, 6634, 6641, 6689, 6836, 6877, 6984, 7017, 7081, 7600, 7711, 7962, 8014, 8177, 8307, 8314, 8355, 8361, 8383, 8667, 8671, 8750, 8757, 8888, 9160, 9362, 9541]","[4640, 5691, 6052, 6253, 6984, 8671]","[160, 177, 199, 285, 290, 299, 379, 405, 435, 568, 656, 743, 836, 881, 1007, 1028, 1171, 1211, 1224, 1286, 1376, 1536, 1775, 1777, 1993, 2205, 2256, 2305, 2533, 2697, 3035, 3170, 3480, 3554, 3975, 4077, 4179, 4189, 4413, 4511, 4705, 4761, 5079, 5291, 5565, 5590, 5866, 6043, 6095, 6213, 6479, 6512, 6567, 6576, 6584, 6592, 6634, 6641, 6689, 6836, 6877, 7017, 7081, 7600, 7711, 7962, 8014, 8177, 8307, 8314, 8355, 8361, 8383, 8667, 8750, 8757, 8888, 9160, 9362, 9541]","[4640, 5691, 6052, 6253, 6984, 8671]",9570,86,9484,6,80,9484,0
2.5,RNSVFG,"[213, 349, 454, 469, 500, 636, 670, 709, 1018, 1182, 1250, 1267, 1347, 1919, 2079]",[500],"[213, 349, 454, 469, 636, 670, 709, 1018, 1182, 1250, 1267, 1347, 1919, 2079]",[500],1841,15,1826,1,14,1826,0
2.5,RNTHYCSG,"[68, 81, 160, 318, 326, 355, 679, 761, 785, 1071, 1105, 1229, 1237, 1242, 1366, 1450, 1454, 1621, 1906, 1983, 2015, 2196, 2203, 2271, 2763]","[68, 1071]","[81, 160, 318, 326, 355, 679, 761, 785, 1105, 1229, 1237, 1242, 1366, 1450, 1454, 1621, 1906, 1983, 2015, 2196, 2203, 2271, 2763]","[68, 1071]",2855,25,2830,2,23,2830,0
2.5,RNU03551,"[46, 64, 219, 578, 584, 620, 661, 715, 766, 799, 832, 1407, 1471, 1545, 1634, 1913, 1969, 2006, 2013, 2115, 2183, 2263, 2418, 2422, 2461, 2552, 3083, 3169, 3176, 3217, 3226, 3360]","[832, 2418, 3083]","[46, 64, 219, 578, 584, 620, 661, 715, 766, 799, 1407, 1471, 1545, 1634, 1913, 1969, 2006, 2013, 2115, 2183, 2263, 2422, 2461, 2552, 3169, 3176, 3217, 3226, 3360]","[832, 2418, 3083]",3590,32,3558,3,29,3558,0
2.5,RNU09193,"[196, 276, 402, 438, 469, 863, 1048, 1457, 1727, 1772, 2077, 2084, 2133, 2163, 2255, 2295, 2449, 2630, 2749, 2794, 3037, 3084, 3326, 3402, 3505, 3600, 3612, 3787, 3899, 3910, 3976]","[2084, 2749, 3084, 3787]","[196, 276, 402, 438, 469, 863, 1048, 1457, 1727, 1772, 2077, 2133, 2163, 2255, 2295, 2449, 2630, 2794, 3037, 3326, 3402, 3505, 3600, 3612, 3899, 3910, 3976]","[2084, 2749, 3084, 3787]",4187,31,4156,4,27,4156,0
2.5,RNU12250,"[252, 293, 325, 424, 464, 473, 826, 888, 1043, 1094, 1181, 1512, 1531, 1704, 1708, 1769]","[293, 473]","[252, 325, 424, 464, 826, 888, 1043, 1094, 1181, 1512, 1531, 1704, 1708, 1769]","[293, 473]",1863,16,1847,2,14,1847,0
2.5,RNUCPG,"[112, 255, 380, 458, 536, 798, 848, 952, 1135, 1151, 1396, 1424, 1515, 1519, 1663, 1730, 1796, 1834, 1881, 1897, 1908, 2015, 2382, 2428, 2614, 2812, 3281, 3539, 3558, 3598, 3749, 3801, 3844, 4110, 4187, 4310, 4477, 4642, 4818, 4822, 4896, 4965, 5157, 5189, 5476, 5480, 5623, 5659, 5677, 5744, 6018, 6042, 6121, 6187, 6192, 6279, 6334, 6417, 6426, 6470, 6660, 6983, 6999, 7007, 7031, 7278, 7298, 7357, 7395, 7704, 7819, 7846, 7852, 7964, 7992, 7996, 8105, 8157, 8180, 8654, 9172, 9297, 9401, 9441, 9995, 10198, 10292, 10300, 10419, 10603, 10732, 10871, 11061, 11092, 11184, 11442, 11481, 11722, 11771, 12170, 12398, 12485]","[4310, 5157, 7964, 8157, 9401]","[112, 255, 380, 458, 536, 798, 848, 952, 1135, 1151, 1396, 1424, 1515, 1519, 1663, 1730, 1796, 1834, 1881, 1897, 1908, 2015, 2382, 2428, 2614, 2812, 3281, 3539, 3558, 3598, 3749, 3801, 3844, 4110, 4187, 4477, 4642, 4818, 4822, 4896, 4965, 5189, 5476, 5480, 5623, 5659, 5677, 5744, 6018, 6042, 6121, 6187, 6192, 6279, 6334, 6417, 6426, 6470, 6660, 6983, 6999, 7007, 7031, 7278, 7298, 7357, 7395, 7704, 7819, 7846, 7852, 7992, 7996, 8105, 8180, 8654, 9172, 9297, 9441, 9995, 10198, 10292, 10300, 10419, 10603, 10732, 10871, 11061, 11092, 11184, 11442, 11481, 11722, 11771, 12170, 12398, 12485]","[4310, 5157, 7964, 8157, 9401]",12496,102,12394,5,97,12394,0
2.5,RNVEGP1,"[305, 400, 506, 571, 926, 1021, 1043, 1156, 1262, 1286, 1623, 1629, 1635, 1697, 1817, 1834, 1935, 1973, 1994, 2076, 2108, 2273, 2628, 2777, 2821, 2915, 3032, 3403, 3454, 3708, 3852, 3940, 4033, 4037, 4052, 4126, 4140, 4452, 4559, 4611, 4710, 4844, 4855, 4962, 5195, 5315, 5360, 5630, 5641, 5948]","[1262, 1834, 3032, 4037, 4611]","[305, 400, 506, 571, 926, 1021, 1043, 1156, 1286, 1623, 1629, 1635, 1697, 1817, 1935, 1973, 1994, 2076, 2108, 2273, 2628, 2777, 2821, 2915, 3403, 3454, 3708, 3852, 3940, 4033, 4052, 4126, 4140, 4452, 4559, 4710, 4844, 4855, 4962, 5195, 5315, 5360, 5630, 5641, 5948]","[1262, 1834, 3032, 4037, 4611]",5948,50,5898,5,45,5898,0
2.5,RNVEGP2C,"[84, 430, 493, 536, 630, 1041, 1136, 1159, 1272, 1378, 1402, 1739, 1745, 1751, 1813, 1933, 1950, 2048, 2086, 2105, 2182, 2213, 2379, 2807, 2875, 2919, 3013, 3069, 3128, 3514, 3817, 3961, 4049, 4142, 4146, 4161, 4432, 4671, 4723, 4727, 4822, 4960, 4971, 5078, 5529, 5566]","[1378, 1950, 3128, 4146, 4723]","[84, 430, 493, 536, 630, 1041, 1136, 1159, 1272, 1402, 1739, 1745, 1751, 1813, 1933, 2048, 2086, 2105, 2182, 2213, 2379, 2807, 2875, 2919, 3013, 3069, 3514, 3817, 3961, 4049, 4142, 4161, 4432, 4671, 4727, 4822, 4960, 4971, 5078, 5529, 5566]","[1378, 1950, 3128, 4146, 4723]",5742,46,5696,5,41,5696,0
2.5,RRU04320,"[240, 323, 386, 573, 693, 700, 838, 1077, 1105, 1126, 1132, 1219, 1538, 1559, 2004, 2008, 2107, 2118, 2500, 2592, 2606, 3080, 3099, 3139, 3301, 3412, 3524, 3559, 3616, 3643, 4014, 4216, 4275, 4512, 4841, 5366, 5370, 5456, 5787, 6213, 6372, 6549]","[2500, 3643]","[240, 323, 386, 573, 693, 700, 838, 1077, 1105, 1126, 1132, 1219, 1538, 1559, 2004, 2008, 2107, 2118, 2592, 2606, 3080, 3099, 3139, 3301, 3412, 3524, 3559, 3616, 4014, 4216, 4275, 4512, 4841, 5366, 5370, 5456, 5787, 6213, 6372, 6549]","[2500, 3643]",6798,42,6756,2,40,6756,0
2.5,S46763,"[186, 191, 252, 265, 278, 336, 479, 507, 535, 695, 699, 777, 788, 1006, 1146, 1235, 1252, 1300, 1406, 1436, 1690, 1715, 1787, 1914, 2000, 2056, 2111, 2268, 2487, 2561, 2584, 2694, 2722, 2775, 2928, 2946, 3053, 3209, 3245, 3278, 3563, 3954, 4052, 4256, 4358, 4381, 4424, 4698, 4782, 4801, 4883, 5060, 5469, 5736, 6085, 6463, 6880, 7078, 7095, 7119, 7334, 7349, 7916, 7953, 7959, 8012, 8037, 8056, 8082, 8294, 8344, 8562, 8683, 8936, 9109, 9241]","[1235, 2487, 2775, 4052, 5060, 5469, 6880, 7334, 8012, 8294]","[186, 191, 252, 265, 278, 336, 479, 507, 535, 695, 699, 777, 788, 1006, 1146, 1252, 1300, 1406, 1436, 1690, 1715, 1787, 1914, 2000, 2056, 2111, 2268, 2561, 2584, 2694, 2722, 2928, 2946, 3053, 3209, 3245, 3278, 3563, 3954, 4256, 4358, 4381, 4424, 4698, 4782, 4801, 4883, 5736, 6085, 6463, 7078, 7095, 7119, 7349, 7916, 7953, 7959, 8037, 8056, 8082, 8344, 8562, 8683, 8936, 9109, 9241]","[1235, 2487, 2775, 4052, 4528, 5060, 5469, 6880, 7334, 8012, 8294]",10035,76,9959,10,66,9958,1
2.5,S49651,"[185, 246, 259, 471, 823, 1117, 1189, 1229, 1652, 1765, 2378, 2476, 2786, 2918, 2955, 3174, 3255, 3566, 3571, 3702, 3712, 3856, 3998, 4132, 4137, 4141, 4449, 4518, 4577, 4624]","[1652, 2786, 3255, 4137]","[185, 246, 259, 471, 823, 1117, 1189, 1229, 1765, 2378, 2476, 2918, 2955, 3174, 3566, 3571, 3702, 3712, 3856, 3998, 4132, 4141, 4449, 4518, 4577, 4624]","[1652, 2786, 3255, 4137]",5440,30,5410,4,26,5410,0
2.5,S57980,"[44, 236, 437, 443, 493, 498, 527, 720, 732, 875, 1261, 1411, 1869, 2024, 2198, 2319, 2354, 2554, 2700, 3058, 3108, 3157, 3244, 3500, 3645, 3656, 3833, 3839, 3914, 4046, 4234, 4239, 4277, 4349, 4524, 4725, 4818, 5159, 5183, 5331, 5678, 5763, 5950, 6007, 6127, 6364, 6678, 6788, 6888, 6972, 7002, 7032, 7410]","[875, 3645, 4524]","[44, 236, 437, 443, 493, 498, 527, 720, 732, 1261, 1411, 1869, 2024, 2198, 2319, 2354, 2554, 2700, 3058, 3108, 3157, 3244, 3500, 3656, 3833, 3839, 3914, 4046, 4234, 4239, 4277, 4349, 4725, 4818, 5159, 5183, 5331, 5678, 5763, 5950, 6007, 6127, 6364, 6678, 6788, 6888, 6972, 7002, 7032, 7410]","[875, 3645, 4524]",7665,53,7612,3,50,7612,0
2.5,S62287,"[6, 190, 239, 555, 570, 705, 731, 1020, 1266, 1420, 1493, 1673, 1679, 1965, 1970, 2330, 2470, 2489, 2535, 2619, 2808, 3003, 3077, 3108, 3167, 3189, 3206, 3356, 3398, 3422]",[1266],"[6, 190, 239, 555, 570, 705, 731, 1020, 1420, 1493, 1673, 1679, 1965, 1970, 2330, 2470, 2489, 2535, 2619, 2808, 3003, 3077, 3108, 3167, 3189, 3206, 3356, 3398, 3422]",[1266],3425,30,3395,1,29,3395,0
2.5,S63697,"[9, 92, 159, 280, 435, 504, 829, 1109, 1240]","[280, 829]","[9, 92, 159, 435, 504, 1109, 1240]","[280, 829]",1331,9,1322,2,7,1322,0
2.5,S66606,"[152, 238, 248, 315, 325, 336, 340, 379, 420, 424, 441, 494, 679, 759, 865, 958, 1076, 1562, 1678, 1846, 1859, 1875, 2485, 2506, 2518, 2537, 2706, 2815, 3054, 3365, 3613, 3631, 3656, 3675, 3723, 3899, 3982, 4067, 4214, 4518, 4530, 4598, 4706, 5586, 5644, 5694, 5780, 5911, 5936, 5958, 6086, 6167, 6171, 6181, 6235, 6255, 6296, 6301]","[2506, 2706, 3899, 4598]","[152, 238, 248, 315, 325, 336, 340, 379, 420, 424, 441, 494, 679, 759, 865, 958, 1076, 1562, 1678, 1846, 1859, 1875, 2485, 2518, 2537, 2815, 3054, 3365, 3613, 3631, 3656, 3675, 3723, 3982, 4067, 4214, 4518, 4530, 4706, 5586, 5644, 5694, 5780, 5911, 5936, 5958, 6086, 6167, 6171, 6181, 6235, 6255, 6296, 6301]","[2506, 2706, 3899, 4598]",6359,58,6301,4,54,6301,0
2.5,S67057,"[49, 83, 98, 154, 322, 840, 953, 1205, 1274]",[840],"[49, 83, 98, 154, 322, 953, 1205, 1274]",[840],1746,9,1737,1,8,1737,0
2.5,S69277,"[142, 151, 207, 432, 734, 857, 1007, 1256, 1299, 1706, 1783, 1967, 1971, 1977, 2058, 2069, 2074, 2101, 2103, 2321, 2435, 2538, 2783, 2810, 2951, 2954, 3072, 3098, 3229, 3267, 3316, 3385, 3521, 3723, 3839, 3995, 4103, 4215, 4348, 4385, 4488, 4556, 4726, 4790, 4852, 5063, 5172, 5378, 5421]","[3098, 3316, 3521, 3839, 4103]","[142, 151, 207, 432, 734, 857, 1007, 1256, 1299, 1706, 1783, 1967, 1971, 1977, 2058, 2069, 2074, 2101, 2103, 2321, 2435, 2538, 2783, 2810, 2951, 2954, 3072, 3229, 3267, 3385, 3723, 3995, 4215, 4348, 4385, 4488, 4556, 4726, 4790, 4852, 5063, 5172, 5378, 5421]","[3098, 3316, 3521, 3839, 4103]",5516,49,5467,5,44,5467,0
2.5,S69278,"[84, 279, 323, 523, 547, 846, 861, 1184, 1196, 1219, 1402, 1406, 1412, 1484, 1495, 1500, 1505, 1529, 1544, 1561, 1567, 1597, 2275, 2302, 2443, 2446, 2564, 2590, 2739, 2826, 2846, 2895, 3031, 3231, 3347, 3453, 3561, 3662, 3832, 4004, 4111, 4174, 4236, 4880, 4923]","[2590, 2826, 3031, 3347, 3561]","[84, 279, 323, 523, 547, 846, 861, 1184, 1196, 1219, 1402, 1406, 1412, 1484, 1495, 1500, 1505, 1529, 1544, 1561, 1567, 1597, 2275, 2302, 2443, 2446, 2564, 2739, 2846, 2895, 3231, 3453, 3662, 3832, 4004, 4111, 4174, 4236, 4880, 4923]","[2590, 2826, 3031, 3347, 3561]",5015,45,4970,5,40,4970,0
2.5,S69350,"[174, 235, 566, 676, 1081, 1179, 1562, 1592, 1709, 1777, 1866, 2039, 2045, 2112, 2124, 2149]",[235],"[174, 566, 676, 1081, 1179, 1562, 1592, 1709, 1777, 1866, 2039, 2045, 2112, 2124, 2149]",[235],2152,16,2136,1,15,2136,0
2.5,SAIEGLOBIM,"[221, 237, 271, 346, 474, 541, 588, 604, 983, 1001, 1033, 1188, 1194, 1299, 1317, 1323, 1329, 1347, 1397, 1425, 1444, 1542, 1547, 1553, 1598, 1654]","[237, 588]","[221, 271, 346, 474, 541, 604, 983, 1001, 1033, 1188, 1194, 1299, 1317, 1323, 1329, 1347, 1397, 1425, 1444, 1542, 1547, 1553, 1598, 1654]","[237, 588]",1826,26,1800,2,24,1800,0
2.5,SMIGCU,"[132, 170, 340, 347, 395, 696, 799, 911, 1233, 1262, 1631, 1779, 1805, 1946, 2014, 2049, 2139, 2173, 2465, 2514, 2612, 2624, 2810]","[799, 1233, 1631]","[132, 170, 340, 347, 395, 696, 911, 1262, 1779, 1805, 1946, 2014, 2049, 2139, 2173, 2465, 2514, 2612, 2624, 2810]","[799, 1233, 1631]",2833,23,2810,3,20,2810,0
2.5,SMNPRP1A,"[215, 236, 310, 320, 601]",[215],"[236, 310, 320, 601]",[215],623,5,618,1,4,618,0
2.5,SOEEGLOBIN,"[17, 220, 236, 270, 344, 472, 539, 586, 602, 1054, 1060, 1165, 1183, 1189, 1195, 1213, 1263, 1291, 1310, 1404, 1460, 1516]","[236, 586]","[17, 220, 270, 344, 472, 539, 602, 1054, 1060, 1165, 1183, 1189, 1195, 1213, 1263, 1291, 1310, 1404, 1460, 1516]","[236, 586]",1688,22,1666,2,20,1666,0
2.5,SSBAT1G,"[54, 142, 260, 285, 482, 518, 743, 999, 1159, 1316, 1344, 1446, 1464, 1471, 1662, 1681, 1843, 1961, 2021, 2215, 2323, 2425, 2459, 2501, 2582, 2592, 2610, 2616, 2716, 2814, 2990, 3142, 3248, 3403, 3618, 3837, 3980, 4001, 4013, 4324, 4399, 4538, 4799, 4875, 5056, 5449, 5527, 5646, 5738, 5890, 6021, 6104, 6290, 6390, 6456, 6500, 6533, 6678, 6710, 6735, 6786, 6908, 6978, 6999, 7034, 7096, 7101, 7799, 7959, 8238, 8331, 8411, 8489, 8708, 8767, 8803, 9034, 9144, 9165, 9252, 9331, 9388, 9674, 9965, 10370, 10466, 10537]","[1316, 2215, 2582, 4538, 8238, 9144, 9388, 9674]","[54, 142, 260, 285, 482, 518, 743, 999, 1159, 1344, 1446, 1464, 1471, 1662, 1681, 1843, 1961, 2021, 2323, 2425, 2459, 2501, 2592, 2610, 2616, 2716, 2814, 2990, 3142, 3248, 3403, 3618, 3837, 3980, 4001, 4013, 4324, 4399, 4799, 4875, 5056, 5449, 5527, 5646, 5738, 5890, 6021, 6104, 6290, 6390, 6456, 6500, 6533, 6678, 6710, 6735, 6786, 6908, 6978, 6999, 7034, 7096, 7101, 7799, 7959, 8331, 8411, 8489, 8708, 8767, 8803, 9034, 9165, 9252, 9331, 9965, 10370, 10466, 10537]","[1316, 2215, 2582, 4538, 5771, 8238, 9144, 9388, 9674]",10666,87,10579,8,79,10578,1
2.5,SSIKBAGE,"[60, 400, 470, 622, 788, 956, 1010, 1132, 1180, 1247, 1575, 1729, 1884, 2364, 2377, 2469, 2501, 2528, 2590, 2604, 3103, 3151, 3334, 3454, 3520, 3620, 3713, 3746, 3766, 3823, 3850, 3938, 3954, 4091, 4470, 4600, 5128, 5251, 5267, 5276, 5304, 5478, 5484, 5601, 5628]","[2469, 3151, 3713, 4091, 4470]","[60, 400, 470, 622, 788, 956, 1010, 1132, 1180, 1247, 1575, 1729, 1884, 2364, 2377, 2501, 2528, 2590, 2604, 3103, 3334, 3454, 3520, 3620, 3746, 3766, 3823, 3850, 3938, 3954, 4600, 5128, 5251, 5267, 5276, 5304, 5478, 5484, 5601, 5628]","[2469, 3151, 3713, 4091, 4470]",5756,45,5711,5,40,5711,0
2.5,SSPINT1B,"[88, 185, 206, 467, 743, 1081, 1416, 1461, 1518, 1536, 1615, 1716, 1860, 1933, 1971, 1987, 2084, 2127, 2252, 2551, 2673, 2734, 2759, 2775, 2929, 3399, 3407, 3523, 3560, 3903, 4159, 4411, 4582, 4793, 5245, 5499, 5551, 5762, 5803, 6247, 6605, 6609, 6774, 6790, 7102, 7326, 7331, 7494, 7761, 7953, 7957, 8049, 8139, 8233, 8246, 8448, 8541, 8611, 8635, 8673, 8731]","[1971, 2551, 3903, 5245, 6605]","[88, 185, 206, 467, 743, 1081, 1416, 1461, 1518, 1536, 1615, 1716, 1860, 1933, 1987, 2084, 2127, 2252, 2673, 2734, 2759, 2775, 2929, 3399, 3407, 3523, 3560, 4159, 4411, 4582, 4793, 5499, 5551, 5762, 5803, 6247, 6609, 6774, 6790, 7102, 7326, 7331, 7494, 7761, 7953, 7957, 8049, 8139, 8233, 8246, 8448, 8541, 8611, 8635, 8673, 8731]","[1971, 2551, 3903, 5245, 6605]",8743,61,8682,5,56,8682,0
2.5,TAPROTP1,"[7, 230, 331]",[230],"[7, 331]",[230],547,3,544,1,2,544,0
2.5,TARHBE,"[76, 103, 119, 153, 351, 400, 418, 465, 948, 1076, 1124, 1202, 1221, 1291, 1403]","[119, 465]","[76, 103, 153, 351, 400, 418, 948, 1076, 1124, 1202, 1221, 1291, 1403]","[119, 465]",1682,15,1667,2,13,1667,0
2.5,TARHBG,"[58, 227, 265, 276, 608, 704, 773, 1025, 1032, 1217, 1263, 1472, 1488, 1822, 2059, 2072]",[265],"[58, 227, 276, 608, 704, 773, 1025, 1032, 1217, 1263, 1472, 1488, 1822, 2059, 2072]","[265, 612]",2139,16,2123,1,15,2122,1
2.5,TFLPA2P1,"[68, 121, 266, 272, 326, 374, 540, 589, 596, 650, 670, 883, 896, 972, 1293, 1311, 1749, 1848, 2031, 2035, 2108, 2240, 2495]","[596, 972, 1749]","[68, 121, 266, 272, 326, 374, 540, 589, 650, 670, 883, 896, 1293, 1311, 1848, 2031, 2035, 2108, 2240, 2495]","[596, 972, 1749]",2708,23,2685,3,20,2685,0
2.5,TFLPA2P2,"[68, 266, 368, 534, 583, 590, 644, 664, 874, 900, 935, 966, 974, 1017, 1286, 1304, 1565, 1783, 1882, 2068, 2072, 2274]","[590, 966, 1783]","[68, 266, 368, 534, 583, 644, 664, 874, 900, 935, 974, 1017, 1286, 1304, 1565, 1882, 2068, 2072, 2274]","[590, 966, 1783]",2431,22,2409,3,19,2409,0
2.5,TFLPA2P3,"[68, 121, 266, 272, 326, 374, 540, 589, 596, 650, 670, 883, 896, 972, 1293, 1311, 1749, 1848, 2031, 2035, 2108, 2240, 2495]","[596, 972, 1749]","[68, 121, 266, 272, 326, 374, 540, 589, 650, 670, 883, 896, 1293, 1311, 1848, 2031, 2035, 2108, 2240, 2495]","[596, 972, 1749]",2708,23,2685,3,20,2685,0
2.5,TFLPA2P4,"[68, 266, 368, 534, 583, 590, 644, 664, 874, 900, 935, 966, 974, 1017, 1286, 1304, 1565, 1783, 1882, 2068, 2072, 2274]","[590, 966, 1783]","[68, 266, 368, 534, 583, 644, 664, 874, 900, 935, 974, 1017, 1286, 1304, 1565, 1882, 2068, 2072, 2274]","[590, 966, 1783]",2431,22,2409,3,19,2409,0
2.5,TGLHBB,"[78, 144, 155, 159, 519, 590, 598, 712, 774, 888, 1106, 1116, 1142, 1214, 1256, 1272, 1360, 1472, 1704, 1742, 1770, 2002, 2034, 2119, 2233]","[519, 888]","[78, 144, 155, 159, 590, 598, 712, 774, 1106, 1116, 1142, 1214, 1256, 1272, 1360, 1472, 1704, 1742, 1770, 2002, 2034, 2119, 2233]","[519, 888]",2300,25,2275,2,23,2275,0
2.5,TIOPRP1A,"[212, 233, 315]",[212],"[233, 315]",[212],556,3,553,1,2,553,0
2.5,U00432,"[83, 237, 290, 793, 975, 1070, 1101, 1203, 1287, 1312, 1459]","[83, 237, 793, 1101, 1312]","[290, 975, 1070, 1203, 1287, 1459]","[83, 237, 793, 1101, 1312]",1575,11,1564,5,6,1564,0
2.5,U00433,"[83, 267, 752, 936, 1245, 1270, 1424]","[83, 267, 752, 1270]","[936, 1245, 1424]","[83, 267, 752, 1062, 1270]",1545,7,1538,4,3,1537,1
2.5,U00454,"[38, 131, 148, 168, 259, 333, 413, 546, 676, 687, 772, 849, 951, 1031, 1036, 1062, 1066, 1090, 1263, 1330, 1598, 1605, 1631, 1705, 1749, 1804, 1967, 2041, 2045, 2071, 2315, 2382, 2631, 2760, 2763, 2781, 2823, 2969, 3043, 3201, 3350, 3447, 3464, 3622, 3905, 4179, 4263, 4269, 4276, 4328, 4362, 4509, 4529, 4573, 4653, 4824, 4862, 5011, 5094, 5303, 5366, 5625, 5667, 5820, 6076, 6565, 6580, 6606, 6782, 6800, 6876, 6887, 7057]","[1598, 4862]","[38, 131, 148, 168, 259, 333, 413, 546, 676, 687, 772, 849, 951, 1031, 1036, 1062, 1066, 1090, 1263, 1330, 1605, 1631, 1705, 1749, 1804, 1967, 2041, 2045, 2071, 2315, 2382, 2631, 2760, 2763, 2781, 2823, 2969, 3043, 3201, 3350, 3447, 3464, 3622, 3905, 4179, 4263, 4269, 4276, 4328, 4362, 4509, 4529, 4573, 4653, 4824, 5011, 5094, 5303, 5366, 5625, 5667, 5820, 6076, 6565, 6580, 6606, 6782, 6800, 6876, 6887, 7057]","[1598, 4862]",7192,73,7119,2,71,7119,0
2.5,U00938,"[34, 60, 71, 102, 143, 247, 492, 556, 777, 832, 893, 912, 1133, 1169, 1173, 1454, 1465, 1516, 1711, 2080, 2179, 2207, 2312, 2384, 2611, 2661, 2715, 2719, 2742, 2824, 2974, 3013, 3017, 3079, 3311, 3397, 3587, 3617, 3687, 3702, 4070, 4186, 4207, 4796, 5071, 5092, 5134, 5138, 5155, 5195, 5202, 5261, 5452, 5570, 5640, 5745, 5809, 5910, 5914, 5962, 5970, 6009, 6198, 6482, 6711, 6763]","[1169, 4070, 5155]","[34, 60, 71, 102, 143, 247, 492, 556, 777, 832, 893, 912, 1133, 1173, 1454, 1465, 1516, 1711, 2080, 2179, 2207, 2312, 2384, 2611, 2661, 2715, 2719, 2742, 2824, 2974, 3013, 3017, 3079, 3311, 3397, 3587, 3617, 3687, 3702, 4186, 4207, 4796, 5071, 5092, 5134, 5138, 5195, 5202, 5261, 5452, 5570, 5640, 5745, 5809, 5910, 5914, 5962, 5970, 6009, 6198, 6482, 6711, 6763]","[1169, 4070, 5155]",6780,66,6714,3,63,6714,0
2.5,U01026,"[44, 52, 262, 428, 492, 848, 901, 1105, 1153, 1308, 1357, 1364, 1419, 1746, 1927, 2071, 2154, 2316, 2537, 2636, 2760, 2809, 2826, 3028]","[1364, 1746, 2537]","[44, 52, 262, 428, 492, 848, 901, 1105, 1153, 1308, 1357, 1419, 1927, 2071, 2154, 2316, 2636, 2760, 2809, 2826, 3028]","[1364, 1746, 2537]",3216,24,3192,3,21,3192,0
2.5,U01027,"[50, 103, 248, 309, 357, 515, 564, 571, 625, 947, 1128, 1272, 1290, 1692, 1710, 1799, 1809, 1933, 1982, 1999, 2054, 2192, 2740]","[571, 947, 1710]","[50, 103, 248, 309, 357, 515, 564, 625, 1128, 1272, 1290, 1692, 1799, 1809, 1933, 1982, 1999, 2054, 2192, 2740]","[571, 947, 1710]",2761,23,2738,3,20,2738,0
2.5,U01844,"[64, 304, 476, 515, 596, 623, 663, 684, 1082, 1180, 1307, 1472, 1559, 1589, 1618, 1770, 1919, 1986, 2090, 2141, 2219, 2395, 2474, 2585, 2653, 2935, 3175, 3211, 3256, 3403, 3608, 3720, 3781, 3843, 4080, 4108, 4143]","[1986, 2141, 2474, 2653, 3211]","[64, 304, 476, 515, 596, 623, 663, 684, 1082, 1180, 1307, 1472, 1559, 1589, 1618, 1770, 1919, 2090, 2219, 2395, 2585, 2935, 3175, 3256, 3403, 3608, 3720, 3781, 3843, 4080, 4108, 4143]","[1986, 2141, 2474, 2653, 3211]",4219,37,4182,5,32,4182,0
2.5,XELCRPGA,"[285, 508, 726, 818, 837, 842, 892, 1021, 1096, 1680, 1686, 1871, 2002, 2377, 2504, 2838, 2961, 2983, 3199, 3338, 3368, 3497, 3551, 3794, 3849, 3852, 3886]",[1096],"[285, 508, 726, 818, 837, 842, 892, 1021, 1680, 1686, 1871, 2002, 2377, 2504, 2838, 2961, 2983, 3199, 3338, 3368, 3497, 3551, 3794, 3849, 3852, 3886]",[1096],3891,27,3864,1,26,3864,0
2.5,XELCRYB,"[125, 162, 170, 179, 196, 200, 582, 592, 605, 706, 911, 945, 990, 1208, 1326, 1500, 1768, 1905]","[706, 1326]","[125, 162, 170, 179, 196, 200, 582, 592, 605, 911, 945, 990, 1208, 1500, 1768, 1905]","[706, 1326]",2049,18,2031,2,16,2031,0
2.5,XELHBBC,"[11, 32, 263, 556, 564, 567, 678, 715, 1233, 1290, 1352, 1418, 1832, 1844]","[263, 678]","[11, 32, 556, 564, 567, 715, 1233, 1290, 1352, 1418, 1832, 1844]","[263, 678]",1981,14,1967,2,12,1967,0
2.5,XLACTA,"[108, 165, 309, 404, 553, 941, 957, 1098, 1260, 1349, 1382, 1758, 2366, 2591, 3197, 3422, 3552, 3556, 3623, 3640, 3815, 3868, 3913, 3994, 4000, 4138, 4242, 4296, 4335, 4370, 4409, 4444, 4453, 4483, 4518, 4557, 4592, 4667, 4845, 4905, 4946, 4961, 5012, 5022, 5048, 5058, 5066, 5078, 5128, 5338, 5509, 5550, 5561, 5898]","[2591, 3868, 4138, 4845, 5128]","[108, 165, 309, 404, 553, 941, 957, 1098, 1260, 1349, 1382, 1758, 2366, 3197, 3422, 3552, 3556, 3623, 3640, 3815, 3913, 3994, 4000, 4242, 4296, 4335, 4370, 4409, 4444, 4453, 4483, 4518, 4557, 4592, 4667, 4905, 4946, 4961, 5012, 5022, 5048, 5058, 5066, 5078, 5338, 5509, 5550, 5561, 5898]","[2591, 3868, 4138, 4845, 5128]",5946,54,5892,5,49,5892,0
2.5,XLACTCAG,"[279, 422, 831, 855, 1201, 1263, 1273, 1338, 1600, 1605, 1638, 1670, 2094, 2107, 2398, 2473, 2675, 3023, 3128, 3298, 3302, 3325, 3329, 3353, 3386, 3561, 3591, 3614, 4019, 4202, 4237, 4256, 4289, 4364, 4412, 4769, 4787, 4865, 4931, 5493, 5562, 5636, 6171, 6279, 6294, 6355, 6381, 6391, 6399, 6461, 7341, 7347, 7511, 7516, 7853, 8347, 8410, 8752, 8892]","[2473, 3614, 4931, 5562, 6461]","[279, 422, 831, 855, 1201, 1263, 1273, 1338, 1600, 1605, 1638, 1670, 2094, 2107, 2398, 2675, 3023, 3128, 3298, 3302, 3325, 3329, 3353, 3386, 3561, 3591, 4019, 4202, 4237, 4256, 4289, 4364, 4412, 4769, 4787, 4865, 5493, 5636, 6171, 6279, 6294, 6355, 6381, 6391, 6399, 7341, 7347, 7511, 7516, 7853, 8347, 8410, 8752, 8892]","[2473, 3614, 4931, 5562, 6461]",8900,59,8841,5,54,8841,0
2.5,XLBGL3,"[22, 143, 338, 388, 614, 692, 982, 1040, 1175, 1272, 1438, 1707, 1851, 1981, 2161, 2443, 2638]","[388, 1175]","[22, 143, 338, 614, 692, 982, 1040, 1272, 1438, 1707, 1851, 1981, 2161, 2443, 2638]","[388, 1175]",2964,17,2947,2,15,2947,0
2.5,XLGLAA1,"[137, 502, 540, 559, 590, 594, 650, 659, 680]","[137, 502]","[540, 559, 590, 594, 650, 659, 680]","[137, 502]",1192,9,1183,2,7,1183,0
2.5,XLGLAA2,"[138, 248, 519, 586, 601, 655, 1163]","[138, 519]","[248, 586, 601, 655, 1163]","[138, 519]",1192,7,1185,2,5,1185,0
2.5,XLK81A1G,"[615, 672, 935, 1412, 1517, 1618, 1671, 1759, 1911, 2033, 2294, 2369, 2468, 2498, 2615, 2734, 2900, 3026, 3145, 3149, 3240, 3388, 3409, 3531, 3647, 3741, 3849, 4127, 4170, 4425, 4429, 4626, 4769, 5170, 5223, 5318, 5672, 5772]","[1759, 2294, 2734, 3026, 3531, 3849, 4170]","[615, 672, 935, 1412, 1517, 1618, 1671, 1911, 2033, 2369, 2468, 2498, 2615, 2900, 3145, 3149, 3240, 3388, 3409, 3647, 3741, 4127, 4425, 4429, 4626, 4769, 5170, 5223, 5318, 5672, 5772]","[1759, 2294, 2734, 3026, 3531, 3849, 4170]",5892,38,5854,7,31,5854,0
2.5,XLRPL14,"[377, 709, 912, 967, 1141, 1292, 1499, 1601, 1605, 1837, 1891, 2087, 2125, 2140, 2145, 2327, 2432, 2560, 2624, 2713, 3051, 3085, 3651, 3695, 3722, 3897, 3928, 4037, 4039, 4263, 4978, 5232, 5287, 5356, 5856, 6146, 6481, 6485, 6622, 6731, 6804, 7052, 7158, 7239, 7354, 7618, 7840, 7849, 7904, 8659, 9072, 9108]","[912, 1891, 2087, 4978, 5356, 7904]","[377, 709, 967, 1141, 1292, 1499, 1601, 1605, 1837, 2125, 2140, 2145, 2327, 2432, 2560, 2624, 2713, 3051, 3085, 3651, 3695, 3722, 3897, 3928, 4037, 4039, 4263, 5232, 5287, 5856, 6146, 6481, 6485, 6622, 6731, 6804, 7052, 7158, 7239, 7354, 7618, 7840, 7849, 8659, 9072, 9108]","[912, 1891, 2087, 4978, 5356, 7904]",9116,52,9064,6,46,9064,0
2.5,XLRPL1AG,"[308, 339, 417, 423, 503, 512, 634, 693, 804, 1078, 1085, 1153, 1482, 1597, 1817, 2105, 2121, 2390, 2418, 2541, 2638, 2695, 2818, 2964, 3137, 3498, 3594, 3717, 3735, 3831, 3844, 3968, 4013, 4169, 4221, 4433, 4533, 4573, 4887, 4994, 5179, 5232, 5303, 5480, 5583, 5594, 5643, 5757, 5816, 5825, 5916, 5925, 6114, 6152, 6206, 6451]","[512, 2121, 2818, 3137, 3831, 4573, 5179, 5757]","[308, 339, 417, 423, 503, 634, 693, 804, 1078, 1085, 1153, 1482, 1597, 1817, 2105, 2390, 2418, 2541, 2638, 2695, 2964, 3498, 3594, 3717, 3735, 3844, 3968, 4013, 4169, 4221, 4433, 4533, 4887, 4994, 5232, 5303, 5480, 5583, 5594, 5643, 5816, 5825, 5916, 5925, 6114, 6152, 6206, 6451]","[512, 2121, 2438, 2818, 3137, 3831, 4573, 5179, 5757]",6949,56,6893,8,48,6892,1
2.5,XLS8,"[83, 98, 164, 493, 692, 804, 951, 961, 1006, 1512, 1530, 1600, 1867, 1874, 2021, 2032, 2326, 2395, 2616, 2865, 2893, 3505, 3539, 3938, 3957, 3963, 4181, 4468, 4473, 4498, 4563, 4856, 4918, 5403, 5432, 5594, 5618, 5708, 5777, 5849, 5912, 5946, 6119, 6325, 6357, 6381, 6468, 6913, 6931, 7000, 7181, 7381, 7470, 7668, 7843, 7933, 8071, 8274, 8292, 8411, 8508, 8542, 8583, 9159, 9241, 9259, 9325, 9832, 9886, 9909, 10214, 10366, 10413, 10559, 10791, 10822, 10967, 10977, 10988, 11229, 11411, 11639, 11694, 11730, 11874, 11936, 11957, 12105, 12177, 12265, 12388, 12509, 12527, 12596, 12978, 13006, 13023, 13088, 13107, 13234]","[2032, 3938, 5912, 7381, 12177]","[83, 98, 164, 493, 692, 804, 951, 961, 1006, 1512, 1530, 1600, 1867, 1874, 2021, 2326, 2395, 2616, 2865, 2893, 3505, 3539, 3957, 3963, 4181, 4468, 4473, 4498, 4563, 4856, 4918, 5403, 5432, 5594, 5618, 5708, 5777, 5849, 5946, 6119, 6325, 6357, 6381, 6468, 6913, 6931, 7000, 7181, 7470, 7668, 7843, 7933, 8071, 8274, 8292, 8411, 8508, 8542, 8583, 9159, 9241, 9259, 9325, 9832, 9886, 9909, 10214, 10366, 10413, 10559, 10791, 10822, 10967, 10977, 10988, 11229, 11411, 11639, 11694, 11730, 11874, 11936, 11957, 12105, 12265, 12388, 12509, 12527, 12596, 12978, 13006, 13023, 13088, 13107, 13234]","[2032, 3938, 5912, 7381, 12177]",13512,100,13412,5,95,13412,0
2.5,XLTUBAG,"[21, 272, 298, 400, 482, 591, 595, 678, 721, 1023, 1030, 1280, 1323, 1454, 1507, 1541, 1555, 1607, 1613, 1680, 1760, 1877, 1885, 2006, 2020, 2048, 2079, 2440, 2610, 2842, 2870, 3080, 3094, 3268, 3626, 3684, 3691, 4024, 4179, 4212, 4224, 4401, 4585, 4775, 4898, 4907, 5039, 5048, 5214, 5313, 5431, 5575, 5708, 6290, 6312, 6345, 6353, 6494, 6577, 6604, 6612, 6618, 6630, 6686]","[678, 4401, 5575]","[21, 272, 298, 400, 482, 591, 595, 721, 1023, 1030, 1280, 1323, 1454, 1507, 1541, 1555, 1607, 1613, 1680, 1760, 1877, 1885, 2006, 2020, 2048, 2079, 2440, 2610, 2842, 2870, 3080, 3094, 3268, 3626, 3684, 3691, 4024, 4179, 4212, 4224, 4585, 4775, 4898, 4907, 5039, 5048, 5214, 5313, 5431, 5708, 6290, 6312, 6345, 6353, 6494, 6577, 6604, 6612, 6618, 6630, 6686]","[678, 4401, 5575]",6888,64,6824,3,61,6824,0
2.5,XLXANF1A,"[255, 317, 611, 1460, 1789, 1917, 1960, 2204, 2647, 2706, 3255, 3259, 4472, 4478, 4595, 4631, 4751, 4760]","[1460, 1960, 2706]","[255, 317, 611, 1789, 1917, 2204, 2647, 3255, 3259, 4472, 4478, 4595, 4631, 4751, 4760]","[1460, 1960, 2706]",4878,18,4860,3,15,4860,0
2.5,XTGLA,"[158, 235, 269, 286, 419, 652, 731, 1323, 1544, 1752, 1850, 2034, 2283, 2838, 2861, 3148, 3340, 3493, 3599, 3604, 4013, 4248, 4344, 4437, 4443, 4482, 4720, 4804]","[731, 2838]","[158, 235, 269, 286, 419, 652, 1323, 1544, 1752, 1850, 2034, 2283, 2861, 3148, 3340, 3493, 3599, 3604, 4013, 4248, 4344, 4437, 4443, 4482, 4720, 4804]","[731, 2838]",4838,28,4810,2,26,4810,0
2.5,XTGLAA,"[377, 416, 541, 656, 785, 908, 1005, 1036, 1156, 1411, 1493]","[1036, 1411]","[377, 416, 541, 656, 785, 908, 1005, 1156, 1493]","[1036, 1411]",1992,11,1981,2,9,1981,0
2.5,XTGLB,"[21, 92, 169, 212, 389, 393, 644, 1398, 1823, 2097, 2175, 2384, 2643, 2836, 3061, 3539, 3599, 3769, 3995, 4034]","[2384, 2836]","[21, 92, 169, 212, 389, 393, 644, 1398, 1823, 2097, 2175, 2643, 3061, 3539, 3599, 3769, 3995, 4034]","[2384, 2836]",4043,20,4023,2,18,4023,0
2.5,ZEFB2MICB,"[304, 383, 542, 954, 985, 1187, 1309, 1323, 1345, 1779, 1846]","[304, 1187]","[383, 542, 954, 985, 1309, 1323, 1345, 1779, 1846]","[304, 1187]",2193,11,2182,2,9,2182,0
